ذرية	ð u r r i j j a h
وعد	w a ʕ d
رأسمال	r a ʔ s m aː l
أمس	ʔ a m a s s i
الآن	a l ʔ aː n
عبوثران	ʕ a b a w θ a r aː n
مقايسة	m u q aː j a s a
أمس	ʔ u m a s s u
ركل	r a k l
حزم	ħ a z a m a
ع	ʕ
بوري	b uː r iː
مينا	m iː n aː
عند	ʕ i n d a
استعصم	i s t a ʕ sˤ a m a
مصنع	m a sˤ n a ʕ
مغزل	m i ɣ z a l
معارف	m a ʕ aː r i f
عائلة	ʕ aː ʔ i l a
سلح	s a l ħ
تواضع	t a w aː dˤ u ʕ
شيص	ʃ iː sˤ
كرفس	k a r a f s
أسهل	ʔ u s a h h i l
كبيكج	k a b iː k a d͡ʒ
شاهد	ʃ aː h a d a
مراجع	m u r aː d͡ʒ i ʕ
دبار	d i b aː r
عربي	ʕ a r a b i j j
بهيم	b a h iː m
ريال	r i j aː l
مكدس	m u k a d d i s
صهريج	sˤ i h r iː d͡ʒ
شهوة	ʃ a h w a
أنف	ʔ a n f u
فحص	f a ħ a sˤ a
نظر	n a ðˤ ðˤ a r a
إهليلج	ʔ i h l iː l a d͡ʒ
تمارة	t a m aː r a
بلوة	b i l w a
كساء	k i s aː ʔ
مناظرة	m u n aː ðˤ a r a h
ضال	dˤ aː l l
ولكن	w a l aː k ɪ n
شخص	ʃ a x x a sˤ a
سذاب	s u ð aː b
ترك	t a r a k a
سونكي	s u n k i j j
عصير	ʕ a sˤ iː r
أنزروت	ʔ a n z a r uː t
باع	b aː ʕ a
حمار	ħ i m aː r
حكمة	ħ a k a m a
أزرع	ʔ a z r a ʕ a
سحم	s a ħ i m a
مشوي	m a ʃ w i j j
قرد	q i r d
مكحلة	m u k ħ u l a
كامبوديا	k a m b oː d i j aː
ممسحة	m i m s a ħ a
مرو	m a r w
مطبخ	m a tˤ b a x
محسن	m u ħ a s s i n
نخل	n a x a l a
نازع	n aː z i ʕ
معارضة	m u ʕ aː r a dˤ a
انعقاد	i n ʕ i q aː d
توغو	t oː ɣ oː
أوبرا	ʔ u b i r a
جادل	d͡ʒ aː d a l a
بارد	b aː r i d
غسل	ɣ a s a l a
أحسن	ʔ u ħ a s s a n u
سوء	s uː ʔ
ماز	m aː z a
انقلب	i n q a l a b a
حافلة	ħ aː f i l a
أميرة	æ m iː r a
مص	m a sˤ sˤ a
شاقول	ʃ aː q uː l
شج	ʃ a d͡ʒ i n
سعى	s a ʕ aː
واحد	w aː ħ i d
أمير	ʔ a m iː r
شهلاء	ʃ a h l aː ʔ
شبح	ʃ a b a ħ
جنى	d͡ʒ a n aː
شمس	ʃ a m i s a
قارورة	q aː r uː r a
عزا	ʕ a z aː
مكياج	m a k j aː d͡ʒ
سنط	s a n tˤ
صعتر	sˤ a ʕ t a r
لباس	l i b aː s
إقالة	ʔ i q aː l a h
شاقولي	ʃ aː q uː l i j j
أنف	ʔ a n f i
ناخوذاة	n aː x uː ð aː h
أسهر	ʔ a s h a r a
نور	n a w r
بحاح	b u ħ aː ħ
صعب	sˤ a ʕ u b a
سنبوسج	s a m b uː s a d͡ʒ
ذ	ð aː l
دويبة	d u w a j b b a t u n
خبط	χ a bˤ tˤ
عض	ʕ a dˤ dˤ a
يسار	j a s aː r
شبح	ʃ a b u ħ a
بشرية	b a ʃ a r i j j a
كوم	k a w m
نسرين	n i s r iː n
زميلة	z a m iː l a
معين	m u ʕ a j j i n
ناجود	n aː d͡ʒ uː d
نقض	n a q dˤ i
مشربة	m i ʃ r a b a
قروش	q u r uː ʃ
فصح	f a sˤ ħ
طقم	tˤ a q m
رخاخ	r i x aː x
تعطى	t a ʕ a tˤ tˤ aː
سوق	s uː ɡ
ثاقبايليث	θ aː q b aː j l iː θ
أعجم	ʔ a ʕ d͡ʒ a m a
لأك	l a ʔ a k a
دنر	d a n n a r a
مشط	m a ʃ tˤ
تضمن	t a dˤ a m m u n
تحيز	t a ħ a w w a z a
ألماني	ʔ a l m aː n i j j
يتيم	j a t iː m
توكيد	t a w k iː d
مؤسس	m u ʔ a s s a s
كيف	k a j f a
صبي	sˤ u b b iː
عمود	ʕ a m uː d
أزعر	ʔ a z ʕ a r
طالم	tˤ aː l a m
أردني	ʔ u r d u n n i j j
ألا	ʔ a l l aː
عتبات	ʕ a t a b aː t
سامور	s aː m uː r
عاهل	ʕ aː h i l
بيت	b a j j a t a
سلالة	s u l aː l a
هم	h u m
فرغة	f a r i ɣ a
جزاء	d͡ʒ a z aː ʔ
ألف	ʔ a l i f
منظمة	m u n a ðˤ ðˤ a m a
إغليق	ʔ i ɣ l iː q
كويكب	k u w a j k i b
صنبور	sˤ u n b uː r
أخضر	ʔ a x dˤ a r
الدانوب	a d d aː n uː b
مشعر	m a ʃ ʕ a r
شبح	ʃ a b a ħ a
طرق	tˤ u r u q
محافظ	m u ħ aː f i ðˤ
م	m iː m
جبن	d͡ʒ a b u n a
قنصلية	q u n sˤ u l i j j a
أما	ʔ a m m aː
برق	b a r q
نتأ	n a t a ʔ a
غرب	ɣ a r u b a
انقضى	i n q a dˤ aː
منجاة	m a n d͡ʒ aː h
نظر	n a ðˤ a r
هدى	h u d a n
شماتة	ʃ a m aː t a
أعور	ʔ a ʕ w a r
إعلام	ʔ i ʕ l aː m
طريخ	tˤ i r r iː x
طهران	tˤ a h r aː n
قرفص	q a r f a sˤ a
وقف	w a q f
مرحبا	m a r ħ a b aː
واو	w aː w
صغر	sˤ a ɣ ɣ a r a
شجرة	ʃ a d͡ʒ a r a
انفتح	i n f a t a ħ a
ثمن	θ u m n
فص	f i sˤ sˤ
فرخ	f a r r a x a
ضأن	dˤ a ʔ n
ملوكيا	m u l uː k i j j aː
موتوسيكل	m oː t oː s iː k i l
خيرات	x a j r aː t
ذو	ð uː
دكتور	d ɪ k t oː r
سيجارة	s i ɡ aː r a
سقيم	s a q iː m
عادات	ʕ aː d aː t
شبرم	ʃ a b r a m
يورانيم	j uː r aː n j u m
تنفس	t a n f a s
عربن	ʕ a r b a n a
قداد	q u d aː d
شخصيا	ʃ a x sˤ i j j a n
مئة	m i ʔ a
غرب	ɣ a r r a b a
تزامن	t a z aː m u n
بطء	b u tˤ ʔ
ويكة	w a j k a
ويكة	w eː k a
أنطاكية	ʔ a n tˤ aː k i j j a
التقط	i l t a q a tˤ a
ليزر	l a j z i r
أدهش	ʔ u d h i ʃ
زوج	z a w w a d͡ʒ a
بدني	b a d a n i j j
تواقف	t a w aː q a f a
دودة	d uː d a
صاد	sˤ aː d
حرق	ħ u r ɡ
فاصولياء	f aː sˤ uː l i j aː ʔ
إله	ʔ i l aː h
تقدم	t a q a d d u m
عال	ʕ aː l i n
طاغوت	tˤ aː ɣ uː t
إبريسم	ʔ i b r a j s a m
حاك	ħ aː k a
نهائي	n i h aː ʔ i j j
إسبانيا	ʔ i s b aː n i j aː
علامة	ʕ a l aː m a
نموذج	n a m uː ð a d͡ʒ
مضض	m a dˤ a dˤ
عراء	ʕ a r aː ʔ
شاء	ʃ aː ʔ a
كنف	k a n a f
قسوة	q a s w a
صفة	sˤ i f a
عظيم	ʕ a ðˤ iː m
طقس	tˤ a ɡ s
يتوع	j a t t uː ʕ
حرف	ħ a r f
قصدير	q a sˤ d iː r
تمرين	t a m r iː n
وزنة	w a z n a
فلس	f i l s
تمساح	t ɪ m s æː ħ
أسهل	ʔ a s h u l u
حذار	ħ a ð aː r i
فظع	f a ðˤ u ʕ a
رقم	r a q m
ماما	m aː m aː
سميذ	s a m iː ð
فوشي	f uː ʃ i j j
مزرعة	m a z r a ʕ a
ثقافة	t a q aː f a
أشقر	ʔ a ʃ ɡ a r
عظم	ʕ i ðˤ a m
صهب	sˤ a h i b a
باكستان	b aː k i s t aː n
ليل	l a j l
فجأة	f a d͡ʒ ʔ a t a n
أبلس	ʔ a b l a s a
منير	m u n iː r
زمج	z u m m a d͡ʒ
جو	d͡ʒ a w w
أشنان	ʔ u ʃ n aː n
نشور	n u ʃ uː r
قد	q a d d
زنة	z i n a
كراج	k a r aː d͡ʒ
حصن	ħ u sˤ u n
هاته	h aː t i h
سيارة	s a j j aː r a
طبقات	tˤ a b a q aː t
استلزم	i s t a l z a m a
واس	w aː s
لجئ	l a d͡ʒ a ʔ a
تحليلي	t a ħ l iː l i j j
لهذا	l i h æː ð æː
تنديل	t a n aː d iː l
مريء	m a r iː ʔ
ذهب	ð a h a b
خسوف	x u s uː f
وردة	w a r d a
كنز	k a n i z
مثل	m a θ a l a
عصف	ʕ a sˤ f
ثمانية	θ a m aː n i j a
عواري	ʕ a w aː r i j j
كركم	k u r k u m
استمرار	i s t i m r aː r
قيقب	q a j q a b
شمبانيا	ʃ a m p aː n j aː
مقاس	m a q aː s
لن	l a n
برذعة	b a r ð a ʕ a
وديعة	w a d iː ʕ a
تدريجي	t a d r iː d͡ʒ i j j
جندبادستر	d͡ʒ u n d u b aː d a s t a r
أهدى	ʔ a h d aː
فرخ	f a r x
تعشيقة	t a ʕ i ʃ iː q a
جلنجبين	d͡ʒ u l l a n d͡ʒ u b iː n
جبانات	d͡ʒ a b aː n aː t
شنع	ʃ a n u ʕ a
عزب	ʕ a z a b a
حصاة	ħ a sˤ aː h
تفرغ	t a f a r r a ɣ a
تهدل	t a h a d d u l
تراوح	t a r aː w u ħ
حدد	ħ a d d a d a
أعطى	ʔ a ʕ tˤ aː
سمور	s a m m uː r
معلم	m u ʕ l i m
هرة	h i r r a t u n
أكاف	ʔ u k aː f
اهتدى	i h t a d aː
القنيطرة	a l q u n a j tˤ i r a
انسل	i n s a l l a
نرجيل	n a r d͡ʒ iː l
أحد	ʔ a ħ a d
انتقل	i n t a q a l a
تال	t aː l i n
مقصر	m u q a sˤ sˤ i r
قسم	q a s m
فم	f a m
احترق	i ħ t a r a q a
مردي	m u r d i j j
قبض	q a b b a dˤ a
ملأك	m a l ʔ a k
قال	ɡ aː l
قيطون	q i tˤ uː n
قلوي	q a l a w i j j
مقذاف	m i q ð aː f
سويسرا	s w iː s r aː
شلغم	ʃ a l ɣ a m
عمم	ʕ a m m a m a
مفرغ	m u f a r r a ɣ
لثة	l ɪ θː ɘ
انجراف	i n d͡ʒ i r aː f
قنطر	q a n tˤ a r a
اقتطف	q a tˤ a f a
بطن	b a tˤ tˤ a n a
عظم	ʕ a ðˤ m
برواز	b a r w aː z
برنيق	b a r n iː q
منقض	m u n q i dˤ
قلعة	q i l ʕ a
أقرب	ʔ a q r a b a
تنفس	t u n a f f i s
شمع	ʃ a m ʕ
قرحة	q u r ħ a
نساب	n a s s aː b
جين	d͡ʒ iː n
ضرط	dˤ a r tˤ
أنكر	ʔ a n k a r a
شعير	ʃ a ʕ iː r
دعسوقة	d u ʕ s uː q a
سوفياتي	s o v j e t i j j
عتب	ʕ a t a b a
توقف	t a w a q q u f
فرنسا	f a r a n s aː
تركمانستان	t u r k u m aː n i s t aː n
صدقة	sˤ a d a q a
طيهوج	tˤ a j h uː d͡ʒ
عض	ʕ a dˤ dˤ
مجراف	m i d͡ʒ r aː f
لوح	l a w ħ
نفوذ	n u f uː ð
صارخ	sˤ ɑː r i x
أسيتون	ʔ a s iː t uː n
حمضي	ħ a m dˤ i j j
أكاذيب	ʔ a k aː ð iː b
بدلات	b a d a l aː t
عوائد	ʕ a w aː ʔ i d
سينثيا	s iː n θ i j aː
وسخ	w a s a x
ج	d͡ʒ iː m
جنطيانا	d͡ʒ u n tˤ a j aː n aː
اجتنى	i d͡ʒ t a n aː
أنت	ʔ a n t i
هريرة	h u r a j r a h
بن	b i n
تلميذ	t i l m iː ð
شبوطة	ʃ a b b uː tˤ a
اجتماعي	i d͡ʒ t i m aː ʕ i j j
مغطس	m i ɣ tˤ a s
رساطون	r u s aː tˤ uː n
افغانستان	a f ɣ aː n i s t aː n
ملقن	m u l a q q i n
أخذ	ʔ a x a ð a
شرب	ʃ a r i b a
ورقة	w a r a q a
إلى	ʔ i l aː
قبط	q u b tˤ
غلبة	ɣ a l u b b a
يوسف	j uː s i f
بؤرة	b u ʔ r a
بتع	b i t ʕ
مبارز	m u b aː r i z
أكل	ʔ a k l
صيد	sˤ a j d
نار	n aː r
رام	r aː m a
أغلب	ʔ a ɣ l i b u
أشم	ʔ a ʃ a m m a
وقع	w a q ʕ
طنطور	tˤ a n tˤ uː r
شهلة	ʃ a h l a
خمسة	x a m s a
عنى	ʕ a n aː
كوثر	k a w θ a r
إشفى	ʔ i ʃ f aː
شنبر	ʃ a n b a r
فسح	f a s s a ħ a
قرطاجي	q a r tˤ aː d͡ʒ i j j
هر	h i r r
دخل	d a x a l
خولنجان	x a w l a n d͡ʒ aː n
ل	l i
أغلب	ʔ u ɣ a l l a b u
إمبريالي	ʔ i m b i r j aː l i j j
قادر	q aː d i r
عظم	ʕ a ðˤ ðˤ a m a
أهلا	ʔ a h l a n
جواهري	d͡ʒ a w aː h i r i j j
إذ	ʔ i ð
معنى	m a ʕ n aː
مكوك	m a k k uː k
حمام	ħ i m aː m
دماغي	d i m aː ɣ i j j
مرحبا	m a r ħ a b a n
نشد	n a ʃ a d a
مئذنة	m i ʔ ð a n a
قليب	q a l iː b
هذه	h aː ð i h i
سوسة	s uː s a
قبع	q a b a ʕ a
أعمدة	ʔ a ʕ m i d a
أتوبوس	ʔ o t o b uː s
كرخ	k i r x
توج	t a w w a d͡ʒ a
السفن	a s s u f u n
أطلسي	ʔ a tˤ l a s i j j
سرجين	s i r d͡ʒ iː n
زبرجد	z a b a r d͡ʒ a d
برج	b a r i d͡ʒ a
فوارة	f a w w aː r a
قطارة	q a tˤ tˤ aː r a
مطفأة	m i tˤ f a ʔ a
فولاذ	f uː l aː ð
قعد	q a ʕ a d a
جام	d͡ʒ aː m
زرنب	z a r n a b
دلب	d u l b
كولومبيا	k o l o m b i j aː
حقيقة	ħ a q iː q a
زمزم	z a m z a m
أنور	ʔ a n w a r
خبز	x a b a z a
استهلك	i s t a h l a k a
صوف	sˤ a w w a f a
أصفاد	ʔ a sˤ f aː d
جخى	d͡ʒ a x x aː
مارس	m aː r a s a
مؤمن	m u ʔ m i n
رضا	r i dˤ a n
سهل	s a h u l a
ظاء	ðˤ aː ʔ
ساق	s aː q a
قرب	q u r b a
ندى	n a d aː
فرقاطة	f r ɡ aː tˤ a
تشالة	t a ʃ aː ʃ iː l
مرتفع	m u r t a f a ʕ
ممسح	m u m a s s a ħ
تلفون	t i l i f uː n
هاجم	h aː d͡ʒ a m a
أحرج	ʔ a ħ r a d͡ʒ a
يوحنا	j uː ħ a n n aː
مغناطيسي	m a ɣ n a tˤ iː s i j j
هزيز	h a z iː z
تنفس	t u n a f f i s a
غادر	ɣ aː d a r a
قماش	ɡ u m aː ʃ
حرق	ħ a r a q a
أدان	ʔ a d aː n a
دارفلفل	d aː r f i l f i l
بحر	b a ħ r
مدام	m u d aː m
عطاس	ʕ u tˤ aː s
حق	ħ a q q a
زمزم	z a m z a m a
استرجع	i s t a r d͡ʒ a ʕ a
لغويات	l u ɣ a w i j j aː t
سنت	s a n t
قدم	q a d i m a
فلنجة	f i l i n d͡ʒ a
عود	ʕ uː d
مغناطيس	m i ɣ n a tˤ iː s
ضائنة	dˤ aː ʔ i n a
سموم	s u m uː m
هما	h u m aː
خبز	x a b z
شهدانج	ʃ a h d aː n a d͡ʒ
خير	x a j r
جمعة	d͡ʒ u m ʕ a
تأوه	t a ʔ a w w a h a
فهم	f a h m
مركب	m a r k a b
طين	tˤ iː n
بطء	b u tˤ u ʔ
أصفر	ʔ a sˤ f a r
قازاقستان	q aː z aː q i s t aː n
كامل	k aː m i l
محافظ	m u ħ aː f a ðˤ
أبرز	ʔ a b r u z a
مخرفة	m a x r a f a
جملة	d͡ʒ u m l a
محاور	m u ħ aː w i r
قصيبة	q u sˤ a j b a
انفرط	i n f a r a tˤ a
سفاح	s i f aː ħ
برجل	b a r d͡ʒ a l
عاين	ʕ aː j a n a
بطارقة	b a tˤ aː r i q a
عجرم	ʕ u d͡ʒ r u m
مسطرات	m i s tˤ a r aː t
ظهر	ðˤ a h h a r a
أولى	ʔ u l aː
آل	ʔ aː l
أودى	ʔ a w d aː
طائرة	tˤ aː ʔ i r a
لله	l i l l aː h i
فطيسة	f i tˤ tˤ iː s a
دلاع	d u l l aː ʕ
مشارة	m a ʃ aː r a
آية	ʔ aː j a
لصق	l a sˤ i q a
حصاد	ħ a sˤ sˤ aː d
تسعمائة	t i s ʕ u m i ʔ a
برمائي	b a r m aː ʔ i j j
شمسي	ʃ a m s i j j
أرضي	ʔ a r dˤ i j j
مقارنة	m u q aː r a n a
أشل	ʔ a ʃ a l l
شقوة	ʃ a q w a
باح	b aː ħ a
مزج	m a z a d͡ʒ a
عن	ʕ a n
خباز	x u b b aː z
بيض	b a j j a dˤ a
لجوء	l u d͡ʒ uː ʔ
حانوت	ħ a w aː n iː t
كثيرا	k a θ iː r a n
رقيق	r a q iː q
ضباب	dˤ a b b aː b
جلد	d͡ʒ i l d
ذنب	ð a n a b
زرع	z a r ʕ
تنفس	t a n f a s a
فوتنج	f uː t a n a d͡ʒ
باب	b aː b
قطع	q i tˤ a ʕ
جفن	d͡ʒ a f n
متزاوج	m u t a z aː w i d͡ʒ
هاته	h aː t i h i
تخم	t u x m
الأندلس	a l ʔ a n d a l u s
حكاية	ħ i k aː j a
نيجيريا	n iː ɡ iː r i j aː
عزى	ʕ a z aː
جوافة	d͡ʒ a w aː f a
إبريز	ʔ i b r iː z
تسلط	t a s a l l a tˤ a
عسقلان	ʕ a s q a l aː n
أفلاطوني	ʔ a f l aː tˤ uː n i j j
قلب	q a l l a b a
زربية	z i r b i j j a
لبى	l a b b aː
نضو	n i dˤ w
سلسلة	s i l s i l a
دشمة	d u ʃ m a
غيبة	ɣ a j b a
ضواحي	dˤ a w aː ħ iː
تايلند	t aː j l a n d
أولى	ʔ a w l aː
زنباعة	z a n b aː ʕ a
بلاستيكي	b l a s t iː k i j j
محول	m u ħ a w w i l
إقليميا	ʔ i q l iː m i j aː
سبب	s a b b a b a
شخر	ʃ a x a r a
حبل	ħ a b l
مفروغ	m a f r uː ɣ
موسكو	m uː s k uː
إشبين	ʔ i ʃ b iː n
سيجارة	s i d͡ʒ aː r a
شلة	ʃ a l l a
نيتروجين	n i t r o d͡ʒ iː n
زخة	z a x x a
خشاب	x a ʃ ʃ aː b
جمال	d͡ʒ i m aː l
ديسمبر	d iː s a m b i r
خطف	x a tˤ a f a
تفقد	t a f a q q a d a
أضاع	ʔ a dˤ aː ʕ a
اتصل	i t t a sˤ a l a
استفز	i s t a f a z z a
استشرق	i s t a ʃ r a q a
قلب	q u l b
مخدر	m u x a d d i r
عنصر	ʕ u n sˤ u r
حادثة	ħ aː d i θ a
ذاق	ð aː q a
تسامح	t a s aː m a ħ a
دلاعة	d a l l aː ʕ a
نجار	n a d͡ʒ d͡ʒ aː r
إطرية	ʔ i tˤ r i j a
قتلة	q i t l a h
هم	h i m m
قاتل	ɡ aː t a l
إلياس	ʔ i l j aː s
أعف	ʔ a ʕ a f f a
شم	ʃ a m m a
إشبيلية	ʔ i ʃ b iː l j a
أكل	ʔ u k l
رواقي	r i w aː q i j j
أغلب	ʔ a ɣ l i b
رائب	r aː ʔ i b
طبيبة	tˤ a b iː b a
غرد	ɣ a r a d
صمم	sˤ a m m a m a
يونيو	j uː n i j oː
أندر	ʔ a n d a r a
صحيح	sˤ a ħ iː ħ
أعمى	ʔ a ʕ m aː
أوحد	ʔ a w ħ a d
آدب	ʔ aː d i b
خبر	x a b u r a
جهاد	d͡ʒ a h aː d
ة	r
وبخ	w a b b a x a
عوج	ʕ i w a d͡ʒ
زرافة	z a r aː f a
أمس	ʔ u m a s s i
دفلى	d i f l aː
مستقيم	m u s t a q iː m
بندق	b u n d u q
حصن	ħ i sˤ n
أغرق	ʔ a ɣ r a q a
وفق	w a f f a q a
مستدير	m u s t a d iː r
كمثرى	k u m m a θ r aː
كثيرا	k a θ iː r aː
كراني	k a r r aː n i j j
لاحق	l aː ħ i q
تفريغ	t a f r iː ɣ
فراولة	f a r aː w l a
قفة	q u f f a
قاعة	q aː ʕ a
بيدر	b a j d a r
كوالا	k u w aː l aː
لمع	l a m m a ʕ a
قذيفة	q a ð iː f a
غمامة	ɣ i m aː m a
قانون	q aː n uː n
تحدى	t a ħ a d d aː
آذريون	ʔ aː ð a r j uː n
باقلى	b aː q i l l aː
صدرية	sˤ i d r i j j a
خلع	x a l a ʕ a
صرصار	sˤ i r sˤ aː r
مخيم	m u x a j j a m
أغار	ʔ a ɣ aː r a
حرقوص	ħ a r q uː sˤ
ترميم	t a r m iː m
شراب	ʃ a r r aː b
دهشة	d a h ʃ a
بن	b i n n a
إسرائيلي	ʔ i s r aː ʔ iː l i j j
رطب	r a tˤ i b
صفر	sˤ a f a r
أموي	ʔ u m a w i j j
قسنطينة	q u s a n tˤ iː n a
أمي	ʔ u m m i j j
فصولياء	f a sˤ uː l i j aː ʔ
ثوري	θ uː r iː
ركل	r a k a l a
شمراخ	ʃ i m r aː x
حج	ħ a d͡ʒ d͡ʒ a
عرف	ʕ a r a f a
توضح	t a w a dˤ dˤ a ħ a
عاد	ʕ aː d a
جنب	d͡ʒ a n n a b a
هنا	h u n aː
ديسمبر	d iː s i m b a r
ذهن	ð i h n
تشيكوسلوفاكيا	t ʃ e k o s l o v aː k i j aː
انحاز	i n ħ aː z a
يسار	j u s aː r a
معماري	m i ʕ m aː r i j j
ثريد	θ a r iː d
مدني	m a d a n i j j
خلر	x u l l a r
ريح	r a j j i ħ
حدوة	ħ i d w a
لج	l u d͡ʒ d͡ʒ
سياع	s a j aː ʕ
خصوص	x u sˤ uː sˤ
ابتذل	i b t a ð a l a
مدفأ	m i d f a ʔ
داخ	d aː x a
آمين	ʔ aː m iː n a
فقري	f i q r i j j
هاء	h aː ʔ a
لام	l aː m a
عمى	ʕ a m m aː
بخت	b a x t
إبريل	ʔ i b r iː l
اتجه	i t t a d͡ʒ a h a
اختطف	i x t a tˤ a f a
شيعة	ʃ iː ʕ a
تراجم	t a r aː d͡ʒ i m
ثقل	θ i q l u n
مشط	m i ʃ tˤ
لوز	l uː z
ابنة	i b n a
أبهج	ʔ a b h a d͡ʒ a
شعر	ʃ i ʕ r
مفلفل	m u f a l f a l
مقصر	m u q a sˤ sˤ a r
بليحا	b a l iː ħ aː
إسبغول	ʔ i s b a ɣ oː l
غراب	ɣ u r aː b
قسطران	q a s tˤ a r aː n
خيالي	x a j aː l i j j
تصفح	t a sˤ a f f a ħ a
الصربية	a sˤ sˤ i r b i j j a
محنة	m i ħ n a
حقوقي	ħ u q uː q i j j
تفاح	t u f f aː ħ
شرعي	ʃ a r ʕ i j j
برق	b a r a q a
هجاء	h a d͡ʒ d͡ʒ aː ʔ
شدة	ʃ i d d a
اثنان	i θ n aː n
ضرب	dˤ u r i b a
نعال	n i ʕ aː l
ذميم	ð a m iː m
منطقة	m ə n tˤ ə ɡ ə
صفيحة	sˤ a f iː ħ a
كزبرة	k ə z b ə r ə
مدرسة	m u d a r r a s a
أحجم	ʔ a ħ d͡ʒ a m a
رماد	r a m aː d
صحى	sˤ a ħ ħ aː
حرف	ħ a r r a f a
مختصر	m u x t a sˤ i r
زخات	z a x x aː t
ديناميكا	d iː n aː m iː k aː
تداع	t a d aː ʕ i n
استقبال	s t i q b aː l
قدم	q a d a m
فرفحين	f a r f a ħ iː n
مكتبة	m a k t a b a
رفاهة	r a f aː h a
طاقية	tˤ aː q i j j a
منقار	m i n q aː r
تجوف	t a d͡ʒ a w w a f a
إعراب	ʔ i ʕ r aː b
مقابلة	m u q aː b a l a h
موسكو	m o s k uː
أبله	ʔ a b l a h
قهوة	ɡ a h w a
هندس	h a n d a s a
إثيوبيا	ʔ i θ j uː b i j aː
يا	j aː
ذكر	ð a k k a r a
كلح	k a l a ħ a
خرطال	x a r tˤ aː l
قبول	q a b uː l
ضرط	dˤ a r i tˤ a
لأن	l i ʔ a n
بيرق	b a j r a q
إكليل	ʔ i k l iː l
إرهاب	ʔ i r h aː b
بيض	b iː dˤ
بن	b u n n
خز	x a z z
خنشار	x i n ʃ aː r
بدر	b a d r
زيت	z a j t
استجمام	i s t i d͡ʒ m aː m
ملك	m a l a k
استفرغ	i s t a f r a ɣ a
ذهب	ð a h h a b a
ضيون	dˤ a j w a n
بربري	b a r b a r i j j
سينما	s iː n a m aː
سوريا	s uː r i j aː
هبة	h i b a
شاشية	ʃ aː ʃ i j j a
تاريخية	t aː r iː x i j j a
أعز	ʔ a ʕ a z z
امتحان	i m t i ħ aː n
ماذا	m aː ð aː
نجاح	n a d͡ʒ aː ħ
لأن	l i ʔ a n n a
أجاب	ʔ a d͡ʒ aː b a
هاد	h aː d a
عتبة	ʕ a t a b a
النيجر	a n n iː d͡ʒ a r
قابلة	ʔ aː b l e
برشام	b u r ʃ aː m
ضربة	dˤ a r b a
عمان	ʕ a m m aː n
إشعاعي	ʔ i ʃ ʕ aː ʕ i j j
طقس	tˤ a ʔ ə s
تمسيد	t a m s iː d
يونيو	j uː n i j uː
واحات	w aː ħ aː t
بطارخ	b u tˤ aː r i x
غربالي	ɣ i r b aː l i j j
كبة	k i b b a
ضرب	dˤ a r a b
عجلة	ʕ a d͡ʒ a l a
كون	k a w n
متى	m a t aː
قاتل	q aː t i l
كسيح	k a s iː ħ
بلوة	b i l a n
سدارة	s a d aː r a
منجى	m a n d͡ʒ a n
استئمارة	i s t i ʔ m aː r a
مبتلى	m u b t a l a n
ضرب	dˤ a r i b a
مبشرة	m i b ʃ a r a
فبراير	f i b r aː j i r
قنص	q a n sˤ
أمريكي	ʔ a m r iː k i j j
لاحم	l aː ħ i m
خزف	x a z a f
إذاعة	ʔ i ð aː ʕ a
لهي	l a h i j a
ورق	w a r a q
ثمان	θ a m aː n i n
عيان	ʕ a j j aː n
طعن	tˤ i ʕ n a
اجتماع	i d͡ʒ t i m aː ʕ
محافظة	m u ħ aː f a ðˤ a
جريدة	d͡ʒ a r iː d a
قائمة	q aː ʔ i m a
شاورما	ʃ aː w a r m aː
وقع	w a q a ʕ a
الفاتيكان	a l f a t i k aː n
رهج	r a h a d͡ʒ
جوز	d͡ʒ oː z
وثق	w a θ i q a
عظ	ʕ i ðˤ
رحمن	r a ħ i m n a
جص	d͡ʒ i sˤ sˤ
سبسب	s a b s a b a
نيويورك	n i j uː j o r k
بنت	b i n t a
جائع	d͡ʒ aː ʔ i ʕ
مطاف	m a tˤ aː f
هال	h aː l a
زغاية	z a ɣ aː j a
حصاد	ħ i sˤ aː d
قاعة	ʔ aː ʕ a
امرأ	i m r a ʔ a
جلباب	d͡ʒ i l b aː b
كنباث	k i m b aː θ
شكري	ʃ u k r i j j
مدفع	m i d f a ʕ
ثمن	θ a m a n
إبريق	ʔ i b r iː q
تفسيري	t a f s iː r i j j
إفريقيا	ʔ i f r iː q j aː
مزق	m a z z a q a
شبح	ʃ a b ħ
أم	ʔ u m m
مجن	m i d͡ʒ a n n
فهرس	f ə h r ə s
ردة	r i d d a
وجدة	w a d͡ʒ d a
فرث	f a r θ
تعريف	t a ʕ r iː f
ضمير	dˤ a m iː r
متسامح	m u t a s aː m i ħ
لوط	l uː tˤ
تلاش	t a l aː ʃ i n
شيراز	ʃ iː r aː z
فسر	f a s s a r a
علم	ʕ a l l a m a
إهليلجي	ʔ i h l iː l a d͡ʒ i j j
مخبأ	m a x b a ʔ
قرنبيط	q a r n a b iː tˤ
وليمة	w a l iː m a
بثن	b a θ a n
ثقل	θ a q q a l a
إسطبل	ʔ i s tˤ a b l
ضفدع	dˤ u f d a ʕ
صراع	sˤ i r aː ʕ
دياقود	d i j aː q uː d
مجمد	m u d͡ʒ a m m a d
بدوي	b a d a w i j j
حفيدة	ħ a f iː d a
صندوق	sˤ u n d uː q
وشيك	w a ʃ iː k
اعتداء	i ʕ t i d aː ʔ
تلميح	t a l m iː ħ
انتظام	i n t i ðˤ aː m
حريم	ħ a r iː m
نقدا	n a q d a n
إسفنط	ʔ i s f a n tˤ
سويسري	s u w iː s r i j j
أدبي	ʔ a d d i b iː
قماش	q u m aː ʃ
قرصان	q u r sˤ aː n
قنطرة	q a n tˤ a r a
إبل	ʔ i b i l
لكز	l a k z
فقير	f a q iː r
ثرى	θ a r a n
مقلياثا	m a q l i j aː θ aː
غيور	ɣ a j uː r
دابرة	d aː b i r a
غسالة	ɣ a s s aː l a
حنطة	ħ i n tˤ a
نوح	n uː ħ
شكال	ʃ i k aː l
دبج	d a b b a d͡ʒ a
مماس	m u m aː s s
مشيمة	m a ʃ iː m a
فهرس	f i h r i s
عاد	ʕ aː d
لصق	l a sˤ sˤ a q a
آمن	ʔ aː m a n u
تذاكى	t a ð aː k aː
ورشان	w a r a ʃ aː n
طرفاء	tˤ u r a f aː ʔ
شاكرة	ʃ aː k i r a
أشرفي	ʔ a ʃ r a f i j j
قديم	ɡ a d iː m
دين	d a j j i n
بيطرة	b a j tˤ a r a
مري	m u r iː
مشرق	m a ʃ r i q
زأر	z a ʔ a r a
فليفلة	f u l a j f i l a
أنفاق	ʔ u n f aː q
كره	k a r r a h a
تحرش	t u ħ a r r i ʃ
حملة	ħ a m l a
رائع	r aː ʔ i ʕ
أحور	ʔ a ħ w a r
قطار	q i tˤ aː r
زحف	z a ħ a f a
مروض	m u r a w w a dˤ
زملاء	z u m a l aː ʔ
إيقاع	ʔ iː q aː ʕ
برغوث	b u r ɣ uː θ
جزيرة	d͡ʒ a z iː r a
ابن	i b n i
لاسلكي	l aː s i l k i j j
خف	x a f f a
انتبه	i n t a b a h a
أزعج	ʔ a z ʕ a d͡ʒ a
جوي	d͡ʒ a w w i j j
أيل	ʔ a j j a l
ضياع	dˤ a j aː ʕ
قبر	ɡ a b a r
درس	d a r a s a
بوصلة	b uː sˤ l a
شيم	ʃ a j j a m a
فنجنكشت	f a n d͡ʒ a n k u ʃ t
قال	q aː l
زبل	z a b b a l a
قيلولة	q a j l uː l a
خرفة	x u r f a
خرج	x a r a d͡ʒ a
تزويد	t a z w iː d
مستوقد	m u s t a w q a d
جهة	d͡ʒ i h a
أطاح	ʔ a tˤ aː ħ a
صوفي	sˤ uː f i j j
مفاجأة	m u f aː d͡ʒ a ʔ a
جاب	d͡ʒ aː b a
قارن	q aː r a n a
مسرح	m a s r a ħ
حفيد	ħ a f iː d
ناحية	n aː ħ i j a
كنزة	k a n z a
عاب	ʕ aː b a
نيلج	n a j l a d͡ʒ
جفن	d͡ʒ i f i n
ركع	r a k a ʕ a
حجرة	ħ u d͡ʒ r a
تفوق	t a f a w w a q a
حلتيت	ħ a l t iː t
كم	k u m
براءة	b a r aː ʔ a
داخل	d aː x a l a
ترياق	t i r j aː q
اذلولى	i ð l a w l aː
أصفر	ʔ a sˤ f a r a
أنطاكية	ʔ a n tˤ aː k i j a
موزمبيق	m oː z a m b iː q
كمأ	k a m a ʔ
كرسي	k u r s i j j
خدش	x a d d a ʃ a
همزة	h a m z a
تواطؤ	t a w aː tˤ u ʔ
شريعة	ʃ a r iː ʕ a
توبة	t o b ɐ
حذفي	ħ a ð a f i j j
رغائف	r a ɣ aː j i f
خرنباش	x u r a n b aː ʃ
مسود	m ɪ s w ɐ d̚
ثآليل	θ a ʔ aː l iː l
متوسط	m u t a w a s s i tˤ
ديبوذ	d a j aː b uː ð
أطرش	ʔ a tˤ r a ʃ
مكون	m u k a w w i n
قاقلة	q aː q i l l a
أندر	ʔ a n d a r
جدد	d͡ʒ a d d a d a
قريدسة	q u r a j d i s a
قيمة	ɡ iː m a
هن	h i n
تقدد	t a q a d d a d a
دلو	d a l w
سميد	s a m iː d
جريب	d͡ʒ u r a j b
دمع	d a m ʕ
آ	ʔ aː
شقة	ʃ u q q a
لبلاب	l a b l aː b
قطعة	q a tˤ a ʕ a
برغي	b u r ɣ i j j
ثيوقراطي	θ i j uː q r aː tˤ i j j
عوينات	ʕ u w a j n aː t
مبتل	m u b t a l i n
ققنوس	q u q n uː s
نظارة	n a ðˤ ðˤ aː r a
تقويم	t a q w iː m
هيا	h a j j aː
سرقين	s i r q iː n
وقية	w i q i j j a
مقصود	m a q sˤ uː d
لوح	l oː ħ
حديث	ħ a d iː θ
بورندي	b u r u n d iː
حظيرة	ħ a ðˤ iː r a
بهمن	b a h m a n
وقية	w u q i j j a
مرقاق	m i r q aː q
كليل	k a l iː l
رومانسي	r uː m aː n s i j j
سنونوة	s u n uː n u w a
رمادي	r a m aː d i j j
صرب	sˤ a r a b a
دون	d a w w a n a
ظفر	ðˤ a f i r a
محاصر	m u ħ aː sˤ i r
قشر	ɡ i ʃ i r
بطم	b u tˤ m
قرقس	q i r q i s
انتقاض	i n t i q aː dˤ
مساومة	m u s aː w a m a
تاء	t aː ʔ
سبح	s a b a ħ a
مختصر	m u x t a sˤ a r
شرب	ʃ u r b
لقاح	l a q aː ħ
تباكى	t a b aː k aː
اتجاهات	i t t i d͡ʒ aː h aː t
كاكنج	k aː k i n d͡ʒ
بريطاني	b a r iː tˤ aː n i j j
ناسك	n aː s i k
رب	r a b b a
سعي	s u ʕ i j a
دم	d u m
أغلب	ʔ a ɣ l a b u
ل	l
أقضى	ʔ a q dˤ aː
زهرة	z u h r a
تبشير	t a b ʃ iː r
ملك	m a l l a k a
شيرج	ʃ iː r i d͡ʒ
بعيثران	b a ʕ a j θ a r aː n
حرق	ħ a r a ɡ
مشكور	m a ʃ k uː r
رحب	r a ħ a b
اليونان	a l j uː n aː n
قرنفل	q a r a n f u l
فسيفساء	f u s a j f i s aː ʔ
جارة	d͡ʒ aː r a
أخدود	ʔ u x d uː d
قابلة	ʔ a b l a
صحا	sˤ a ħ aː
وقت	w a ʔ t
براين	b r aː j a n
شمس	ʃ a m m a s a
جبل	d͡ʒ a b a l a
استبد	i s t a b a d d a
اجتاز	i d͡ʒ t aː z a
قمل	q a m l
قشع	q a ʃ a ʕ a
أن	ʔ a n
أشهد	ʔ a ʃ h a d a
تراب	t u r aː b
بنت	b a n a t
كره	k a r i h
إنجلترا	ʔ i n ɡ i l t e r aː
خاء	x aː ʔ
معين	m u ʕ a j j a n
شاهدانق	ʃ aː h d aː n a q
تفاوض	t a f aː w u dˤ
روبيان	r uː b i j aː n
غ	ʁ
لبوس	l a b uː s
سبتمبر	s i b t i m b i r
عربز	ʕ a r b a z
شتاء	ʃ i t aː ʔ
صبر	sˤ a b i r
أغلب	ʔ a ɣ l i b a
أثل	ʔ a θ l
يعقوب	j a ʕ q uː b
أسهل	ʔ u s a h h a l a
إنقاض	ʔ i n q aː dˤ
ريفي	r iː f i j j
دهليز	d i h l iː z
ميعاد	m iː ʕ aː d
نظيف	n a ðˤ iː f
تفسير	t a f s iː r
شاكوش	ʃ aː k uː ʃ
سفرجلة	s a f a r d͡ʒ a l a
أيام	ʔ a j j aː m
للأسف	l i l ʔ a s a f
نساء	n i s aː ʔ
الأوكيناوا	a l ʔ uː k iː n aː w aː
لازوردي	l aː z u w a r d i j j
متفجرات	m u t a f a d͡ʒ d͡ʒ i r aː t
قشد	q a ʃ a d a
مهندس	m u h a n d i s
حمزة	ħ a m z a h
عنصل	ʕ u n sˤ a l
إفرند	ʔ i f r i n d
دبقي	d i b q i j j
امرؤ	u m r u ʔ
ظفر	ðˤ u f r
مطحنة	m a tˤ ħ a n a
وعد	w a ʕ a d a
شاورما	ʃ ɐ w ə r m ə
كشمش	k i ʃ m i ʃ
بخير	b i x a j r
جزيرة	ɡ a z iː r a
ولد	w a l l a d a
هزة	h a z z a
صقنقور	sˤ a q a n q uː r
وريد	w a r iː d
شاور	ʃ aː w a r a
خلقي	x i l q i j j
أعمى	ʔ u ʕ a m m aː
نعامة	n a ʕ aː m a
أوج	ʔ a w d͡ʒ
طاجن	tˤ aː d͡ʒ i n
اتضح	i t t a dˤ a ħ a
تدريب	t a d r iː b
ثقافة	θ a q aː f a
مغطس	m a ɣ tˤ i s
هودج	h a w d a d͡ʒ
قبض	q a b a dˤ a
احتراق	i ħ t i r aː q
رائعة	r aː ʔ i ʕ a
أوجد	ʔ uː d͡ʒ a d a
ناردين	n aː r a d iː n
موقف	m a w q i f
عجاب	ʕ u d͡ʒ aː b
فور	f a w r
إناء	ʔ i n aː ʔ
أسفر	ʔ a s f a r a
مبارك	m u b aː r a k
أب	ʔ a b
عجب	ʕ u d͡ʒ b
متطرف	m u t a tˤ a r r i f
بيرو	b eː r uː
رب	r u b b
شاط	ʃ aː tˤ a
برقوق	b u r q uː q
شكرا	ʃ u k r a n
خلق	x a l q
أنعل	ʔ a n ʕ u l
مفتش	m u f a t t i ʃ
دثر	d a θ r
كمان	k a m aː n
كرة	k a r r a
بغي	b a ɣ i j j
فنار	f a n aː r
نفخ	n a f x
السعودية	a s s u ʕ uː d i j j a
ترفع	t a r a f f a ʕ a
ضحك	dˤ a ħ i k a
حياة	ħ a j aː h
قلاووز	q a l aː w uː z
طيهوج	tˤ iː h uː d͡ʒ
لاتفيا	l aː t v i j aː
رباط	r i b aː tˤ
زرقون	z a r q uː n
توعوي	t a w ʕ a w i j j
كذاب	k a d d aː b
سلم	s u l l a m
ر	r aː ʔ
فالجي	f aː l a d͡ʒ i j j
زائف	z aː ʔ i f
توقيف	t a w q iː f
برتقالي	b u r t u q aː l i j j
ألهى	ʔ a l h aː
منهج	m a n h a d͡ʒ
قتل	q a t t a l a
جهد	d͡ʒ a h a d a
نظير	n a ðˤ iː r
مست	m a sː a t
اقتعد	i q t a ʕ a d a
كستج	k u s t a d͡ʒ
سنبك	s u m b a k
هش	h a ʃ ʃ
أم	ʔ a m m a
دلاع	d a l l aː ʕ
مزاد	m a z aː d
قداحة	q a d d aː ħ a
محادث	m u ħ aː d i θ
لحق	l a ħ q
مذكر	m u ð a k k a r
ترعة	t u r ʕ a
فاصولياء	f a sˤ uː l i j aː ʔ
سيل	s a j l
دعش	d a ʕ ʕ a ʃ a
هندسي	h a n d a s i j j
وزغة	w a z a ɣ a
أيون	ʔ a j oː n
بابونج	b aː b uː n a d͡ʒ
هال	h aː l
النمسا	a n n a m s aː
حديقة	ħ a d iː ɡ a
شيم	ʃ iː m
غرق	ɣ a r r a q
ما	m aː
قناع	q i n aː ʕ
فانيد	f aː n iː d
ضرب	dˤ a r b
كندوج	k a n d uː d͡ʒ
مقبل	m u q b i l
بلادونا	b i l aː d uː n aː
ألم	ʔ a l a m
طاعة	tˤ aː ʕ a
زوجة	z a w d͡ʒ a
قشطة	q i ʃ tˤ a
ه	h
ثلاثون	θ a l aː θ uː n a
طباق	tˤ i b aː q
نزعة	n a z ʕ a
ضيق	dˤ iː q
تعصر	t a ʕ a sˤ sˤ a r a
مجري	m a d͡ʒ a r i j j
ضيعة	dˤ a j ʕ a
أبريل	ʔ a b r iː l
فوار	f a w w aː r
أحسن	ʔ a ħ s u n a
حرش	ħ a r a ʃ a
أرز	ʔ a r u z z
مقدونس	m a q d uː n i s
توبة	t a w b a
قسم	q i s a m
شعبة	ʃ u ʕ b a
حان	ħ aː n a
سويسري	s w iː s r i j j
جراد	d͡ʒ a r aː d
بلس	b u l u s
منسأة	m i n s a ʔ a
غزاوة	ɣ a z aː w a
شيح	ʃ iː ħ
رفقة	r u f q a
علقة	ʕ a l a q a
فرغ	f a r i ɣ
أنغولا	ʔ a n ɣ oː l aː
قاموس	q aː m uː s
العاصي	a l ʕ aː sˤ iː
زهرة	z a h r a
مخرج	m u x r i d͡ʒ
إصطبل	ʔ i sˤ tˤ a b l
قداد	q i d d aː d
ضمني	dˤ i m n i j j
قطلب	q a tˤ l a b
من	m a n
خابية	x aː b i j a
ذراع	ð i r aː ʕ
فيج	f u j uː d͡ʒ
الثلاثاء	a θ θ u l aː θ aː ʔ
سعي	s a ʕ j
تصعيد	t a sˤ ʕ iː d
كم	k a m
ثيتل	θ a j t a l
كهف	k ə h f
دب	d a b b a
حجن	ħ a d͡ʒ a n a
حوب	ħ uː b
كاسيت	k aː s iː t
إلى	ʔ i l a n
قرطاس	q u r tˤ aː s
قشف	q a ʃ i f a
ابتسام	i b t i s aː m
حفار	ħ a f f aː r
جبل	d͡ʒ a b l
اختط	i x t a tˤ tˤ a
مخاض	m a x aː dˤ
جم	d͡ʒ a m m
سوراني	s uː r aː n i j j
حب	ħ a b b
سبعون	s a b ʕ uː n a
أذن	ʔ a ð a n a
كدس	k a d s
قفازات	q u f f aː z aː t
مناعة	m a n aː ʕ a
هامش	h aː m i ʃ
حرف	ħ a r a f a
مقدر	m u q a d d a r
مقولة	m a q uː l a
مقود	m i q w a d
ضاد	dˤ aː d
تمرين	t a m u r r iː n a
داخل	d aː x i l
نير	n a j j i r
زق	z u q q
أسطوانة	ʔ u s tˤ u w aː n a
جنطيانا	d͡ʒ a n tˤ i j aː n aː
إرادي	ʔ i r aː d i j j
تنوير	t a n w iː r
بوصلة	b a w sˤ a l a
تغذية	t a ɣ ð i j a
جمل	d͡ʒ a m a l
مومسة	m uː m i s a
مجادلة	m u d͡ʒ aː d a l a h
محسة	m i ħ a s s a
حاء	ħ aː ʔ
مستنقعات	m u s t a n q a ʕ aː t
الإسلام	a l ʔ i s l aː m
تسلم	t a s a l l a m a
عباء	ʕ a b aː ʔ
تسلم	t a s a l l u m
رب	r a b b
أسباب	ʔ a s b aː b
ضمن	dˤ i m n a
أغلب	ʔ u ɣ l a b a
اعتقل	i ʕ t a q a l a
هيدروجين	h i d r o ʒ eː n
سيئ	s a j j i ʔ
بركة	b a r a k a
لثغة	l u θ ɣ a t u n
نخل	n a x x a l a
السودان	a s s uː d aː n
عري	ʕ a r i j a
قدوم	q a d uː m
عنكبوت	ʕ a n aː k i b
لكن	l aː k i n n a
عقاري	ʕ a q aː r i j j
ضرب	dˤ a r a b a
متراس	m i t r aː s
طيرة	tˤ a j r a
أبنوس	ʔ a b a n uː s
قلادة	q i l aː d a
ق	ʔ
من	m i n
فلان	f u l aː n
سوفياتي	s u f j aː t i j j
شليل	ʃ a l iː l
حميم	ħ a m iː m
أعصر	ʔ a ʕ sˤ a r a
نقض	n u q dˤ a
أنزل	ʔ a n z a l a
لكم	l a k a m a
شونة	ʃ uː n a
كأن	k a ʔ a n n a
فظع	f a ðˤ i ʕ a
لقمة	l u q m a
تضامني	t a dˤ aː m u n i j j
ضمن	dˤ a m m a n a
لون	l a w n
أوروبي	ʔ uː r uː b b i j j
حلقة	ħ a l q a
ملاك	m u l l aː k
انتظم	i n t a ðˤ a m a
أوحال	ʔ a w ħ aː l
قلاية	q i l l aː j a
سكن	s a k a n
مجسم	m u d͡ʒ a s s a m
مقام	m a ɡ aː m
استفتى	i s t a f t aː
غزال	ɣ a z aː l
تذبذب	t a ð a b ð a b a
كمح	k a m a ħ a
صدق	sˤ a dː a q a
بلور	b i l l uː r
قام	ɡ aː m
انقرض	i n q a r a dˤ a
أصهب	ʔ a sˤ h a b a
ثقة	θ i q a
جامايكا	d͡ʒ a m a j k aː
بيلاروسيا	b e l a r uː s j aː
تبحر	t a b a ħ ħ a r a
اعتزل	i ʕ t a z a l a
دائمي	d aː ʔ i m i j j
نوم	n a w w a m a
مخالف	m u x aː l i f
حجاب	ħ d͡ʒ ɑː b
رحب	r a ħ i b a
كامبودي	k aː m b uː d i j j
طرفاء	tˤ a r f aː ʔ
الأشهل	a l ʔ a ʃ h a l
لبأ	l i b a ʔ
قرية	q a r i j j a
مديرة	m u d iː r a
محمدة	m u ħ a m m a d a
قلائد	q a l aː ʔ i d
تحمس	t a ħ a m m u s
خرج	x a r d͡ʒ
فاء	f aː ʔ
مستاجر	m u s t a ʔ d͡ʒ i r
الله	a ɫ ɫ aː h u
كسحاء	k a s ħ aː ʔ
دمية	d u m j a
آمن	ʔ aː m a n
غلقة	ɣ i l q a
تهدد	t a h a d d a d a
مثل	m i θ l a
مرشة	m i r a ʃː a
شلال	ʃ a l l aː l
خردل	x a r d a l
هايتي	h a i t iː
حانوت	ħ aː n uː t
مخطوطة	m a x tˤ uː tˤ a
ضيق	dˤ a j j i q
تماسك	t a m aː s u k
أقرع	ʔ a q r a ʕ
سمن	s i m a n
انجذاب	i n d͡ʒ i ð aː b
زرقطونا	z a r q a tˤ uː n aː
قيطون	q aː tˤ uː n
هش	h a ʃ ʃ a
ظربان	ðˤ a r i b aː n
أوضح	ʔ a w dˤ a ħ a
انخفاض	i n x i f aː dˤ
عجب	ʕ a d͡ʒ i b a
برباريس	b a r b aː r iː s
أثث	ʔ a θ θ a θ a
ردع	r a d a ʕ a
قفص	q u f sˤ
قاف	q aː f
قدم	q a d d a m a
قابلة	ɡ aː b l a
حرش	ħ a r i ʃ
عباية	ʕ a b aː j a
ليرة	l a j r a
أولئك	ʔ u l aː ʔ i k a
فراغ	f a r aː ɣ
صواع	sˤ u w aː ʕ
مقاود	m a q aː w i d
سعة	s a ʕ a
عرف	ʕ u r f
ميدان	m a j d aː n
منار	m a n aː r
بستان	b u s t aː n
طخش	tˤ a x ʃ
استحم	i s t a ħ a m m a
ياء	j aː ʔ
قاء	q aː ʔ a
جوافة	d͡ʒ u w aː f a
ألوهية	ʔ u l uː h i j j a
سركنجبين	s i r k a n d͡ʒ a b iː n
أعتاب	ʔ a ʕ t aː b
فؤاد	f u ʔ aː d
إدحية	ʔ i d ħ i j a
مروض	m u r a w w i dˤ
تهذيب	t a h ð iː b
تسلل	t a s a l l a l a
جميل	d͡ʒ a m iː l
محاكمة	m u ħ aː k a m a
أمسك	ʔ a m s a k a
ركلة	r a k l a
وبال	w a b aː l
بنت	b i n t u
جذمور	d͡ʒ u ð m uː r
ناغش	n aː ɣ i ʃ a
نموذجي	n a m uː ð a d͡ʒ i j j
تين	t iː n
دمنة	d i m n a
فاصوليا	f aː sˤ uː l i j aː
زحافة	z a ħ ħ aː f a
حكمة	ħ i k m a
رف	r a f f
أدبي	ʔ a d a b i j j
اليابان	a l j aː b aː n
وأى	w a ʔ aː
فحم	f a ħ m
رصفان	r u sˤ f aː n
فن	f a n n
قلقطار	q a l q a tˤ aː r
بربخ	b a r b a x
سمن	s i m n a
شريطة	ʃ a r iː tˤ a
قطع	q a tˤ a ʕ a
صغير	sˤ a ɣ iː r
أمس	ʔ a m a s s a
زخ	z a x x a
أوقية	ʔ uː q i j j a
قرميدة	q i r m iː d a
حادث	ħ aː d i θ
عمة	ʕ a m m a
اتحاد	i t t i ħ aː d
بوصلة	b uː sˤ u l a
علي	ʕ a l iː
عماد	ʕ i m aː d
قهوة	ʔ a h w ɛ
ورس	w u r u s
تحرش	t u ħ r a ʃ
أشوس	ʔ a ʃ w a s
ممسح	m u m a s s i ħ
أبها	ʔ a b h aː
ذنب	ð a n n a b a
صحة	sˤ i ħ ħ a
مفروشات	m a f r uː ʃ aː t
خمسون	x a m s uː n a
كروياء	k a r a w j aː ʔ
لعل	l a ʕ l
شمع	ʃ a m a ʕ
ض	dˤ aː d
جمع	d͡ʒ a m a ʕ a
غسق	ɣ a s a q
درس	d a r s
بغرير	b a ɣ r iː r
أسهل	ʔ a s h u l a
حلال	ħ a l aː l
ذرة	ð u r a
تناقض	t a n aː q a dˤ a
فكرة	f i k r a
ترنج	t r i n d͡ʒ
سميت	s a m iː t
هو	w a h u w a
دراسي	d i r aː s i j j
مردقوش	m a r d a q uː ʃ
رعد	r a ʕ d
أنت	ʔ a n t
تكدس	t u k a d d i s u
مستقبل	m u s t a q b a l
عيادة	ʕ i j aː d a
ب	b aː ʔ
مدع	m u d d a ʕ i n
غانا	ɣ aː n aː
بندر	b a n d a r
باكستاني	b aː k i s t aː n i j j
أوراق	ʔ a w r aː q
مسلخ	m a s l a x
مسار	m a s aː r
شهر	ʃ a h a r a
مداد	m i d aː d
قصار	ɡ u sˤ aː r
باقلاء	b aː q i l l aː ʔ
قبعة	q u b b a ʕ a
لصاق	l i sˤ aː q
فيروز	f a j r uː z
فوري	f a w r i j j
شبقي	ʃ a b a q i j j
الخمس	a l x u m s
ثمانون	θ a m aː n uː n a
موز	m a w z
مساحة	m i s aː ħ a
شدد	ʃ a d d a d a
أعرج	ʔ a ʕ r a d͡ʒ
أذن	ʔ a ð i n a
غير	ɣ u j u r
مثقال	m i θ q aː l
لقاح	l i q aː ħ
البرازيل	a l b a r aː z iː l
شراب	ʃ u r r aː b
أصفهان	ʔ a sˤ f a h aː n
محدلة	m i ħ d a l a
صدغ	sˤ a d ɣ
أنيسون	ʔ a n iː s uː n
جلي	d͡ʒ a l i j j
قشلة	q a ʃ l a
لزج	l a z i d͡ʒ a
قراد	q u r aː d
لبنان	l u b n aː n
رستاق	r u s t aː q
أفعى	ʔ a f ʕ a n
زامبيا	z a m b i j aː
غ	ɣ a j n
عدو	ʕ a d u w w
صداقة	sˤ a d aː q a
ماميثا	m aː m iː θ aː
إمضاء	ʔ i m dˤ aː ʔ
عقل	ʕ a q l
تنازع	t a n aː z a ʕ a
عتيرة	ʕ a t iː r a
فوفل	f a w f a l
غضب	ɣ a dˤ a b
مدينة	m a d iː n a
وجود	w u ʒ uː d
أعجوبة	ʔ u ʕ d͡ʒ uː b a
إسكاف	ʔ i s k aː f
تحذير	t a ħ ð iː r
صدر	sˤ a d r
عدمية	ʕ a d a m i j j a
مجرد	m u d͡ʒ a r r a d
شلاق	ʃ a l l aː q
فيتنام	v i j e t n aː m
ضائن	dˤ aː ʔ i n
عقدة	ʕ u q d a
صنان	sˤ u n aː n
هنغاري	h a n ɣ aː r i j j
ركض	r a k dˤ
سلحفاة	s u l a ħ f aː h
لهجة	l a h ɡ a
ماسورة	m aː s uː r a
نسوان	n u s w aː n
مقدمة	m u q a d d i m a
لحظ	l a ħ ðˤ
وقت	w a ɡ t
ف	f
شخص	ʃ a x a sˤ a
كوز	k uː z
سدل	s a d a l a
إنفحة	ʔ i n f a ħ a
راوند	r aː w a n d
لزج	l a z i d͡ʒ
ققنس	q u q n u s
أعجمي	ʔ a ʕ d͡ʒ i m iː
ه	h aː ʔ
ل	ɫ
هزل	h a z l
مخفر	m a x f a r
دوليا	d u w a l i j j a n
صغر	sˤ a ɣ a r a
هم	h a m m
القطيف	ɪ l q ə tˀ i f
رحب	r u ħ b
ناسفة	n aː s i f a
مارس	m aː r i s
توفيق	t a w f iː q
علا	ʕ a l aː
بنجنكشت	b a n d͡ʒ a n k u ʃ t
امرأ	i m r a ʔ
أمازيغ	ʔ a m aː z iː ɣ
قيتار	q iː t aː r
نارجيل	n aː r a d͡ʒ iː l
كراث	k u r r aː θ
اعتقادية	i ʕ t i q aː d i j j a
صلعمي	sˤ a l ʕ a m i j j
قضائي	q a dˤ aː ʔ iː
شمام	ʃ a m m aː m
بكارة	b a k aː r a
جورب	d͡ʒ a w r a b
لم	l u m
ترجم	t a r d ʒ a m a
ز	z aː j
ناخوذة	n a w aː x i ð a
جنوب	d͡ʒ a n uː b
ملاط	m i l aː tˤ
موسى	m uː s a n
أوجد	ʔ uː d͡ʒ a d
سيد	s a j j i d
كتب	k i t aː b
وثق	w a θ θ a q a
باليه	b aː l eː h
والله	w a ‿ ɫ ɫ aː h i
صفر	sˤ i f r
بغل	b a ɣ l
حق	ħ u q q
جبان	d͡ʒ a b b aː n
بيعة	b a j ʕ a
رجل	r a d͡ʒ d͡ʒ a l a
اشتد	i ʃ t a d d a
سوريا	s uː r i j j aː
مرزبة	m i r z a b b a
القطيف	a l q a tˀ iː f
صيف	sˤ a j f
مرتعب	m u r t a ʕ i b
خوذة	x uː ð a
تزامن	t a z aː m a n a
غمامة	ɣ a m aː m a
متزوج	m u t a z a w w i d͡ʒ
بوصلة	b uː sˤ i l a
دوش	d uː ʃ
سهلا	s a h l a n
هيدروجين	h a j d r o d͡ʒ iː n
أوساكا	ʔ uː s a k aː
خادم	x aː d i m
حنفية	ħ a n a f i j j a
إلكترونيات	ʔ i l i k t r uː n i j j aː t
جميز	d͡ʒ u m m a j z
ركلات	r a k a l aː t
مصابحة	m u sˤ aː b a ħ a
لبان	l u b aː n
قاقلة	q aː q u l l a
أولي	ʔ a w w a l i j j
هي	h i j a
محدث	m u ħ a d d i θ
ضاع	dˤ aː ʕ a
تكدس	t u k a d d i s
شوحة	ʃ uː ħ a
أنبوبة	ʔ u n b uː b a
شلجم	ʃ a l d͡ʒ a m
نضب	n a dˤ a b a
إبراهيم	ʔ i b r aː h iː m
طود	tˤ a w d
خبر	x a b a r
طحلب	tˤ u ħ l u b
عناية	ʕ i n aː j a
جمهورية	d͡ʒ u m h uː r i j j a
باطية	b aː tˤ i j a
مصل	m a sˤ l
أغلب	ʔ u ɣ a l l a b a
قز	q a z z
شرعي	ʃ a r r i ʕ iː
محاسبة	m u ħ aː s a b a
قتل	q i t l
مثل	m a θ θ a l a
عطن	ʕ a tˤ a n
منتظر	m u n t a ðˤ a r
غلب	ɣ a l l a b a
راب	r aː b a
فقوسة	f a q q uː s a
أحب	ʔ a ħ a b b
غرب	ɣ u r b
أو	ʔ a w
أرجان	ʔ a r d͡ʒ aː n
تنفس	t u n a f f a s
كيلوغرام	k i l u ɡ r aː m
السبت	a s s a b t
وجبة	w a d͡ʒ b a
أعض	ʔ a ʕ a dˤ dˤ a
فلس	f u l s
انتقد	i n t a q a d a
فرأ	f a r a ʔ
قام	q aː m a
قيصوم	q a j sˤ uː m
شيخ	ʃ a j x
خبط	x a b b a tˤ a
مستفرغ	m u s t a f r i ɣ
أنزع	ʔ a n z a ʕ a
غرامة	ɣ a r aː m a
صفة	sˤ u f f a
أطل	ʔ a tˤ a l l a
قرميد	q i r m iː d
اشترى	i ʃ t a r aː
تراخوما	t i r aː x uː m aː
كوسوفو	k uː s uː f uː
جزمازج	d͡ʒ a z m aː z a d͡ʒ
دب	d u b b
بوان	b i w aː n
ثقل	θ a q u l a
يرقة	j a r a ɡ a
مصنع	m a sˤ n a ʕ u n
اصطاد	i sˤ tˤ aː d a
أممي	ʔ a m m i m iː
قتل	q a t l
مرفأ	m a r f a ʔ
ترنجان	t u r u n d͡ʒ aː n
يسار	j u s aː r r u
عنصرية	ʕ u n sˤ u r i j j a
جنينة	d͡ʒ u n a j n a
كره	k a r i h a
نون	n uː n
أيل	ʔ a j j i l
ألا	ʔ a l aː
ممسح	m i m s a ħ
ماسح	m aː s i ħ
تنديل	t a n d iː l i j j a
ليلك	l iː l a k
قضم	q a dˤ m
حالة	ħ aː l a t a
جندية	d͡ʒ u n d i j j a
أدهش	ʔ a d h i ʃ
خيرة	x i j a r a
تايلندي	t aː j l a n d i j j
شعبية	ʃ a ʕ b i j j a
دسار	d i s aː r
إريس	ʔ i r r iː s
غضب	ɣ u dˤ i b a
نقض	n a q a dˤ a
فروغ	f u r uː ɣ
شحرور	ʃ u ħ r uː r
انخرط	i n x a r a tˤ a
احتضن	i ħ t a dˤ a n a
شراب	ʃ a r aː b
فصيلة	f a sˤ iː l a
قلية	q i l l i j j a
تقرح	t a q a r r a ħ a
مضاربة	m u dˤ aː r a b a
عطن	ʕ a tˤ i n a
عشرون	ʕ i ʃ r uː n
شام	ʃ aː m a
تينة	t iː n a
أغضب	ʔ a ɣ dˤ a b a
ولاية	w i l aː j a
بلاذر	b a l aː ð i r
هو	h uː
هدس	h a d a s
علج	ʕ i l d͡ʒ
بطانة	b i tˤ aː n a
رسداق	r u s d aː q
صحافي	sˤ i ħ aː f i j j
أمستردام	ʔ a m s t i r d aː m
إيران	ʔ iː r aː n
فران	f a r r aː n
بازار	b a z aː r
متلوث	m u t a l a w w i θ
منبه	m u n a b b i h
رتيلة	r u t a j l a
أن	ʔ a n n
مخصصات	m u x a sˤ sˤ a sˤ aː t
أنقض	ʔ a n q a dˤ i
غني	ɣ a n n iː
اعتلى	i ʕ t a l aː
حصل	ħ a sˤ a l a
إربيان	ʔ i r b i j aː n
أكتوبر	ʔ u k t uː b a r
ورس	w a r s
زنخ	z a n i x a
تفاوض	t a f aː w a dˤ a
خيط	x a j tˤ
تصغير	t a sˤ ɣ iː r
جريب	d͡ʒ a r iː b
حرق	ħ a r r a q a
إبليس	ʔ i b l iː s
قذارة	q a ð aː r a
مثل	m a θ a l
ذوب	ð a w w a b a
مغناطيسية	m i ɣ n a tˤ iː s i j j a
زكام	z u k aː m
اعتل	i ʕ t a l l a
زرزر	z u r z u r
غرفة	ɣ u r f a
زجاجة	z a d͡ʒ aː d͡ʒ a
تقديم	t a q d iː m
موسكو	m o s k oː
مثل	m i θ l i
هدف	h a d a f
صناب	sˤ i n aː b
بطارخ	b a tˤ aː r i x
جاء	d͡ʒ aː ʔ a
فريق	f a r iː q
مالقة	m aː l a q a
بليحاء	b a l iː ħ aː ʔ
دم	d i m m
طالما	tˤ aː l a m aː
سن	s i n n
لكن	l aː k i n
انفرث	i n f a r a θ a
ناردين	n aː r d iː n
جرافة	d͡ʒ a r r aː f a
جنب	d͡ʒ u n i b a
فرند	f i r i n d
سيدا	s iː d aː
تحرش	t u ħ a r r a ʃ a
دينار	d iː n aː r
جرجير	d͡ʒ i r d͡ʒ iː r
سنة	s u n n a
شمالي	ʃ a m aː l i j j
صبر	sˤ a b r
صك	sˤ a k k a
عض	ʕ i dˤ dˤ
ناقض	n aː q a dˤ a
شرد	ʃ a r a d a
عجول	ʕ a d͡ʒ uː l
نوح	n a w ħ
ؤ	ʔ
إمهال	ʔ i m h aː l
رب	r a b b i
تنوب	t a n n uː b
أنطاليا	ʔ a n tˤ aː l i j aː
إما	ʔ i m m aː
زبل	z i b l
كتب	k u t u b
صواع	sˤ i w aː ʕ
فعلا	f i ʕ l a n
بعيد	b a ʕ iː d
هيبة	h a j b a
مستشرق	m u s t a ʃ r i q
أسود	ʔ u s uː d
شاخ	ʃ aː x a
انتظر	i n t a ðˤ a r a
بارز	b aː r a z a
فسا	f a s aː
عبد	ʕ a b a d a
بطؤ	b a tˤ u ʔ a
في	f iː
قوم	q a w m
غائر	ɣ aː ʔ i r
فراسيون	f a r aː s i j uː n
سيرج	s iː r i d͡ʒ
بغلة	b a ɣ l a
قدوم	q a j d uː m
هناك	h u n aː k a
توقف	t a w a q q a f a
صعب	sˤ a ʕ b
سكرجة	s u k r u d͡ʒ a
فتق	f a t q
عتيق	ʕ a t iː q
تزحلق	t a z a ħ l u q
بح	b a ħ ħ a
تصنيف	t a sˤ n iː f
رضيع	r a dˤ iː ʕ
عرقي	ʕ i r q i j j
مبارك	m u b aː r i k
إياك	ʔ i j j aː k a
رئيسي	r a ʔ iː s i j j
غالب	ɣ aː l i b
صاقور	sˤ aː q uː r
قديم	q a d iː m
قسطاس	q u s tˤ aː s
فاوض	f aː w a dˤ a
قيثارة	q iː θ aː r a
تحريضي	t a ħ r iː dˤ i j j
عضلة	ʕ a dˤ a l a
لو	l a w
بلور	b i l l a w r
ساهور	s aː h uː r
البهاما	a l b a h aː m aː
أوروغواي	ʔ uː r uː ɣ u w aː j
برذون	b i r ð a w n
سمن	s a m m a n a
طل	tˤ u l
شيمة	ʃ iː m a
بالوعات	b aː l uː ʕ aː t
شاهدانج	ʃ aː h d aː n a d͡ʒ
علل	ʕ a l l a l a
معقود	m a ʕ q uː d
سمع	s a m ʕ
جامعة	d͡ʒ aː m i ʕ a
اكتسب	i k t a s a b a
سيكران	s a j k a r aː n
صراط	sˤ i r aː tˤ
نوفمبر	n uː f i m b i r
آدمي	ʔ aː d a m i j j
صربيا	sˤ i r b i j aː
عبقري	ʕ a b q a r i j j
مطار	m a tˤ aː r
جدوار	d͡ʒ a d w aː r
قهوة	ɡ h a w a
طباخ	tˤ a b b aː x
أخرس	ʔ a x r a s
أسارون	ʔ a s aː r uː n
عظم	ʕ a ðˤ u m a
طعن	tˤ a ʕ a n a
شاي	ʃ aː j
أكتوبر	ʔ u k t uː b i r
مؤتمر	m u ʔ t a m a r
متنوع	m u t a n a w w i ʕ
هو	h u w a
درياق	d i r j aː q
أرز	ʔ u r u z z
بذرقطونا	b a ð r a q a tˤ uː n aː
أيلول	ʔ a j l uː l
فضي	f i dˤ dˤ i j j
جناح	d͡ʒ a n aː ħ
تجدد	t a d͡ʒ a d d a d a
شلة	ʃ i l l a
صاخب	sˤ aː x i b
شهادة	ʃ a h aː d a
تعفج	t a ʕ a f f a d͡ʒ a
ساج	s aː d͡ʒ
وجيز	w a d͡ʒ iː z
قرطاس	q i r tˤ aː s
تساوى	t a s aː w aː
فقوس	f a q q uː s
صلصال	sˤ a l sˤ aː l
غد	ɣ a d
مذاق	m a ð aː q
قيطون	ɡ aː tˤ uː n
قيراط	q iː r aː tˤ
فرفيري	f i r f iː r i j j
طاح	tˤ aː ħ a
حكومي	ħ u k uː m i j j
تضرر	t a dˤ a r r u r
مساحة	m a s s aː ħ a
قلوي	q i l w i j j
بس	b a s s a
إنما	ʔ i n n a m aː
أعياد	ʔ a ʕ j aː d
مفتش	m u f a t t a ʃ
صيني	sˤ iː n i j j
نظر	n i ðˤ r
نيكاراغوا	n iː k aː r aː ɣ u w aː
إ	ʔ i
ق	q
هويات	h u w i j j aː t
ثقيل	θ a q iː l
تنفس	t a n f u s a
عبوة	ʕ u b u w w a h
مارس	m aː r s
ساط	s aː tˤ a
واعد	w aː ʕ a d a
قبر	ɡ a b u r
قسيس	q i s s iː s
هراوى	h a r aː w aː
كراوية	k a r aː w i j a
أذن	ʔ a ð n
دائخ	d aː ʔ i x
تشنج	t a ʃ a n n u d͡ʒ
أذن	ʔ u ð u n
إنبيق	ʔ i n b iː q
اعتاد	i ʕ t aː d a
رسول	r a s uː l
اختبأ	i x t a b a ʔ
سكن	s a k a n a
طربوش	tˤ a r b uː ʃ
فارغ	f aː r i ɣ
لهجة	l a h d͡ʒ a
قوت	q uː t
جميل	ɡ a m iː l
محلي	m u ħ a l l i
بقية	b a q i j j a
أدار	ʔ a d aː r a
أعل	ʔ a ʕ a l l a
مسطرة	m i s tˤ a r a
شدة	ʃ a d d a
فريسة	f a r iː s a
تعذب	t a ʕ a ð ð a b a
تنامى	t a n aː m aː
ودج	ʔ a w d aː d͡ʒ
مدرك	m u d r i k
سوس	s a w w a s a
برعم	b u r ʕ u m
ولد	w a l a d a
عيد	ʕ iː d
قوض	q a w w a dˤ a
جمل	ɡ æ m ɛ l
ثعبان	t u ʕ b aː n
أحاط	ʔ u ħ aː tˤ a
كتاب	k u t t aː b
أله	ʔ a l l a h a
صغر	sˤ i ɣ a r
ضاحية	dˤ aː ħ i j a
جعفر	d͡ʒ a ʕ f a r
حسنا	ħ a s a n a n
مربى	m u r a b b aː
بارزذ	b aː r z a ð
مونتريال	m uː n t r i j aː l
أربعون	ʔ a r b a ʕ uː n a
زها	z a h aː
انقلاب	i n q i l aː b
إسكتلندي	ʔ i s k u t l a n d i j j
عميق	ʕ a m iː q
تقيأ	t a q a j j a ʔ a
فرث	f a r i θ a
رجل	r i d͡ʒ l
ڤ	v
جمعة	d͡ʒ u m u ʕ a
موضوع	m a w dˤ uː ʕ
نجار	n u d͡ʒ aː r
سنور	s i n n a w r
بعلبك	b ʕ a l b a k
ندوة	n u d u w w a
بكى	b a k aː
شهل	ʃ u h l
استل	i s t a l l a
سمع	s a m m a ʕ a
كراج	ɡ a r aː d͡ʒ
ضرب	dˤ a r u b a
قبر	ɡ u b b a r
قوقع	q a w q a ʕ
تطبب	t a tˤ a b b a b a
سماد	s a m aː d
زود	z a w w a d a
مليار	m i l j aː r
أنا	ʔ a n a
فيديو	v i d i j oː
أشخص	ʔ a ʃ x a sˤ a
خيزران	x a j z u r aː n
سبتمبر	s i b t i m b a r
أسهل	ʔ u s a h h i l a
كراز	k u r r aː z
حبق	ħ a b a q a
كهرباء	k a h r a b aː ʔ
جمعة	d͡ʒ u m a ʕ a
قافلة	q aː f i l a
طوب	tˤ uː b
هذى	h a ð aː
مات	m ō t
حورية	ħ uː r i j j a
معير	m u ʕ iː r
هو	h u w a h
ذبابة	ð u b aː b a
غباوة	ɣ a b aː w a
شبع	ʃ a b i ʕ a
أوركسترا	ʔ o r k e s t r aː
غضب	ɣ a dˤ i b
منام	m a n aː m
منطقي	m a n tˤ i q i j j
شيطاني	ʃ a j tˤ aː n i j j
أمس	ʔ a m s
نسيئة	n a s iː ʔ a
حوراء	ħ a w r aː ʔ
طقس	tˤ a q i sˤ
أشم	ʔ a ʃ a m m
دجاجة	d a d͡ʒ aː d͡ʒ a
استحوذ	i s t a ħ w a ð a
تزدان	t a z d aː n u
أجوف	ʔ a d͡ʒ w a f
طير	tˤ a j r
دب	d a b b
سحلية	s i ħ l i j j a
قرر	ɡ a r r a r
شرطة	ʃ a r tˤ a
فهم	f a h i m a
قد	q a d d a
تنرفز	t a n a r f a z a
ساسم	s aː s a m
وجهة	w i d͡ʒ h a
مغنم	m a ɣ n a m
انبغى	i n b a ɣ aː
بولندا	b oː l a n d aː
تنقض	t a n q a dˤ i
جسامة	d͡ʒ a s aː m a
ها	h aː
أتوبيس	ʔ o t o b iː s
مصراع	m i sˤ r aː ʕ
بليلة	b a l iː l a
قصبة	q a sˤ a b a
زق	z a q q
غضب	ɣ a dˤ i b a
زربطانة	z a r b a tˤ aː n a
وسخ	w a s i x
تنور	t a n a w w a r a
منشفة	m i n ʃ a f a
جحر	d͡ʒ u ħ r
مشهور	m a ʃ h uː r
تدرج	t a d a r r a d͡ʒ a
كيول	k a j j uː l
جلوز	d͡ʒ i l l a w z
قلاووظ	q a l aː w uː ðˤ
ضفدع	dˤ u f d u ʕ
حكومة	ħ u k uː m a
سن	s a n n
ش	ʃ
جهنم	d͡ʒ a h a n n a m
أكيد	ʔ a k iː d
ظ	ðˤ
انقد	i n q a d d a
شوكولاتة	ʃ o k o l aː t a
طلع	tˤ a l i ʕ a
مائدة	m aː ʔ i d a
لهيب	l a h iː b
ألفبائي	ʔ a l i f b aː ʔ i j j
ط	tˤ aː ʔ
نشيد	n a ʃ iː d
جذوع	d͡ʒ u ð uː ʕ
مفلس	m u f l i s
رفأ	r a f a ʔ a
إكاف	ʔ i k aː f
منتصف	m u n t a sˤ a f
تكدس	t u k a d d a s u
سكافة	s i k aː f a
نور	n a w w a r a
عيان	ʕ i j aː n
يورو	j uː r oː
غرب	ɣ a r a b a
آخن	ʔ aː x a n
أحبك	ʔ u ħ i b b u k i
تشخيصي	t a ʃ x iː sˤ i j j
سن	s a n n a
غرين	ɣ a r iː n
خبز	x u b z
تكدس	t u k a d d a s a
قسر	q a s a r a
قلب	q u l l a b
لندني	l a n d a n i j j
رباعيات	r u b aː ʕ i j j aː t
معدوم	m a ʕ d uː m
جدا	d͡ʒ i d d a n
عمان	ʕ u m aː n
دخل	d a x l
شجو	ʃ a d͡ʒ w
سريش	s a r iː ʃ
الإمارات	a l ʔ i m aː r aː t
أفسنتين	ʔ a f s i n t iː n
ممتلكات	m u m t a l a k aː t
متفرغ	m u t a f a r r i ɣ
موظفة	m u w a ðˤ ðˤ a f a
ثقبة	θ u q b a
المكسيك	a l m a k s iː k
جنوب	ɡ a n uː b
سيكران	s a j k u r aː n
وفق	w a f i q a
جنح	d͡ʒ u n ħ
محمدة	m a ħ m a d a
سلامتك	s a l aː m t a k
أتون	ʔ a t t uː n
إيانا	ʔ i j j aː n aː
حلبة	ħ u l b a
بوابة	b a w w aː b a
سربال	s i r b aː l
أرثوذكسي	ʔ u r θ uː ð u k s i j j
قدوم	q a d d uː m
بثرات	b a θ a r aː t
بلغاريا	b a l ɣ aː r i j aː
وجد	w a d͡ʒ d
نساء	n a s aː ʔ
فلاديمير	f l a d iː m i r
رحب	r a ħ b
بردقوش	b a r d a q uː ʃ
ساذج	s aː ð a d͡ʒ
تنفس	t a n a f f u s
طالب	tˤ aː l i b
سجا	s a d͡ʒ aː
رقابة	r a q aː b a
شمسية	ʃ a m s i j j a
فاجأ	f aː d͡ʒ a ʔ a
شاورما	ʃ aː w i r m aː
قرن	q a r n
مكياج	m ɪ k j ɑː d͡ʒ
غلب	ɣ a l a b
وتيرة	w a t iː r a
ليموني	l a j m uː n i j j
ر	r
تحرش	t u ħ a r r a ʃ
تراوح	t a r aː w a ħ a
صمغ	sˤ a m ɣ
عناية	ʕ a n aː j a
قيمة	q iː m a
ثقافي	θ a q aː f i j j
تلفون	t u l f uː n a
بلجيكا	b e l d͡ʒ iː k aː
طبعة	tˤ a b ʕ a
عناب	ʕ u n n aː b
مبرة	m ə b ə rː ə
نتف	n a t a f
استعمار	i s t i ʕ m aː r
جولق	d͡ʒ a w l a q
دهس	d a h s
بشملة	b a ʃ m a l a
شخص	ʃ a x sˤ
شجيع	ʃ a d͡ʒ iː ʕ
ثداء	θ u d d aː ʔ
قرصعنة	q u r sˤ a ʕ a n n a
ملك	m u l l a k
نبات	n a b aː t
مخيط	m i x j a tˤ
زميلات	z a m iː l aː t
مسيح	m a s iː ħ
مؤمن	m u ʔ m a n
مصباح	m i sˤ b aː ħ
تجدد	t a d͡ʒ a d d u d
رحب	r a ħ u b a
قرن	q a r a n a
تنور	t a n n uː r
قرد	q a r d
مغنيسيوم	m a ɣ n iː s i j uː m
جثمان	d͡ʒ u θ m aː n
خيبة	x a j b a
تصميم	t a sˤ m iː m
مسلم	m u s a l l a m
بعر	b a ʕ a r a
طاقم	tˤ aː q i m
قدم	q a d a m a
معدة	m i ʕ d a
دمي	d a m i j a
الأحد	a l ʔ a ħ a d
تقبض	t a q a b b a dˤ a
أسهل	ʔ u s a h h a l u
زق	z a q q a
عميد	ʕ a m iː d
قارب	q aː r i b
زاي	z aː j
فاسد	f aː s i d
مشعاع	m i ʃ ʕ aː ʕ
زيار	z i j aː r
ريح	r iː ħ a
ندبة	n u d b a
أشقر	ʔ a ʃ q a r
أجنبي	ʔ a d͡ʒ n a b i j j
بزق	b a z q
ضمن	dˤ i m n
فلم	f i l m
جربوع	d͡ʒ a r b uː ʕ
عاشوراء	ʕ aː ʃ uː r aː ʔ
إستديو	ʔ i s t i d j oː
قنص	q a n a sˤ a
مضمون	m a dˤ m uː n
ويكي	w iː k iː
محرك	m u ħ a r r i k
فسح	f a s a ħ a
جنك	d͡ʒ a n k
فلنجة	f a l a n d͡ʒ a
مثنان	m i θ n aː n
يوم	j a w m
رجع	r a d͡ʒ ʕ
حسنا	ħ a s s a n n aː
ذرة	d u r a
جورجي	d͡ʒ u r d͡ʒ i j j
سرة	s u r r a
تماسك	t a m aː s a k a
سائمة	s aː ʔ i m a
قراص	q u r r aː sˤ
بنت	b i n t i
عيد	ʕ i j a d
مدة	m a d d a
إيارج	ʔ i j aː r a d͡ʒ
سيادة	s i j aː d a
عصف	ʕ a sˤ a f a
خسئ	x a s i ʔ a
كيلومتر	k iː l o m i t e r
كتاب	k i t aː b
هن	h a n n a
يرقة	j a r a ʔ a
وصاية	w i sˤ aː j a
نضيج	n a dˤ iː d͡ʒ
قرص	q u r sˤ
خوخة	x a w x a
فجور	f u d͡ʒ uː r
سوس	s uː s
بابور	b aː b uː r
شعري	ʃ i ʕ r i j j
أوكرانيا	ʔ u k r aː n i j aː
خجول	x a d͡ʒ uː l
تكلم	t a k a l l u m
غنيمة	ɣ a n iː m a
حق	ħ u q q a
كادس	k aː d i s
قطف	q a tˤ a f a
أممي	ʔ u m a m i j j
تعطى	t u ʕ tˤ aː
أمي	ʔ u m m iː
برتقال	b u r t u q aː l
بوذا	b uː ð aː
جماعة	d͡ʒ a m aː ʕ a
قضم	q a dˤ a m
حمل	ħ a m m a l a
جدد	d͡ʒ a d a d
ضمخ	dˤ a m a x a
آذى	ʔ aː ð aː
بدهي	b a d a h i j j
استوضح	i s t a w dˤ a ħ a
سفينة	s a f iː n a
فرن	f u r n
كاكنج	k aː k a n d͡ʒ
الحارث	a l ħ aː r i θ
مئبر	m i ʔ b a r
غزير	ɣ a z iː r
محطة	m a ħ a tˤ tˤ a
قلم	ɡ a l a m
فص	f a sˤ sˤ
حلبوب	ħ u l b uː b
ساوم	s aː w a m a
أرقان	ʔ a r q aː n
صراخة	sˤ a r r aː x a
حاد	ħ aː d d
فوج	ʔ a f w aː d͡ʒ
الأردن	a l ʔ u r d u n n
عقاقير	ʕ a q aː q iː r
غوشنة	ɣ a w ʃ a n a
و	w ɪ
اعوج	i ʕ w a d͡ʒ d͡ʒ a
ديماس	d a j m aː s
طما	tˤ a m aː
آسفي	ʔ aː s a f iː
حندقوق	ħ a n d a q uː q
مشأمة	m a ʃ ʔ a m a h
خيمة	x a j m a
طوافة	tˤ a w w aː f a
طار	tˤ aː r a
عزيمة	ʕ a z iː m a
قبة	q u b b a
فلسطين	f i l a s tˤ iː n
عندما	ʕ i n d a m aː
أذن	ʔ a ð ð a n a
ولى	w a l l aː
ترمس	t i r m i s
تأثير	t a ʔ θ iː r
كمء	k a m ʔ
لام	l aː m
مختلف	m u x t a l i f
سكنجبين	s i k a n d͡ʒ a b iː n
أسهل	ʔ u s a h h i l u
عنبر	ʕ a n b a r
ضعيف	dˤ a ʕ iː f
علف	ʕ æ l æ f
بليج	b a l l iː d͡ʒ
غباء	ɣ a b aː ʔ
خروف	x a r uː f
فوج	f a w d͡ʒ
مكمل	m u k a m m i l
متجر	m a t d͡ʒ a r
لهى	l a h h aː
مقالة	m a q aː l a
بصق	b a sˤ a q a
الخميس	a l x a m iː s
كرباج	k u r b aː d͡ʒ
هراوات	h i r aː w aː t
خوخ	x a w x
مجسمة	m u d͡ʒ a s s a m a
حيصل	ħ a j sˤ a l
بطاطس	b a tˤ aː tˤ i s
نظام	n i ðˤ aː m
حش	ħ a ʃ ʃ a
شامبو	ʃ aː m b uː
حصوة	ħ a sˤ w a
ذخيرة	ð a x iː r a
مأساة	m a ʔ s aː h
فرقاطة	f u r q aː tˤ a
مستقبلي	m u s t a q b a l i j j
حقد	ħ a q a d a
تمرد	t a m a r r u d
قرش	q a r a ʃ a
كثير	k a θ iː r
براعة	b a r aː ʕ a
لامبالاة	l aː m u b aː l aː h
افترى	i f t a r aː
رجع	r a d͡ʒ d͡ʒ a ʕ a
محقق	m ʊ ħ ɐ q q ɪ q
خطف	x a tˤ f
مولدوفا	m o l d oː f aː
أمس	ʔ a m a s s u
لاحق	l aː ħ a q a
أبدية	ʔ a b a d i j j a
مداخل	m u d aː x a l
مرحلة	m a r ħ a l a
إبريق	ʔ i b r iː ɡ
مناقض	m u n aː q i dˤ
استمسك	i s t a m s a k a
بناية	b i n aː j a
كرى	k a r aː
فطيسة	f a tˤ iː s a
كلب	k a l b
مطعم	m a tˤ ʕ a m
فلان	f l ɑ n
مهاجر	m u h aː d͡ʒ i r
صدم	sˤ a d a m a
سذاجة	s a ð aː d͡ʒ a
أخطبوط	ʔ u x tˤ u b uː tˤ
حرج	ħ a r i d͡ʒ a
لكمة	l a k m a
وردة	w u r d a
سكسكة	s a k s a k a
فتاة	f a t aː h
مطحنة	m i tˤ ħ a n a
حمل	ħ i m l
بارزد	b aː r z a d
خشخاش	x a ʃ x aː ʃ
سياسة	s i j aː s a
عيسى	ʕ iː s aː
ماه	m aː h a
لغة	l ʊ ʁ ə
وابور	w aː b uː r
تعزب	t a ʕ a z z a b a
هجليج	h i d͡ʒ l iː d͡ʒ
فلاديمير	v l a d iː m i r
مجلس	m a d͡ʒ l i s
جيد	d͡ʒ iː d
أورانيوم	ʔ u r aː n j u m
هم	h a m m a
شافانج	ʃ aː f aː n a d͡ʒ
بدنة	b a d a n a
معتزلة	m u ʕ t a z i l a
طبي	tˤ i b b i j j
جربندية	d͡ʒ a r a b a n d i j j a
ناووس	n aː w uː s
ب	b
قبر	ɡ a b i r
طلح	tˤ a l ħ
تكدس	t u k d a s
سمن	s u m n a
رفس	r a f a s a
استضاف	i s t a dˤ aː f a
ضريبة	dˤ a r iː b a
قسم	q a s s a m a
حب	ħ a b b a
حرشف	ħ a r ʃ a f
خرنق	x i r n i q
مصلى	m u sˤ a l l a n
أشار	ʔ a ʃ aː r a
السويد	a s s u w a j d
ترقوة	t a r q u w a
طاعون	tˤ aː ʕ uː n
مزدهر	m ʊ z d æ h ɪ r
ترنج	t u r u n d͡ʒ
خرج	x u r d͡ʒ
ضحك	dˤ a ħ ħ a k a
زجاجة	z u d͡ʒ aː d͡ʒ a
موسيقا	m uː s iː q aː
بعير	b a ʕ iː r
جدوى	d͡ʒ a d w aː
حوار	ħ i w aː r
بحر	b a ħ a r
حبرج	ħ u b r u d͡ʒ
استثمار	i s t i θ m aː r
تواقف	t a w aː q u f
سليل	s a l iː l
شهر	ʃ a h r
معجزات	m u ʕ d͡ʒ i z aː t
مغلوب	m a ɣ l uː b
عطارد	ʕ u tˤ aː r i d
رغف	r u ɣ u f
أمامي	ʔ a m aː m i j j
اكتفاء	i k t i f aː ʔ
شريان	ʃ i r j aː n
معاداة	m u ʕ aː d aː h
ذكر	ð a k a r
بذلة	b i ð l a
ملاكمة	m u l aː k a m a
عكاز	ʕ u k k aː z
عيد	ʕ iː d a
جدد	d͡ʒ u d a d
أين	ʔ a j n
بروناي	b r uː n aː j
حجاب	ħ i ʒ aː b
صوف	sˤ uː f
أكل	ʔ u k u l
أفرغ	ʔ a f r a ɣ a
غرلة	ɣ u r l a
رح	r u ħ
هنغاري	h i n ɣ aː r i j j
الفرات	a l f u r aː t
تبغ	t i b ɣ
صندوق	sˤ a n d uː q
ورى	w ɐ r ə
أريكة	ʔ a r iː k a
براني	b a r r aː n i j j
سرداب	s i r d æː b
جذر	d͡ʒ a ð ð a r a
واجهة	w aː d͡ʒ i h a
حسنا	ħ a s u n n aː
منصب	m a n sˤ i b
عراك	ʕ i r aː k
ملوكية	m u l uː k i j j a
إزميل	ʔ i z m iː l
ملعقة	m i l ʕ a q a
أنتم	ʔ a n t u m
ج	d͡ʒ
ميثاق	m iː θ aː q
إنتاج	ʔ i n t aː d͡ʒ
خرنباش	x a r a n b aː ʃ
تلك	t i l k a
قطران	q a tˤ r aː n
مغن	m u ɣ a n n i n
تحرش	t u ħ a r r i ʃ a
حوجلة	ħ a w d͡ʒ a l a
ربما	r u b b a m aː
باحث	b aː ħ i θ
نصاب	n a sˤ sˤ aː b
فلس	f a l a s a
خبر	x a b b a r a
حادث	ħ aː d a θ a
سليخة	s a l iː x a
كيف	k a j j a f a
هنغاريا	h a n ɣ aː r i j aː
عيني	ʕ a j n i j j
شبعان	ʃ a b ʕ aː n
نحن	n a ħ n u
نشل	n a ʃ l
ث	θ aː ʔ
رد	r i d
مذيع	m u ð iː ʕ
بقي	b i ɡ i
نفوذ	n a f uː ð
بوذية	b uː ð i j j a
مشط	m u ʃ tˤ
سافانا	s aː f aː n aː
كسرة	k a s r a
أجاب	ʔ u d͡ʒ aː b u
أحاط	ʔ u ħ aː tˤ u
قريب	q a r iː b
جراحة	d͡ʒ i r aː ħ a
أوجد	ʔ a w d͡ʒ a d a
بقس	b a q s
مبكر	m u b a k k i r
مكان	m a k aː n
دين	d iː n
بيلادونا	b iː l aː d uː n aː
بضاعة	b i dˤ aː ʕ a
بزق	b a z a q a
نشادر	n u ʃ aː d i r
قهوة	ɡ a h w ɛ
رقبة	r a q a b a
رقم	r a ɡ i m
خبط	x a b tˤ
مصطار	m u sˤ tˤ aː r
ذكر	ð i k r
دشداشة	d i ʃ d aː ʃ a
قرمزي	q i r m i z i j j
تايوان	t aː j w aː n
فسح	f a s ħ
حلقوم	ħ u l q uː m
ملك	m a l k
شوى	ʃ a w aː
باقة	b aː q a
معطف	m i ʕ tˤ a f
شابانك	ʃ aː b aː n a k
حصرم	ħ i sˤ r i m
درجة	d a r a d͡ʒ a
آخرة	ʔ aː x i r a
دين	d iː n a
هود	h a w w a d a
جسماني	d͡ʒ u s m aː n i j j
بحريني	b a ħ r a j n i j j
استنفاد	i s t i n f aː d
ليبيا	l iː b i j aː
إردب	ʔ a r d a b b
مكتب	m a k t a b
ارتقب	i r t a q a b a
مفك	m i f a k k
عاطف	ʕ aː tˤ i f
لواء	l i w aː ʔ
تحكيم	t a ħ k iː m
منطقة	m i n tˤ a q a
جنة	d͡ʒ a n n a
اشهل	i ʃ h a l l a
أسطول	ʔ u s tˤ uː l
بصير	b a sˤ iː r
تنفس	t u n f a s a
متشكر	m u t a ʃ a k k i r
منقار	m i n ɡ aː r
استبحر	i s t a b ħ a r a
هزيمة	h a z iː m a
سوق	s a w w a q a
وقود	w a q uː d
كوريا	k oː r i j aː
بري	b a r r iː
ملاقاة	m u l aː q aː h
كرك	k u r k
غضاضة	ɣ a dˤ aː dˤ a
فارع	f æː r i ʕ
اصطك	i sˤ tˤ a k k a
قلب	q a l b
سنبوسق	s a m b uː s a q
جنيه	ɡ u n eː h
أي	ʔ a j j
أشكل	ʔ a ʃ k a l
ض	ɮˤ
ثم	θ a m m a
كفات	k i f aː t
الاثنين	ʔ a l i θ n a j n i
خواتم	x a w aː t i m
فدن	f a d a n
وضح	w a dˤː a ħ a
كنز	k a n z
ذليل	ð a l iː l
يوجوسلافيا	j uː ɡ o s l aː v i j aː
رخخة	r i x a x a
كافر	k aː f i r
مرتفع	m u r t a f i ʕ
تأوه	t a ʔ a w w u h
دم	d a m
لها	l a h aː
فوطة	f uː tˤ a
جدر	d͡ʒ a d u r a
نقحر	n a q ħ a r a
ربوة	r u b w a
كرها	k a r h a n
نمط	n a m a tˤ
قوقعة	q a w q a ʕ a
دائرة	d aː ʔ i r a h
مخطوب	m a x tˤ uː b
عبودية	ʕ u b uː d i j j a h
شريان	ʃ a r j aː n
تنفس	t u n a f f i s u
أيهقان	ʔ a j h u q aː n
هذا	h aː d a
نورس	n a w r a s
مشاية	m a ʃ ʃ aː j a
صاد	sˤ aː d a
ثانوي	θ aː n a w i j j
سكرتير	s i k r i t iː r
تسعون	t a s ʕ a w n a
سينمائي	s i j n a m aː ʔ i j j
واقعي	w aː q i ʕ i j j
لك	l a k k
ناقض	n aː q i dˤ
أوزبكستان	ʔ uː z b a k i s t aː n
ي	j aː ʔ
بطالة	b a tˤ aː l a
طومار	tˤ uː m aː r
ريوند	r iː w a n d
عادة	ʕ aː d a
لله	l i l l aː h
ألمانيا	ʔ a l m aː n i j aː
فلسطين	f a l a s tˤ iː n
سنونية	s u n uː n i j a
معجزة	m ʊ ʕ d͡ʒ ɪ z a
سروال	s i r w aː l
رساطون	r a s aː tˤ uː n
طلا	tˤ a l a n
خزانة	x i z aː n a
حرامي	ħ a r aː m i j j
بقس	b u q s
قاض	q aː dˤ a
دومان	d uː m aː n
ظبي	ðˤ a b j
تعلة	t a ʕ i l l a
قاسم	q aː s i m
استدعى	i s t a d ʕ aː
تفاحة	t u f f aː ħ a
أصهب	ʔ a sˤ h a b
تحالف	t a ħ aː l u f
حرير	ħ ɑ r iː r
سليقة	s a l iː q a
صابح	sˤ aː b a ħ a
جمجمة	d͡ʒ u m d͡ʒ u m a
سحاب	s a ħ aː b
كيف	k a j f
إبرة	ʔ i b r a
خارجي	x aː r i d͡ʒ i j j
صنعة	sˤ a n ʕ a
طائر	tˤ aː ʔ i r
حمل	ħ a m l
نرويجية	n u r w iː d͡ʒ i j j a
رياضة	r i j aː dˤ a
أمراء	ʔ u m a r aː ʔ
مجلة	m a d͡ʒ a l l a
لحظ	l a ħ a ðˤ a
سكين	s i k k iː n
مضمار	m i dˤ m aː r
هدهد	h a d h a d a
قشر	ɡ a ʃ ʃ a r
شبوط	ʃ a b b uː tˤ
ديسق	d iː s a q
مشربة	m a ʃ r a b a
تنزانيا	t a n z aː n j aː
تحت	t a ħ t u
طعام	tˤ a ʕ aː m
فاثور	f aː θ uː r
بعثران	b a ʕ θ a r aː n
تكدس	t a k d i s
رمى	r a m aː
دولي	d a w l i j j
يسار	j u s aː r r a
تدخين	t a d x iː n
طرمبة	tˤ r o m b a
محام	m u ħ aː m i n
سريع	s a r iː ʕ
دقيق	d a ɡ iː ɡ
تالي	t aː l iː
مصفاة	m i sˤ f aː h
سيء	s iː ʔ a
سنونو	s u n uː n uː
أ	ʔ u
ثوم	θ uː m
بلجيكي	b i l d͡ʒ iː k i j j
قداد	q i d aː d
حمزة	ħ a m z a
قرانيا	q a r aː n i j aː
توجو	t oː ɡ oː
مسعور	m a s ʕ uː r
رجل	r a d͡ʒ i l
أشل	ʔ a ʃ a l l a
أشترغار	ʔ u ʃ t u r ɣ aː r
كوسا	k uː s aː
قاتم	q aː t i m
مجرم	m u d͡ʒ r i m
عجب	ʕ a d͡ʒ d͡ʒ a b a
خراب	x a r aː b
أزدرخت	ʔ a z d a r x a t
أفرع	ʔ a f r u ʕ
علني	ʕ a l a n i j j
لسان	l i s aː n
ثلاثة	θ a l aː θ a h
زكريا	z a k a r i j j aː
أسياخ	ʔ a s j aː x
طوارئ	tˤ a w aː r i ʔ
شيطان	ʃ a j tˤ aː n
أنبيق	ʔ a n b iː q
ز	z
ناصور	n aː sˤ uː r
غرق	ɣ a rː a ɡ
محاضرة	m u ħ aː dˤ i r a
خالف	x aː l a f a
سفرة	s u f r a
نفض	n a f a dˤ a
سحابة	s a ħ aː b a
صودا	sˤ oː d aː
حجفة	ħ a d͡ʒ a f a
سكرجة	s u k u r r u d͡ʒ a
توأم	t a w ʔ a m
طلمبة	tˤ u l u m b a
غرابيل	ɣ a r aː b iː l
شاطئ	ʃ aː tˤ i ʔ
نخل	n a x l
فيديو	f i d i j uː
تنحى	t a n a ħ ħ aː
طرطور	tˤ a r tˤ uː r
فيلم	f iː l m
فلس	f a l s
ا	ʔ a l i f
طويل	tˤ a w iː l
محاور	m a ħ aː w i r
غلب	ɣ a l i b a
ماهاراجا	m aː h aː r aː d͡ʒ aː
ثم	θ u m m a
وسام	w i s aː m
شقة	ʃ a q q a
كراز	k u r aː z
شدياق	ʃ i d j aː q
لله	l a ɫ ɫ aː h
سيخي	s iː x i j j
إيجاد	ʔ iː d͡ʒ aː d
مجنون	m a d͡ʒ n uː n
عقيق	ʕ a q iː q
بدلة	b a d l a
دوى	d a w a n
مؤشر	m u ʔ a ʃ ʃ i r
روح	r a w ħ
أرقان	ʔ a r ɡ aː n
قطران	q a tˤ a r aː n
تكفيري	t a k f iː r i j j
مؤلف	m u ʔ a l l a f
اصطلاح	i sˤ tˤ i l aː ħ
امرأ	i m r a ʔ a n
مهاجم	m u h aː d͡ʒ i m
لألأ	l a ʔ l a ʔ a
أخلاط	ʔ a x l aː tˤ
قطعة	q i tˤ ʕ a
مربوط	m a r b uː tˤ
هجليج	h a d͡ʒ l iː d͡ʒ
اقتاد	i q t aː d a
طموح	tˤ u m uː ħ
زواج	z a w aː d͡ʒ
أردمون	ʔ a r d a m uː n
سحم	s a ħ a m
جرابي	d͡ʒ i r aː b i j j
نعوظ	n u ʕ uː ðˤ
قطع	q a tˤ tˤ a ʕ a
إجاص	ʔ i d͡ʒ d͡ʒ aː sˤ
دزينة	d a z z iː n a
ضمان	dˤ a m aː n
وراثة	w i r aː θ a
وظف	w u ðˤ u f
إباحي	ʔ i b aː ħ i j j
بريمة	b a r r iː m a
تاجورة	t a d͡ʒ uː r a
صدرية	sˤ a d r i j j a
تأسف	t a ʔ a s s a f a
سمك	s a m a k
الأرثوذكسية	a l ʔ u r θ uː ð u k s i j j a
طبيب	tˤ a b iː b
معدات	m u ʕ a d d aː t
عل	ʕ a l l a
شمندورة	ʃ a m a n d uː r a
جاف	d͡ʒ aː f f
تعالم	t a ʕ aː l a m a
رقبة	r a ɡ a b a
مجاور	m u d͡ʒ aː w i r
دستور	d u s t uː r
فضح	f a dˤ a ħ a
جبت	d͡ʒ i b t
أ	ʔ
و	oː
درونج	d a r a w n i d͡ʒ
دوغ	d uː ɣ
بسبب	b i s a b a b i
طاق	tˤ aː q a
كهرمان	k a h r a m aː n
لئلا	l i ʔ a l l aː
هو	w a h w a
فيديو	v i d j uː
زرشك	z a r r a ʃ k
ترك	t u r k
كابلي	k aː b u l i j j
زغلول	z a ɣ l uː l
سبعة	s a b ʕ a
بورما	b u r m aː
ذاب	ð aː b a
جفنة	d͡ʒ a f n a
رقف	r a q a f
عرعر	ʕ a r ʕ a r
سلطوية	s u l tˤ a w i j j a
هن	h u n n a
كوب	k uː b
برعم	b a r ʕ a m a
مجمر	m i d͡ʒ m a r
المرء	a l m a r ʔ
عجور	ʕ a d͡ʒ d͡ʒ uː r
نخاع	n u x aː ʕ
أغسطس	ʔ a ɣ u s tˤ u s
يبروح	j a b r uː ħ
ذريع	ð a r iː ʕ
متعة	m u t ʕ a
فراغ	f u r r aː ɣ
بحيرة	b u ħ a j r a
فركس	f i r k i s
حرص	ħ a r a sˤ a
جبل	d͡ʒ a b a l
محمد	m a ħ m i d
قرص	q a r sˤ
طرز	tˤ a r r a z a
شمعة	ʃ a m a ʕ a
مري	m u r r i j j
ضحك	dˤ a ħ k
مسرحي	m a s r a ħ i j j
اندلع	i n d a l a ʕ a
بيعة	b iː ʕ a
منفاخ	m i n f aː x
كراز	k a r r aː z
مدغشقر	m a d a ɣ a ʃ q a r
محايد	m u ħ aː j i d
بطريركية	b a tˤ r i j a r k i j j a
بساط	ʔ a b s i tˤ a
سؤال	s u ʔ ʔ aː l
غواتيمالا	ɣ w aː t iː m aː l aː
أفك	ʔ a f a k a
نظف	n a ðˤ ðˤ a f a
ديماس	d iː m aː s
نخروبي	n u x r uː b i j j
أين	ʔ a j n a
تجنب	t a d͡ʒ a n n u b
إمناء	ʔ i m n aː ʔ
معلم	m u ʕ a l l i m
شيء	ʃ a j ʔ
أفرغ	ʔ a f r a ɣ
خرمال	x u r m aː l
مسدس	m u s a d d a s
الصومال	a sˤ sˤ uː m aː l
ضوأ	dˤ a w w a ʔ a
معتقل	m u ʕ t a q a l
إتاوة	ʔ i t aː w a
القرآن	a l q u r ʔ aː n
عاطفي	ʕ aː tˤ i f i j j
خاف	x aː f a
وجب	w a d͡ʒ d͡ʒ a b a
غربة	ʁ ʊ r b ɐ
تم	t a m m a
محاضر	m u ħ aː dˤ a r
أنجدان	ʔ a n d͡ʒ u d aː n
دنيا	d u n j aː
أضمر	ʔ a dˤ m a r
نظر	n a ðˤ a r a
دكتور	d u k t uː r
بظر	b ɑ ðˤ r
ديسق	d a j s a q
ميمنة	m a j m a n a
قسطاس	q i s tˤ aː s
أخامص	ʔ a x aː m i sˤ
جشاء	d͡ʒ u ʃ aː ʔ
دجاج	d a d͡ʒ aː d͡ʒ
أسفراج	ʔ a s f a r aː d͡ʒ
أدكن	ʔ a d k a n
عقال	ʕ u q q aː l
هل	h a l
فصح	f a sˤ u ħ a
مجدد	m u d͡ʒ a d d i d
لذلك	l i ð aː l i k a
متأخرا	m u t a ʔ a x x i r a n
مقع	m a q a ʕ a
سبتمبر	s i b t a m b i r
تقدم	t a q a d d a m a
فرمل	f a r m a l a
عار	ʕ aː r a
مرآة	m i r ʔ aː h
أساس	ʔ a s aː s
هجرة	h i d͡ʒ r a
مخصوص	m a x sˤ uː sˤ
انبثق	i n b a θ a q a
إذا	ʔ i ð aː
سليلة	s a l iː l a
بطاء	b i tˤ aː ʔ
قفص	q a f a sˤ
فسافس	f a s aː f i s
غرد	ɣ a r r a d a
لهجة	l a h ʒ a
حاز	ħ aː z a
تطوان	t a tˤ w aː n
سرقسطة	s a r a q u s tˤ a
تسعة	t i s ʕ a
تساوى	t u s aː w aː
معدة	m a ʕ d a
يربوز	j a r b uː z
عزى	ʕ a z z aː
قبو	q a b w
أحول	ʔ a ħ w a l
اطرد	i tˤ tˤ a r a d a
قندهار	q u n d u h aː r
سيف	s a j f
تونس	t uː n u s
مثل	m u θ u l
دخس	d u x a s
حقبة	ħ i q b a
قشدة	q i ʃ d a
ادعى	i d d a ʕ aː
مصطلح	m u sˤ tˤ a l a ħ
كره	k a r h
أوشك	ʔ a w ʃ a k a
غامض	ɣ aː m i dˤ
وصفة	w a sˤ f a
سماوي	s a m aː w i j j
تناوم	t a n aː w a m a
أسف	ʔ a s i f a
أبرز	ʔ a b r u z
صولجان	sˤ a w l a d͡ʒ aː n
جلاد	d͡ʒ a l l aː d
السلفادور	a s s a l f aː d uː r
تومان	t uː m aː n
دعا	d a ʕ aː
قاوونة	q aː w uː n a
قهوة	q a h w a
شجا	ʃ a d͡ʒ aː
ديسمبر	d iː s i m b i r
حقل	ħ a q l
همزة	h u m a z a
فستان	f u s t aː n
النرويج	a n n u r w iː d͡ʒ
شار	ʃ aː r i n
أقضى	ʔ u q dˤ aː
إسماعيل	ʔ i s m aː ʕ iː l
استغنى	i s t a ɣ n aː
مغسلة	m a ɣ s a l a
معهد	m a ʕ h a d
كوج	k uː d͡ʒ
مرماخور	m a r m aː x uː r
تاج	t aː d͡ʒ
الجمعة	a l d͡ʒ u m ʕ a
شمس	ʃ a m s
إبليز	ʔ i b l iː z
ليت	l a j t a
انشقاق	i n ʃ i q aː q
معدة	m a ʕ i d a
يسار	j u s aː r u
دخان	d u x aː n
نصراني	n a sˤ r aː n iː j
ترانزستور	t r a n z i s t u r
واقع	w ɑː q i ʕ
كوشاد	k uː ʃ aː d
قنينة	q i n n iː n a
مرجل	m i r d͡ʒ a l
ثمن	θ u m u n
صدر	sˤ u d i r a
طلع	tˤ a l a ʕ a
شعبة	ʃ i ʕ b a
طيارة	tˤ a j j aː r a
الصويرة	a sˤ sˤ a w iː r a
شحاذ	ʃ a ħ ħ aː ð
عجيب	ʕ a d͡ʒ iː b
حصرم	ħ u sˤ r u m
حمام	ħ a m aː m
استدل	i s t a d a l l a
الأربعاء	a l ʔ a r b i ʕ aː ʔ
ذروة	ð u r w a
مغرور	m a ɣ r uː r
زربية	z a r b i j j a
قاسم	ɡ aː s i m
شاشة	ʃ aː ʃ a
قنديل	q a n d iː l
تنديل	t i n d iː l
إنجليزي	ʔ i n d͡ʒ i l iː z i j j
ولد	w a l a d
و	w aː w
خرقة	x i r q a
قهوة	ʔ a h w a
كنار	k a n aː r
زفر	z a f a r a
عضوية	ʕ u dˤ w i j j a
بنما	b a n a m aː
دوري	d a w r i j j
رأي	r a ʔ j
جاد	d͡ʒ aː d a
مثل	m i θ l u
قد	q u d
أعزب	ʔ a ʕ z a b
فيروزي	f a j r uː z i j j
أثل	ʔ a θ l a
دردي	d u r d i j j
قائف	q aː ʔ i f
بساط	b u s u tˤ
دورة	d a w r a
شوفان	ʃ uː f aː n
الصين	a sˤ sˤ iː n
صفد	sˤ a f a d a
إسرائيل	ʔ i s r aː ʔ iː l
أطفال	ʔ a tˤ f aː l
أخت	ʔ u x t
بليج	b i l l iː d͡ʒ
قيافة	q i j aː f a
أنموذج	ʔ u n m uː ð a d͡ʒ
مرفوع	m a r f uː ʕ
عوار	ʕ a w aː r
أفريقيا	ʔ a f r iː q j aː
المغرب	a l m a ɣ r i b
غضب	a l ɣ a dˤ a b
عرناس	ʕ a r n aː s
ممارسة	m u m aː r a s a
كرواتيا	k u r u w aː t i j aː
إزاء	ʔ i z aː ʔ a
تجنى	t a d͡ʒ a n n aː
ترك	t a r k
زنباع	z a n b aː ʕ
منيرة	m u n iː r a
ائتلف	i ʔ t a l a f a
منافس	m u n aː f i s
و	w ə
غلاء	ɣ a l aː ʔ
منهج	m i n h a d͡ʒ
لاهور	l aː h uː r
خصوبة	x u sˤ uː b a
الأندلس	a l ʔ a n d u l u s
مدرسة	m u d a r r i s a
أن	ʔ a n n a
سنوت	s a n n uː t
أسهل	ʔ a s h u l
شدا	ʃ a d aː
إصقنقور	ʔ i sˤ q a n q uː r
رادف	r aː d a f a
نستعليق	n a s t a ʕ l iː q
قلنسوة	q a l a n s u w a
قبيلة	q b iː l a
أعجمي	ʔ a ʕ d͡ʒ a m i j j
زنبوع	z a n b uː ʕ
جمادى	d͡ʒ u m aː d aː
دورق	d a w r a q
لسان	l s aː n
كسوف	k u s uː f
استدعاء	i s t i d ʕ aː ʔ
تمنى	t a m a nː aː
جزئي	d͡ʒ u z ʔ i j j
هدد	h a d d a d a
ساء	s aː ʔ a
سيناء	s a j n aː ʔ
شنبر	ʃ a m b a r
تشرفنا	t a ʃ a r r a f n aː
نافورة	n aː f uː r a
ملك	m a l a k a
مخض	m a x a dˤ a
اهتز	i h t a z z a
جنب	d͡ʒ a n a b a
لؤلؤ	l a w l u ʔ
سكر	s u k k a r
مرزبة	m a r z a b a
زعط	z a ʕ a tˤ a
أعظ	ʔ a ʕ a ðˤ ðˤ a
شمروخ	ʃ u m r uː x
تعصب	t a ʕ a sˤ sˤ a b a
تفرغ	t a f a r r u ɣ
جبروت	d͡ʒ a b a r uː t
فاحش	f aː ħ a ʃ a
تفوق	t a f a w w u q
مازريون	m aː z a r j uː n
اعتنى	i ʕ t a n aː
هائل	h aː ʔ i l
تعشق	t a ʕ a ʃ ʃ a q a
طيفورية	tˤ a j f uː r i j j a
مسلم	m u s l i m
تجرد	t a d͡ʒ a r r a d a
كبريت	k i b r iː t
كيلوغرام	k i l u ɣ r aː m
قطمة	q a tˤ m a
صفا	sˤ a f aː
هندسة	h a n d a s a
مسمار	m i s m aː r
مجموع	m a d͡ʒ m uː ʕ
مؤسسة	m u ʔ a s s i s a
سطع	s a tˤ a ʕ a
عنصل	ʕ u n sˤ u l
قاس	q aː s i n
جنائي	d͡ʒ i n aː ʔ i j j
إنكار	ʔ i n k aː r
برمج	b a r m a d͡ʒ a
يرقة	j a r a q a
مخلص	m u x l i sˤ
ابتهج	i b t a h a d͡ʒ a
معدونس	m a ʕ d uː n i s
م	m
خبيئة	x a b iː ʔ a
بلس	b a l a s
إكسينون	ʔ i k s iː n o n
غلقة	ɣ a l q a
أكشف	ʔ a k ʃ a f a
زكوة	z a k aː h
نيلي	n iː l i j j
عنكبوت	ʕ a n k a b uː t
طعن	tˤ a ʕ n
نعل	n a ʕ a l
قريبا	q a r iː b a n
زانية	z aː n i j a
مدحلة	m i d ħ a l a
تزدان	t a z d aː n a
مصعد	m i sˤ ʕ a d
تلقى	t a l a q q aː
خلية	x a l i j j a
ساعد	s aː ʕ i d
نخاسة	n i x aː s a
غمام	ɣ a m aː m a
بحر	b a ħ ħ a r a
قسم	q i s m
سيراليون	s iː r aː l i j uː n
خالد	x aː l i d
ساعة	s aː ʕ a
فنجان	f i n d͡ʒ aː n
سخاب	s i x aː b
إنترنت	ɪ n t ə r n ə t
هيبة	h iː b a
دير	d a j r
فكة	f a k k a
إعلامي	ʔ i ʕ l aː m i j j
ثؤلول	θ u ʔ l uː l
رحيم	r a ħ iː m
قلقاسة	q u l q aː s a
شرق	ʃ a r ɡ
كوكبة	k a w k a b a
استنفد	i s t a n f a d a
بيدق	b a j d a q
مرقص	m a r q a sˤ
أكمة	ʔ a k a m a h
خبر	x u b r
ولو	w a l a w
تمسيح	t a m s iː ħ
أولمبي	ʔ uː l i m b i j j
كان	k aː n a
أسى	ʔ a s a n
نخلة	n a x l a
بينما	b a j n a m aː
لبن	l a b a n
ميزان	m iː z aː n
سحم	s a ħ ħ a m a
تكية	t a k i j j a
كتب	k a t t a b a
أستاذ	ʔ u s t aː ð
كالون	k aː l uː n
أضمر	ʔ a dˤ m a r a
كتان	k a t t aː n
زوراء	z a w r aː ʔ
أريحا	ʔ a r iː ħ aː
اتهام	i t t i h aː m
سلطة	s a l a tˤ a
أديب	ʔ a d iː b
سوق	s a w q
فك	f a k k a
طيون	tˤ a j j uː n
بلغم	b a l ɣ a m
أدهش	ʔ u d h i ʃ u
رمضان	r a m a dˤ aː n
نص	n a sˤ sˤ
و	uː
وضب	w a dˤ dˤ a b a
حفر	ħ a f r
مخلص	m u x a l l i sˤ
مسعى	m a s ʕ a n
نحل	n a ħ l
ض	dˤ
حرز	ħ i r z
بواليع	b a w aː l iː ʕ
أنواع	ʔ a n w aː ʕ
هاء	h aː ʔ
وضاح	w a dˤ dˤ aː ħ
ترسة	t i r s a
هارون	h aː r uː n
غواصة	ɣ a w w aː sˤ a
لائحة	l aː ʔ i ħ a
معتبر	m u ʕ t a b i r
تنفس	t u n a f f a s u
رشفة	r a ʃ f a
مرسم	m a r s a m
غربة	ɣ u r b a
هاته	h aː t i h iː
إمامة	ʔ i m aː m a
نشل	n a ʃ a l
منزل	m a n z i l
هندباء	h i n d i b aː ʔ
شبابة	ʃ a b b aː b a
سلجم	s a l d͡ʒ a m
شاء	ʃ aː ʔ
تطبيق	t a tˤ b iː q
أتى	ʔ a t aː
ماجور	m aː d͡ʒ uː r
مفرغ	m u f a r r i ɣ
مجلخة	m i d͡ʒ l a x a
ديانات	d i j aː n aː t
أردف	ʔ a r d a f a
امرأة	i m r a ʔ a
شبح	ʃ u b i ħ a
ارتاح	i r t aː ħ a
كرز	k a r a z
تناسق	t a n aː s u q
كاشف	k aː ʃ i f
عتاب	ʕ i t aː b
ديك	d iː k
لاهوتي	l aː h uː t i j j
داليا	d aː l i j aː
هجوم	h u d͡ʒ uː m
غفر	ɣ a f a r a
بكين	b i k iː n
ميمون	m a j m uː n
علس	ʕ a l a s
لهاث	l u h aː θ
معصم	m i ʕ sˤ a m
رومانيا	r uː m aː n i j aː
شهدانق	ʃ a h d aː n a q
زيارة	z i j aː r a
ء	ʔ
ملك	m a l i k
حمل	ħ a m a l
مالديفز	m aː l d iː f z
بئس	b a ʔ i s a
سوفياتي	s o v j eː t i j j
نعل	n a ʕ a l a
بلاذر	b a l aː ð u r
آمن	ʔ aː m u n
تحوز	t a ħ a w w a z a
فيديو	v iː d j oː
الحسيمة	a l ħ u s a j m a
حلتيث	ħ i l t iː θ
أرصفة	ʔ a r sˤ i f a
توفى	t a w a f f aː
عفريت	ʕ i f r iː t
عنق	ʕ u n a q
كوع	k uː ʕ
لم	l i m a
متانة	m a t aː n a
فيلم	f i l m
أشنة	ʔ u ʃ n a
وظيفة	w a ðˤ iː f a
محبس	m a ħ b a s
مقاس	m a ɡ aː s
خطئ	x a tˤ i ʔ a
سيماء	s iː m aː ʔ
استيقظ	i s t a j q a ðˤ a
برج	b u r d͡ʒ
زنزانة	z i n z aː n a
أبنوس	ʔ a b n uː s
امتعض	i m t a ʕ a dˤ a
أناخ	ʔ a n aː x a
أكل	ʔ a k k a l a
رواقية	r i w aː q i j j a
فوضى	f a w dˤ aː
مدفع	m a d f a ʕ
كتلة	k u t l a
شحاذة	ʃ i ħ aː ð a
خيرة	x iː r a
بطن	b a tˤ a n a
قرسطون	q a r a s tˤ uː n
جرعة	d͡ʒ u r ʕ a
قدم	q a d u m a
كاف	k aː f
محب	m u ħ a b b
أفيون	ʔ a f j uː n
استخرج	i s t a x r a d͡ʒ a
نذير	n a ð iː r
مهرجان	m i h r a d͡ʒ aː n
مهلة	m u h l a
شقاء	ʃ a q aː ʔ
فلفل	f i l f i l
أناقة	ʔ a n aː q a
أغلب	ʔ u ɣ l a b
مدير	m u d iː r
عفونة	ʕ u f uː n a
موقف	m a w ɡ i f
أفطس	ʔ a f tˤ a s
قرصعنة	q a r sˤ a ʕ a n n a
لمع	l a m a ʕ a
بس	b a s s
أنتما	ʔ a n t u m aː
لاسلطوي	l aː s u l tˤ a w i j j
زرجون	z a r d͡ʒ uː n
راع	r aː ʕ a
استفراغ	i s t i f r aː ɣ
ميثرة	m iː θ a r a
كثيراء	k a θ iː r aː ʔ
جمهور	d͡ʒ u m h uː r
ظاهري	ðˤ aː h i r i j j
صفع	sˤ a f a ʕ a
غلط	ɣ a l a tˤ
غرامي	ɣ a r aː m i j j
أدحية	ʔ u d ħ i j a
أبان	b aː n a
سكون	s u k uː n
مظلة	m a ðˤ a l l a
إي	ʔ iː
قيطون	ɡ iː tˤ oː n
حماسة	ħ a m aː s a
دكتور	d o k t oː r
ح	ħ aː ʔ
كمبيوتر	k a m b j uː t a r
جبان	d͡ʒ a b aː n
جنك	d͡ʒ u n k
حلقوص	ħ a l q uː sˤ
رجع	r u d͡ʒ u ʕ
سمبوسة	s a m b uː s a
عازب	ʕ aː z i b
مبرة	m a b a r r a
انتقم	i n t a q a m a
أمغر	ʔ a m ɣ a r a
أوعية	ʔ a w ʕ i j a
مثلجات	m u θ a l l a d͡ʒ aː t
متفرق	m u t a f a r r i q
أسرة	ʔ a s i r r a
ي	iː
عاشب	ʕ aː ʃ i b
فربيون	f a r b i j uː n
سدر	s i d r
سفرجل	s a f a r d͡ʒ a l
أخصائي	ʔ a x i sˤ sˤ aː ʔ i j j
ضيع	dˤ a j j a ʕ a
سموم	s a m uː m
معمودية	m a ʕ m uː d i j j a
دافئ	d aː f i ʔ
مرزبان	m a r z u b aː n
إياك	ʔ i j j aː k i
كيلوغرام	k iː l u ɣ r aː m
تنفس	t a n f u s u
آيسلندا	ʔ aː j s l a n d aː
مولى	m a w l a n
رسالة	r i s aː l a
كحلاء	k a ħ l aː ʔ
مداخل	m a d aː x i l
رابط	r aː b i tˤ
أدهش	ʔ u d h a ʃ
ماعونة	m aː ʕ uː n a
تحرير	t æ ħ r iː r
صلى	sˤ a l l aː
سلح	s a l l a ħ a
نسيم	n a s iː m
ذئبة	ð i ʔ b a
قذة	q u ð ð a
هاون	h aː w u n
بوصير	b uː sˤ iː r
كينيا	k iː n i j aː
ضمران	dˤ a m r aː n
ترك	t a r r a k a
خفر	x a f a r a
رب	r u b b a
محادثة	m u ħ aː d a θ a
هباء	h a b aː ʔ
خصوصي	x u sˤ uː sˤ i j j
أثناء	ʔ a θ n aː ʔ a
أبرز	ʔ a b r a z
علي	ʕ a l j
بحث	b a ħ a θ a
يقين	j a q iː n
سيرك	s i r k
مضيق	m a dˤ iː q
مزبلة	m a z b a l a
ك	k ɑː f
حصرم	ħ a sˤ r a m a
بوليس	b uː l iː s
استكشاف	i s t i k ʃ aː f
ل	l aː m
غلط	ɣ a l i tˤ a
فوز	f a w z
يسوع	j a s uː ʕ
سكنجبين	s i k a n d͡ʒ u b iː n
تكدس	t u k a d d i s a
محراب	m a ħ aː r iː b
جريد	d͡ʒ a r iː d
ولكن	w a l aː k ɪ nː a
أعاجيب	ʔ a ʕ aː d͡ʒ iː b
إنموذج	ʔ i n m uː ð a d͡ʒ
قاف	q aː f a
من	m a n n
تلاشى	t a l aː ʃ aː
حرش	ħ a r r a ʃ a
العراق	a l ʕ i r aː q
وعاء	w i ʕ aː ʔ
هن	h i n n a
فاض	f aː dˤ a
دب	d i b b
جناح	d͡ʒ u n aː ħ
زخ	z a x x
سميط	s a m iː tˤ
أمضى	ʔ a m dˤ aː
شره	ʃ a r i h a
خطام	x i tˤ aː m
فقس	f a q a s a
شكوهج	ʃ i k uː h a d͡ʒ
سلطوي	s u l tˤ a w i j j
وسع	w a s i ʕ a
رمضان	r a m dˤ aː n
خزينة	x a z iː n a
الأردن	a l ʔ u r d u n
أشهل	ʔ a ʃ h a l
كذاب	k a z z aː b
قبر	q u b b a r
صبي	sˤ a b i j j
بازهر	b aː z a h r
أطبة	ʔ a tˤ i b b a
ثعبان	θ u ʕ b aː n
واجه	w aː d͡ʒ a h a
زمام	z i m aː m
تربة	t u r b a
تنفس	t u n f a s
ث	θ
دونم	d uː n u m
موكب	m a w k i b
أنا	ʔ a n aː
سبطانة	s a b a tˤ aː n a
مايو	m aː j uː
بطن	b a tˤ n
حشيش	ħ a ʃ iː ʃ
دقيق	d a q iː q
وظف	w a ðˤ ðˤ a f a
عوارية	ʕ a w aː r i j j a
الفلبين	a l f i l i b b iː n
حصل	ħ a sˤ sˤ a l a
غرق	ɣ i r i ɡ
نشيدة	n a ʃ iː d a
و	u
تذبذب	t a ð a b ð u b
إذا	ʔ i ð a n
مبالغة	m u b aː l a ɣ a
ستون	s i t t uː n a
أطلع	ʔ a tˤ l a ʕ a
أربعة	ʔ a r b i ʕ a
رد	r a d d a
عجرم	ʕ i d͡ʒ r i m
شيك	ʃ eː k
رصفاء	r u sˤ a f aː ʔ
مسد	m a s s a d a
تغيير	t a ɣ j iː r
سلامتك	s a l aː m t i k
قشر	q a ʃ ʃ a r a
تدليك	t a d l iː k
استمتع	i s t a m t a ʕ a
عسال	ʕ a s s aː l
مدخن	m u d a x x i n
خبر	x a b a r a
انشق	i n ʃ a q q a
تكدس	t a k a d d u s
سوس	s a w i s a
هود	h a w d
بلغاريا	b u l ɣ aː r i j aː
قرمل	q a r m a l
راقص	r aː q i sˤ
انبث	i m b a θ θ a
كاف	k aː f i n
بند	b a n d
تحرش	t a ħ a r r a ʃ a
طاقم	tˤ aː q a m
أدهش	ʔ u d h a ʃ a
أحسن	ʔ u ħ a s s a n a
صعيد	sˤ a ʕ iː d
لون	l a w w a n a
كروية	k u r a w i j j a
مزرع	m a z r a ʕ
أغلب	ʔ u ɣ l a b u
صفد	sˤ a f f a d a
شي	ʃ a j j
كثافة	k a θ aː f a
عطلة	ʕ u tˤ l a
وقت	w a q a t
مراسل	m u r aː s i l
زمزريق	z a m z a r iː q
المسيح	a l m a s iː ħ
مستفرغ	m u s t a f r a ɣ
أخشن	ʔ a x ʃ a n
تواضع	t a w aː dˤ a ʕ a
فرعون	f i r ʕ a w n
مال	m aː l
اللهم	ʔ a ɫ ɫ aː h u m m a
واسع	w aː s i ʕ
شهق	ʃ a h a q a
ص	sˤ aː d
عم	ʕ a m m
مراجع	m u r aː d͡ʒ a ʕ
فلاح	f a l l aː ħ
عانى	ʕ aː n aː
قام	q ō m
أهبة	ʔ u h b a
سنبوسك	s a m b uː s a k
عتمة	ʕ a t a m a
كستيج	k u s t iː d͡ʒ
ثدييات	θ a d j i j j aː t
شمال	ʃ a m aː l
سلوفينيا	s l o v eː n i j aː
خرقة	x i r ɡ a
موزامبيق	m uː z a m b iː q
أكل	ʔ a k a l a
شمشار	ʃ a m ʃ aː r
كستج	k a s t a d͡ʒ
منقض	m u n q a dˤ
ظفر	ðˤ i f r
قرصن	q a r sˤ a n a
حرقدة	ħ a r q a d a
بطرك	b a tˤ r a k
إنسان	ʔ i n s aː n
مكناس	m a k n aː s
ميانمار	m i j aː n m aː r
فلو	f u l u w w
فرغ	f a r a ɣ a
دواسة	d a w w aː s a
إن	ʔ i n
عصا	ʕ a sˤ aː
شرق	ʃ a r q
صبر	sˤ a b b a r a
عبادة	ʕ i b aː d a
قالب	q aː l a b
حبق	ħ a b a q
إسحاق	ʔ i s ħ aː q
ك	k
قال	ʔ aː l
جيش	ɡ eː ʃ
مناخي	m a n aː x i j j
نظرية	n a ðˤ a r i j j a
نعس	n a ʕ a s a
مرة	m a r r a t a n
شرموطة	ʃ a r m uː tˤ a
منتظم	m u n t a ðˤ a m
باص	b aː sˤ
تأمرك	t a ʔ a m r a k a
أحب	ʔ a ħ a b b a
خلاص	x a l aː sˤ
تحت	t a ħ t a
توراة	a t t a w r aː h
محمدة	m a ħ m i d a
عصيان	ʕ i sˤ j aː n
كبر	k a b u r a
مصدوم	m a sˤ d uː m
ممحوق	m a m ħ uː q
فرقاطة	f u r ɡ aː tˤ a
غزلي	ɣ a z a l i j j
هاون	h aː w a n a
كمر	k a m a r
جارية	d͡ʒ aː r i j a
إرهابي	ʔ i r h aː b i j j
فوضوية	f a w dˤ a w i j j a
إعياء	ʔ i ʕ j aː ʔ
عصب	ʕ a sˤ sˤ a b a
طه	tˤ aː h aː
نهر	n a h r
قطران	q a tˤ i r aː n
كوم	k oː m
أحمر	ʔ a ħ m a r
هو	f a h w a
أنوق	ʔ a n uː q
كاشف	k aː ʃ a f a
عجورة	ʕ a d͡ʒ d͡ʒ uː r a
شعب	ʃ u ʕ a b
تفاجأ	t a f aː d͡ʒ a ʔ a
رطب	r u tˤ a b
دقيقة	d a ɡ iː ɡ a
تقضب	t a q a dˤ dˤ a b a
رابع	r aː b i ʕ
مشمش	m i ʃ m i ʃ
فراولة	f a r aː w i l a
افتراع	i f t i r aː ʕ
كون	k a w w a n a
عالي	ʕ aː l iː
غبن	ɣ a b n
صدغ	sˤ u d ɣ
ريباس	r iː b aː s
استعان	i s t a ʕ aː n a
صقاع	sˤ i q aː ʕ
ديباج	d iː b aː d͡ʒ
أريكا	ʔ a r iː k aː
عبودية	ʕ ʊ b uː d ɛ jː ə
سراويل	s a r aː w iː l
حطاب	ħ a tˤ tˤ aː b
أجذاع	ʔ a d͡ʒ ð aː ʕ
مخروطي	m a x r uː tˤ i j j
ي	j
أبكم	ʔ a b k a m
فني	f a n i j a
أعقد	ʔ a ʕ ɡ a d
حوول	ħ uː w i l a
حجامة	ħ a d͡ʒ aː m a
جزمازق	d͡ʒ a z m aː z a q
مستهلك	m u s t a h l i k
زمان	z a m aː n
ساحلي	s aː ħ i l i j j
سجادة	s i d͡ʒː aː d a
نملة	n a m l a
مذاق	m a d aː q
رقم	r a ɡ a m
هدى	h a d aː
تعزم	t a ʕ a z z a m a
شمشير	ʃ a m ʃ iː r
جهادي	d͡ʒ i h aː d i j j
ساكف	s aː k i f
نفخ	n a f a x a
نعم	n a ʕ a m
اعتمد	i ʕ t a m a d a
شمال	ʃ i m aː l
رغيفة	r a ɣ iː f a
لاءم	l aː ʔ a m a
حرف	ħ u r f
مسطار	m i s tˤ aː r
شؤبوب	ʃ u ʔ b uː b
متصل	m u t t a sˤ i l
زار	z aː r a
خارج	x aː r i d͡ʒ
حبس	ħ a b b a s a
ألبانيا	ʔ a l b aː n i j aː
تمرد	t a m a r r a d a
منافق	m u n aː f i q
أريج	ʔ a r iː d͡ʒ
هوادة	h a w aː d a
مخنث	m u x a n n a θ
سابق	s aː b i q
عود	ʕ a w d
هذا	h aː ð a
تقرأ	t a q a r r a ʔ a
طمى	tˤ a m aː
أقط	ʔ a q a tˤ a
فاتحة	f aː t i ħ a
فيديو	f iː d i j uː
فرقاطة	f i r ɡ aː tˤ a
باريس	b aː r iː s
ليلة	l a j l a
تايلاند	t aː j l a n d
كزمازق	k a z m aː z a q
جميع	d͡ʒ a m iː ʕ
شامة	ʃ aː m a
مغسلة	m a ɣ s i l a
و	w a
بورصة	b uː r sˤ a
العبرية	a l ʕ i b r i j j a
اقتصر	i q t a sˤ a r a
حافة	ħ aː f a
عشاء	ʕ i ʃ aː ʔ
تماما	t a m aː m a n
صورة	sˤ uː r a
مفرد	m u f r a d
أدب	ʔ a d a b
انسلخ	i n s a l a x a
أدحوة	ʔ u d ħ u w w a
أبيدجان	ʔ a b iː d d͡ʒ aː n
فرغ	f a r r a ɣ a
قاتل	ɡ aː t i l
مخلوقات	m a x l uː q aː t
قرار	q a r aː r
عمامة	ʕ i m aː m a
فاعل	f aː ʕ i l
مشاعر	m a ʃ aː ʕ i r
عربية	ʕ a r a b i j j a
أحسن	ʔ a ħ s a n a
بردعة	b a r d a ʕ a
مفتاح	m i f t aː ħ
حجة	ħ u d͡ʒ d͡ʒ a
غسول	ɣ a s uː l
أخمص	ʔ a x m u sˤ
انقراض	i n q i r aː dˤ
فلو	f a l u w w
قضم	q a dˤ i m a
أحسن	ʔ u ħ a s s a n
قيطون	ɡ eː tˤ oː n
شعر	ʃ a ʕ a r a
رحمن	r a ħ m aː n
إسبانية	ʔ i s b aː n i j a
يونس	j uː n u s
مقطعية	m a q tˤ a ʕ i j j a
إياهما	ʔ i j j aː h u m aː
زبدة	z u b d a
سنجاب	s i n d ʒ aː b
حافلات	ħ aː f i l aː t
أكسح	ʔ a k s a ħ
شكوس	ʃ a k w a s
فجل	f a d͡ʒ d͡ʒ a l a
ضحك	dˤ i ħ k
صاحب	sˤ aː ħ i b
مرسين	m a r s iː n
قرص	q a r a sˤ a
صلوة	sˤ a l aː h
حبل	ħ a b i l a
عنق	ʕ a n a q
مدفأة	m i d f a ʔ a
رحمن	r u ħ ħ i m n a
ملاك	m a l a k
نظف	n a ðˤ u f a
وصيف	w a sˤ iː f
عتب	ʕ a t a b
اعتبر	i ʕ t a b a r a
غلا	ɣ a l aː
طارق	tˤ aː r i q
أميركي	ʔ a m eː r i k i j j
أغلب	ʔ u ɣ a l l i b
جواد	d͡ʒ a w aː d
تسامح	t a s aː m u ħ
مسلسل	m u s a l s i l
خسأ	x a s a ʔ a
أضاف	ʔ a dˤ aː f a
قتل	q a t a l a
لهث	l a h i θ a
فنلندا	f i n l a n d aː
حلبوب	ħ a l b uː b
نسأ	n a s a ʔ a
سلعة	s i l ʕ a
مالطا	m aː l tˤ aː
موقع	m u w a q q i ʕ
حامول	ħ aː m uː l
بالتوفيق	b i t t a w f iː q i
تركيا	t u r k i j j aː
حاسوب	ħ aː s uː b
قال	q aː l a
قرطم	q u r tˤ u m
منغوليا	m u n ɣ uː l i j aː
فلفل	f u l f u l
مخمل	m u x m a l
ملحمي	m a l ħ a m i j j
وعدة	w a ʕ d a
إقامة	ʔ i q aː m a
سرير	s ɪ r iː r
مشط	m a ʃ ʃ a tˤ a
أسوة	ʔ u s w a
اسم	i s m
سدر	s a d i r a
اعتدال	i ʕ t i d aː l
قضيب	q ɑ dˤ iː b
أرضة	ʔ a r a dˤ a
فصح	f u sˤ u ħ
قرب	q a r u b a
إباحية	ʔ i b aː ħ i j j a
خداج	x i d aː d͡ʒ
زرافة	z u r aː f a
حريش	ħ a r iː ʃ
قطع	q u tˤ a ʕ
رجع	r a d͡ʒ a ʕ a
خليقة	x a l iː q a
عفوا	ʕ a f w a n
إحصائي	ʔ i ħ sˤ aː ʔ i j j
سلة	s u l l a
ظهر	ðˤ a h a r a
كهف	k a h f
انتقال	i n t i q aː l
مرزبة	m a r z a b b a
زق	z i q q
شهل	ʃ a h i l a
نظامي	n a ðˤ ðˤ aː m i j j
طحال	tˤ i ħ aː l
تباطأ	t a b aː tˤ a ʔ a
ميراث	m a w aː r iː θ
تصوير	t a sˤ w iː r
عنصري	ʕ u n sˤ u r i j j
جمعي	d͡ʒ a m ʕ i j j
سابيائي	s aː b i j aː ʔ i j j
سمبوسك	s a m b uː s a k
قنطار	q a n tˤ aː r
جاوشير	d͡ʒ aː w a ʃ iː r
معنى	m a ʕ n a n
عريش	ʕ a r iː ʃ
أحبك	ʔ u ħ i b b u k a
عنزروت	ʕ a n z a r uː t
مشعل	m i ʃ ʕ a l
أجرب	ʔ a d͡ʒ r a b
ابتغى	i b t a ɣ aː
جدول	d͡ʒ a d w a l
محادثة	m u ħ aː d i θ a
برلمان	b a r l a m aː n
معاصر	m u ʕ aː sˤ i r
د	d
قابلة	q æː b l æ
الأرجنتين	a l ʔ a r d͡ʒ a n t iː n
تلا	t a l aː
ضوء	dˤ a w ʔ
مرش	m a r ʃ
سيطر	s a j tˤ a r a
شوح	ʃ uː ħ
دفيء	d a f iː ʔ
شكوش	ʃ aː k uː ʃ
كزبرة	k u z b a r a
ممتلئ	m u m t a l i ʔ
كوسى	k uː s aː
عصعص	ʕ u sˤ ʕ u sˤ
عطف	ʕ a tˤ a f a
تسع	t i s ʕ
سلوفاكيا	s l o v aː k i j aː
يانصيب	j aː n a sˤ iː b
بزاز	b a z z aː z
ملل	m a l l a l a
منطقة	m ə n tˤ ə q ə
ملك	m i l k
زندقة	z a n d a q a
نيجيريا	n iː d͡ʒ eː r i j aː
فوض	f a w w a dˤ a
رضائع	r a dˤ aː ʔ i ʕ
مخاط	m u x aː tˤ
و	w
كارى	k aː r aː
فندق	f u n d u q
شارع	ʃ aː r i ʕ
عما	ʕ a m m aː
نقض	n a q q a dˤ a
قدم	q i d a m
كنارة	k i n n aː r a
علي	ʕ u l i j a
كبد	k a b i d
مقطر	m u q a tˤ tˤ i r
يخت	j a x t
سمن	s a m n
طفل	tˤ i f l
باقلاء	b aː q i l aː ʔ
مغناطيسي	m i ɣ n a tˤ iː s i j j
اختار	i x t aː r a
تونس	t uː n i s
نشرة	n a ʃ r a
غبن	ɣ a b a n a
نهب	n a h a b a
عاقبة	ʕ aː q i b a
عقرب	ʕ a ɡ r a b
هنيهة	h u n a j h a
نعل	n a ʕ l
كردون	k u r d uː n
قمح	q a m ħ
محمد	m u ħ a m m a d
لهجة	l ə h d͡ʒ ə
أسطرلاب	ʔ a s tˤ u r l aː b
تقدمي	t a q a d d u m i j j
بوري	b uː r i
سوء	s a w ʔ
شهواني	ʃ a h w aː n i j j
لواط	l i w aː tˤ
ق	ɡ
نوه	n a w w a h a
قارب	ʔ aː r e b
خزاف	x a z z aː f
تمييز	t a m j iː z
انخفض	i n x a f a dˤ a
نضي	n a dˤ i j j
انقطع	i n q a tˤ a ʕ a
هدار	h a d d aː r
فلكي	f a l a k i j j
ساق	s aː q
اتحادي	i t t i ħ aː d i j j
أغلف	ʔ a ɣ l a f
ركبة	r u k b a
تكلم	t a k a l l a m a
ذهب	ð a h a b a
شهر	ʃ a h h a r a
دال	d aː l
رجل	r a d͡ʒ i l a
هن	h a n
معمل	m a ʕ m a l
وحل	w a ħ l
صفعة	sˤ a f ʕ a
دونمة	d uː n m a
الكنية	a l k u n j a
اشتياق	i ʃ t i j aː q
كوستاريكا	k o s t a r iː k aː
نسخ	n a s a x a
خبا	x a b aː
مغناطيس	m a ɣ n a tˤ iː s
إسرنج	ʔ i s r i n d͡ʒ
ساعد	s aː ʕ a d a
باصور	b aː sˤ uː r
مسلسل	m u s a l s a l
مرش	m a r a ʃ a
لا	l aː
عجلة	ʕ i d͡ʒ a l a
دماغ	d i m aː ɣ
قبض	q a b dˤ
نسبوية	n i s b a w i j j a
مغلف	m u ɣ a l l a f
مثلث	m u θ a l l a θ
أهدب	ʔ a h d a b a
جمع	d͡ʒ a m m a ʕ a
حلتيت	ħ i l t iː t
نبراس	n i b r aː s
ظ	ðˤ aː ʔ
زيزفون	z a j z a f uː n
معلم	m a ʕ l a m
تنبول	t a m b uː l
مي	m a j j
كليب	k l i b
حدق	ħ a d a q a
طل	tˤ a l l a
أزلي	ʔ a z a l i j j
قنبيط	q u n n a b iː tˤ
مدة	m u d d a
عادة	ʕ aː d a t a n
احترف	i ħ t a r a f a
ظفر	ðˤ a f f a r a
تنور	t a n a w w u r
الجديدة	a l d͡ʒ a d iː d a
أشعل	ʔ a ʃ ʕ a l a
إيا	ʔ i j j aː
عكازة	ʕ u k k aː z a
أمريكا	ʔ a m r iː k aː
سرو	s a r w
إدهاش	ʔ i d h aː ʃ
رفيق	r a f iː q
حمل	ħ a m a l a
منتقض	m u n t a q i dˤ
متخصص	m u t a x a sˤ sˤ i sˤ
أسبوع	ʔ u s b uː ʕ
طبقة	tˤ a b a q a
غلبة	ɣ u l u b b a
اتعد	i t t a ʕ a d a
أباجور	ʔ a b aː ʒ uː r
قشدي	q i ʃ d i j j
مساهمة	m u s aː h a m a
سادة	s aː d a
نسخة	n u s x a
ثعلب	θ a ʕ l a b
نوفمبر	n uː f i m b a r
تشنج	t a ʃ a n n a d͡ʒ a
حجاب	ħ i ɡ æː b
سويسرا	s u w iː s r aː
تكدس	t u k d a s u
سمعي	s a m ʕ i j j
مصيبة	m u sˤ iː b a
عليون	ʕ i l l i j j uː n
جمل	d͡ʒ u m a l
ا	ʔ
ويسكي	w i s k iː
موزامبيق	m oː z a m b iː q
عطن	ʕ a tˤ n
بنفسج	b a n a f s a d͡ʒ
رقم	r a ʔ a m
صك	sˤ a k k
أديبة	ʔ a d iː b a
أثل	ʔ u θ uː l
كره	k u r h
صحي	sˤ i ħ ħ i j j
فتوى	f a t w aː
سرط	s a r a tˤ a
نفاد	n a f aː d
ملبس	m a l b a s
بيروقراطي	b iː r uː q r aː tˤ i j j
معمار	m i ʕ m aː r
ثلة	θ u l l a
أيش	ʔ a j ʃ i n
ك	k aː f
مجرب	m u d͡ʒ a r r i b
أهيف	ʔ a h j a f
دولار	d oː l aː r
غبار	ɣ u b aː r
عيد	ʕ a j j a d a
ينع	j a n a ʕ a
غلبة	ɣ a l a b a
مشحذ	m i ʃ ħ a ð
رجينة	r a d͡ʒ iː n a
منفضة	m i n f a dˤ a
سلطة	s u l tˤ a
لجأ	l a d͡ʒ a ʔ a
بقص	b a q sˤ
رم	r a m m a
سمن	s u m m a n
حرذون	ħ a r ð uː n
قيطون	ɡ i tˤ uː n
نعيم	n a ʕ iː m
بعل	b a ʕ l
وسط	w a s a tˤ
وقت	w a k t
تخفيف	t a x f iː f
طمث	tˤ a m θ
المحمدية	a l m u ħ a m m a d i j j a
داخل	d aː x i l a
شقة	ʃ i ɡ ɡ a
متعلم	m u t a ʕ a l l i m
رهبوت	r a h a b uː t
وعي	w a ʕ j
أجمع	ʔ a d͡ʒ m a ʕ
أونسة	ʔ u n s a
ردى	r a d d aː
فرع	f a r a ʕ a
فرقاطة	f i r q aː tˤ a
بوسة	b oː s ə
يقظة	j a q a ðˤ a
لعل	l a ʕ a l l a
إملاء	ʔ i m l aː ʔ
خربش	x a r b a ʃ a
أرغان	ʔ a r ɣ aː n
سميع	s a m iː ʕ
أجلح	ʔ a d͡ʒ l a ħ
إقناع	ʔ i q n aː ʕ
وثيقة	w a θ iː q a
بندق	b u n d u ɡ
رغفان	r u ɣ f aː n
شطر	ʃ a tˤ r
جما	d͡ʒ a m m a n
مجفل	m u d͡ʒ a f f i l
غاز	ɣ aː z
زغلول	z u ɣ l uː l
سهل	s a h l
كاراتيه	k a r aː t eː
ملحن	m u l a ħ ħ i n
نواخذة	n a w aː x i ð a
الإسكندرية	a l ʔ i s k a n d a r i j j a
أرهب	ʔ a r h a b a
ناسور	n aː s uː r
جميزة	d͡ʒ u m m a j z
قضيبي	q a dˤ iː b i j j
حيوة	ħ a j aː h
أملج	ʔ a m l a d͡ʒ
سفافيد	s a f aː f iː d
صحراء	sˤ a ħ r aː ʔ
جبس	d͡ʒ i b s
كزمازج	k a z m aː z a d͡ʒ
كم	k a m m
عبيثران	ʕ u b a j θ a r aː n
قرصنة	q a r sˤ a n a
كبد	k a b b a d a
زنبور	z a m b uː r
شنع	ʃ a n n a ʕ a
بذلة	b a ð l a
متلوث	m ʊ t ə l ə wː ɪ θ
قد	q a d
آل	ʔ aː l u
جاورس	d͡ʒ aː w a r s
حينئذ	ħ iː n a ʔ i ð i n
تنفيذ	t a n f iː ð
حاجز	ħ aː d͡ʒ i z
أنتن	ʔ a n t u n n a
عار	ʕ aː r i n
ترنيم	t a r n iː m
ركض	r a k a dˤ a
لبلابي	l a b l aː b i j j
أوجد	ʔ uː d͡ʒ a d u
قنطار	q i n tˤ aː r
شفر	ʃ a f r
أسهل	ʔ a s h a l
جليد	d͡ʒ a l iː d
شيء	ʃ iː ʔ a
وقف	w a q a f a
فتة	f a t t a
تحرش	t a ħ r i ʃ u
قاوق	q aː w u q
ركف	r a k a f
أخاديد	ʔ a x aː d iː d
ثور	θ a w r
تألف	t a ʔ a l l a f a
مشترك	m u ʃ t a r a k
سجين	s a d͡ʒ iː n
تعليق	t a ʕ l iː q
إشبينة	ʔ i ʃ b iː n a
شمس	ʃ a m a s
سماء	s a m aː ʔ
وسع	w a s u ʕ a
صنارة	sˤ i n n aː r a
قاد	q aː d a
سبسب	s a b s a b
ربيع	r a b iː ʕ
عنق	ʕ u n u q
فصيل	f a sˤ iː l
فدائي	f i d aː ʔ i j j
حجامة	ħ i d͡ʒ aː m a
كثيب	k a θ iː b
عار	ʕ aː r
بسملة	b a s m a l a
مص	m a sˤ sˤ
مربض	m a r b i dˤ
ناصع	n aː sˤ i ʕ
تعصب	t a ʕ a sˤ sˤ u b
أخذ	ʔ a x x a ð a
فراشة	f a r aː ʃ a
ن	n
أهدب	ʔ a h d a b
قوش	q uː ʃ
أعزل	ʔ a ʕ z a l
حينذاك	ħ iː n a ð aː k a
صنارة	sˤ i n aː r a
تعالى	t a ʕ aː l aː
فسقية	f i s q i j j a
شعبي	ʃ a ʕ b i j j
رحمة	r a ħ m a
طراح	tˤ i r aː ħ
حوذان	ħ a w ð aː n
شين	ʃ iː n
حيوان	ħ a j a w aː n
سنبل	s u n b u l
دساتير	d a s aː t iː r
اضطهاد	i dˤ tˤ i h aː d
كندا	k a n a d aː
كتابخانة	k i t aː b x aː n a
عجول	ʕ u d͡ʒ uː l
هنغاريا	h i n ɣ aː r i j aː
بودابست	b u d a b i s t
إمبراطوري	ʔ i m b a r aː tˤ uː r i j j
ألباني	ʔ a l b aː n i j j
أوغندا	ʔ uː ɣ a n d aː
رأس	r a ʔ a s a
سورينام	s uː r iː n aː m
غار	ɣ aː r a
شعر	ʃ a ʕ a r
شمبانيا	ʃ a m b aː n j aː
شقة	ʃ i q q a
خرافي	x u r aː f i j j
حب	ħ u b b
استمنى	i s t a m n aː
ضباب	dˤ i b aː b
تكفير	t a k f iː r
عرنسية	ʕ a r a n s i j j a
طحن	tˤ a ħ a n a
استمارة	i s t i m aː r a
فجل	f a d͡ʒ a l
غ	ʁ a j n
سمع	s a m i ʕ a
حيواني	ħ a j a w aː n i j j
لاوس	l aː w s
عنب	ʕ u n a b
كزمازك	k a z m aː z a k
أثل	ʔ a θ a l aː t
مقشرة	m i q ʃ a r a
نحلة	n a ħ l a
سياع	s i j aː ʕ
ملجأ	m a l d͡ʒ a ʔ
مغبن	m a ɣ b a n
جردل	d͡ʒ a r d a l
سنغافورة	s i n ɣ aː f uː r a
دغموس	d a ɣ m uː s
روض	r a w w a dˤ a
سقم	s a q a m
تطوان	t i tˤ w aː n
أغلب	ʔ u ɣ a l l i b u
يانسون	j aː n a s uː n
تعسفي	t a ʕ a s s u f i j j
حديقة	ħ a d iː q a
صوم	sˤ a w m
حرذون	ħ i r ð a w n
خصص	x a sˤ sˤ a sˤ a
متحمس	m u t ħ a mː i s
شرشيري	ʃ a r ʃ iː r i j j
مقشدة	m i q ʃ a d a
مسجد	m a s d͡ʒ i d
لعبة	l a ʕ b a
زنار	z u n n aː r
حقد	ħ i q d
تهدل	t a h a d d a l a
إثمد	ʔ i θ m i d
عافية	ʕ aː f i j a
شاف	ʃ aː f a
أخلاقي	ʔ a x l aː q i j j
تامول	t aː m uː l
عنيف	ʕ a n iː f
مزر	m i z r
كوثل	k a w θ a l
أثاث	ʔ a θ aː θ
النمسا	a n n i m s aː
تقضى	t u q dˤ aː
رمش	r a m a ʃ a
داود	d aː w uː d
أسود	ʔ a s w a d
خلفي	x a l f i j j
توراة	t ə w r ɑː t
مفرغ	m u f r i ɣ
مقام	m a q aː m
علقم	ʕ a l q a m
س	s iː n
محافظة	m u ħ aː f i ðˤ a
لاث	l aː θ a
رياضي	r i j aː dˤ i j j
بليحة	b a l iː ħ a
أمس	ʔ u m a s s a
رحمن	r a ħ ħ a m n a
مرقشيتا	m a r q a ʃ iː t aː
وزع	w a z z a ʕ a
أغلب	ʔ a ɣ l a b
مات	m aː t a
زفن	z a f a n a
ساهم	s aː h a m a
قرأ	q a r a ʔ a
جزمازك	d͡ʒ a z m aː z a k
هنالك	h u n aː l i k a
صومعة	sˤ a w m a ʕ a
لعبة	l u ʕ b a
باء	b aː ʔ
وغل	w a ɣ a l a
كاراطي	k aː r aː tˤ iː
دولي	d u w a l i j j
زهرية	z a h r i j j a
اجتنب	i d͡ʒ t a n a b a
درك	d a r a k
أفرط	ʔ a f r a tˤ a
سيخية	s iː x i j j a
قبطان	q u b tˤ aː n
جحفل	d͡ʒ ħ f a l a
ظليم	ðˤ a l iː m
زم	z a m m a
كنيسة	k a n iː s a
سكرجة	s u k u r r a d͡ʒ a
أكتوبر	ʔ a k t uː b a r
مرقشيثا	m a r q a ʃ iː θ aː
معروف	m a ʕ r uː f
سنة	s i n a
ألقى	ʔ a l q aː
متى	m a t t aː
خرسانة	x a r a s aː n a
محبس	m i ħ b a s
اقترح	i q t a r a ħ a
زراعي	z i r aː ʕ i j j
مركب	m u r a k k a b
فعل	f a ʕ l
نضار	n u dˤ aː r
كرح	k i r ħ
سلاطين	s a l ɑː tˀ iː n
بطاطا	b a tˤ aː tˤ aː
نبأ	n a b a ʔ
خالق	x aː l i q
مجوهرات	m u d͡ʒ a w h a r aː t
ميراث	m iː r aː θ
سقم	s u q m
تجنب	t a d͡ʒ a n n a b a
كلوتة	k a l l uː t a
أنبوب	ʔ u n b uː b
بامية	b aː m i j a
ماء	m aː ʔ
نفض	n a f f a dˤ a
وسمة	w a s m a
كمثراة	k u m m a θ r aː h
مكافح	m u k aː f i ħ
ريحان	r a j ħ aː n
حرنكش	ħ a r a n k a ʃ
قبرة	q u b b a r a
أزرق	ʔ a z r a ɡ
الفاتيكان	a l v a t i k aː n
ينسون	j a n s uː n
جلنجبين	d͡ʒ u l l a n d͡ʒ a b iː n
كوة	k a w w a
طاف	tˤ aː f a
قتلة	q a t l a h
يوسف	j uː s u f
بلغمي	b a l ɣ a m i j j
ناشف	n aː ʃ i f
خريطة	x a r iː tˤ a
مجنون	m æ ɡ n uː n
جسمان	d͡ʒ u s m aː n
محراث	m i ħ r aː θ
إندونيسيا	ʔ i n d uː n iː s i j aː
حصرم	ħ a sˤ r a m
هيف	h a j f
قصير	q a sˤ iː r
شخشخ	ʃ a x ʃ a x a
فنزويلا	f e n z u w eː l aː
استحصل	i s t a ħ sˤ a l a
حصل	ħ a sˤ a l
كنز	k a n a z a
بعثي	b a ʕ θ i j j
فز	f a z z a
قيظ	q a j ðˤ
تنديل	t a n d iː l
عبيثران	ʕ a b a j θ a r aː n
حفر	ħ a f a r a
لغة	l u ɣ a
غدة	ɣ u d d a
أيوبي	ʔ a j j uː b i j j
قلعة	q a l ʕ a
مجنون	m e ɪ j n uː n
فلانة	f l ɑ n ɐ
حساسي	ħ a s s aː s i j j
أشوه	ʔ a ʃ w a h
سوق	s uː ʔ
نهر	n a h a r
سهل	s a h h a l a
جواب	d͡ʒ a w aː b
أقرب	ʔ a q r a b
حنبل	ħ a n b a l
غبط	ɣ a b a tˤ a
قيطون	ɡ iː tˤ uː n
مقدونيا	m a q d uː n i j aː
خطة	x u tˤ tˤ a
باطس	b aː tˤ u s
فعل	f a ʕ ʕ a l a
ضفدع	dˤ i f d a ʕ
تنبول	t u m b uː l
ضيق	dˤ a j q
حنظلة	ħ a n ðˤ a l a
بنطال	b a n tˤ aː l
تنقض	t a n a q q u dˤ
بعر	b a ʕ r
غطس	ɣ a tˤ a s a
مقص	m i q a sˤ sˤ
طاعم	tˤ aː ʕ a m a
سرخس	s a r x a s
مستنقع	m u s t a n q a ʕ
جزدان	d͡ʒ u z d aː n
صبر	sˤ a b a r a
إذخر	ʔ i ð x i r
تجذير	t a d͡ʒ ð iː r
عامل	ʕ aː m a l a
فيديو	f iː d j uː
وصيد	w a sˤ iː d
وقت	w a q q a t a
زنبوج	z a n b uː d͡ʒ
قفير	q a f iː r
أسري	ʔ u s r i j j
أسفاراج	ʔ a s f aː r aː d͡ʒ
تنفس	t a n f u s
صمام	sˤ i m aː m
أقدر	ʔ a q d a r a
حامض	ħ aː m i dˤ
قرش	q i r ʃ
صفيراء	sˤ u f a j r aː ʔ
بوصلة	b o sˤ l a
صالح	sˤ aː l i ħ
مدة	m u d d a t a
فتح	f a t ħ
خرشوف	x u r ʃ uː f
الله	a ɫ ɫ aː h
خلقي	x a l l i q iː
بلان	b a l l aː n
جنب	d͡ʒ a n a b
انصرف	i n sˤ a r a f a
بعض	b a ʕ dˤ
وارث	w aː r i θ
حاضرة	ħ aː dˤ i r a
إدريس	ʔ i d r iː s
مكنسة	m i k n a s a
مكسرات	m u k a s s a r aː t
دين	d a j n
ثمن	t a m a n
مغفل	m u ɣ a f f a l
بوصلة	b uː sˤ l eː
قابلة	q aː b l a
دويبة	d u w a j b b a h
راجمة	r aː d͡ʒ i m a
منسأة	m a n s a ʔ a
كراميل	k a r aː m iː l
تلفون	t a l i f oː n
فانوس	f aː n uː s
قشف	q a ʃ ʃ a f a
اللات	a l l aː t
جوذاب	d͡ʒ uː ð aː b
محراب	m i ħ r aː b
أباريق	ʔ a b aː r iː q
فورا	f a w r a n
عبرة	ʕ i b r a
قفاز	q u f aː z
معجون	m a ʕ d͡ʒ uː n
بائع	b aː ʔ i ʕ
محجم	m i ħ d͡ʒ a m
أستاذ	ʔ u s t aː z
عدد	ʕ a d a d
ساد	s aː d a
صلابة	sˤ a l aː b a
آمن	ʔ aː m i n
كبيرة	k a b iː r a h
ات	aː t
راقص	r aː q a sˤ a
رند	r a n d
لكنة	l u k n a
علم	ʕ a l a m
نافذة	n aː f i ð a
تبريز	t a b r iː z
مهدد	m u h a d d a d
عجج	ʕ a d͡ʒ d͡ʒ a d͡ʒ a
عطس	ʕ a tˤ a s a
برن	b i r n
أرض	ʔ a r dˤ
غفلة	ɣ a f l a
جمع	d͡ʒ a m ʕ
زنديق	z i n d iː q
شندقورة	ʃ a n d ɡ uː r a
كبريت	k a b r iː t
ناعور	n aː ʕ uː r
مكدس	m u k a d d a s
جنيف	d͡ʒ i n iː f
لندني	l u n d u n i j j
ماجور	m a ɡ uː r
أعلى	ʔ u ʕ l aː
تحرش	t a ħ r i ʃ a
ساجور	s aː d͡ʒ uː r
شاهترج	ʃ aː h t a r a d͡ʒ
أشيب	ʔ a ʃ j a b
تشاعر	t a ʃ aː ʕ a r a
توارى	t a w aː r aː
هاتف	h aː t i f
شحن	ʃ a ħ a n a
فرث	f a r a θ a
مشط	m a ʃ a tˤ a
بوروندي	b u r u n d iː
كبيس	k a b iː s
واق	w aː q i n
مساطر	m a s aː tˤ i r
رقيب	r a q iː b
ائتلاف	i ʔ t i l aː f
أزب	ʔ a z a b b
مغرفة	m i ɣ r a f a
حطب	ħ a tˤ a b
مو	m uː
قلب	q a l a b a
واجهات	w aː d͡ʒ i h aː t
تراجم	t a r aː d͡ʒ a m a
أغبر	ʔ a ɣ b a r
سنت	s a n n a t
ناقوس	n aː q uː s
بزاق	b u z aː q
إحسان	ʔ i ħ s aː n
سمن	s a m i n a
أكاف	ʔ u k k aː f
أسمر	ʔ a s m a r
طيفور	tˤ a j f uː r
صفصاف	sˤ a f sˤ aː f
ظالم	ðˤ aː l i m
كرنب	k u r u n b
سريلانكا	s i r iː l aː n k aː
أولو	ʔ u l uː
ساحة	s aː ħ a
شم	ʃ a m m
خنزير	x i n z iː r
رمضان	r u m dˤ aː n
إبطاء	ʔ i b tˤ aː ʔ
لقح	l a q a ħ a
أدهش	ʔ a d h a ʃ a
أنقض	ʔ a n q a dˤ a
قريدس	q u r a j d i s
روسيا	r uː s j aː
غابة	ɣ aː b a
تغوط	t a ɣ a w w a tˤ a
أرغفة	ʔ a r ɣ i f a
مثنان	m a θ n aː n
القدس	a l q u d s
أقرأ	ʔ a q r a ʔ a
مريم	m a r j a m
طابور	tˤ aː b uː r
غرق	ɣ a r i q a
انجرف	i n d͡ʒ a r a f a
توعية	t a w ʕ i j a
خرافة	x u r aː f a
خدش	x a d a ʃ a
أيوب	ʔ a j j uː b
خ	x aː ʔ
غويانا	ɣ uː j aː n aː
ناخوذة	n aː x uː ð a
عيدية	ʕ iː d i j j a
برز	b a r a z a
أنثوي	ʔ u n θ a w i j j
همجي	h a m a d͡ʒ i j j
مصدق	m u sˤ a d d a q
سكي	s a k k i j j
صدق	sˤ a d a q a
ساذج	s aː ð i d͡ʒ
برئ	b a r i ʔ a
مؤسس	m u ʔ a s s i s
تخم	t a x m
رج	r a d͡ʒ d͡ʒ a
ووفق	w uː f i q a
تحرش	t u ħ a r r i ʃ u
سيرج	s iː r a d͡ʒ
سجادة	s a d͡ʒ d͡ʒ aː d a
وارث	w ɑː r ɪ θ
لبسة	l i b s a
شاكر	ʃ aː k i r
زمرد	z u m u r r u d
نهضة	n a h dˤ a
بلوة	b i l aː
ت	t
أثناء	ʔ a θ n aː ʔ
مقولة	m ɐ q uː l ə
مضيف	m u dˤ iː f
موت	m a w t
راحة	r aː ħ a
فأس	f a ʔ s
بارز	b aː r i z
كندس	k u n d u s
ضبط	dˤ a b a tˤ a
قصعين	q a sˤ ʕ iː n
قلعي	q a l ʕ i j j
تكدس	t a k a d d a s a
أعرن	ʔ a ʕ r a n a
حليب	ħ a l iː b
ديسم	d a j s a m
برتقال	b ʊ r t ə q ɑː l
فسقية	f a s q i j j a
جاهز	d͡ʒ aː h i z
عبوة	ʕ u b uː w a h
لج	l a d͡ʒ d͡ʒ a
آشوري	ʔ aː ʃ uː r i j j
قوة	q u w w a
سيراء	s iː r aː ʔ
عضوي	ʕ u dˤ w i j j
نيلج	n iː l a d͡ʒ
مدهش	m u d h i ʃ
لاسلطوية	l aː s u l tˤ a w i j j a
أسطورة	ʔ u s tˤ uː r a
مؤسسة	m u ʔ a s s a s a
جربوز	d͡ʒ a r b uː z
المجر	a l m a d͡ʒ a r
مجفل	m u d͡ʒ a f f a l
أخدر	ʔ a x d a r
عنوان	ʕ u n w aː n
سيخ	s iː x
أترج	ʔ u t r u d͡ʒ d͡ʒ
صحوة	sˤ a ħ w a
محسن	m u ħ a s s a n
مالطي	m aː l tˤ i j j
باز	b aː z
سلة	s a l l a
زوفا	z uː f aː
اصهاب	i sˤ h aː b b a
أفغاني	ʔ a f ɣ aː n i j j
صاع	sˤ aː ʕ
عرناس	ʕ i r n aː s
مقدونيا	m a q d oː n i j aː
سلا	s a l aː
فضة	f i dˤː a
قرصة	q a r sˤ a
سميك	s a m iː k
ذكر	ð a k a r a
خطيئة	x a tˤ iː ʔ a
لوز	l a w z
سركنجبين	s i r k a n d͡ʒ u b iː n
هراوة	h i r aː w a
ليث	l a j θ
بلجيكا	b a l d͡ʒ iː k aː
بعوض	b a ʕ uː dˤ
مرجان	m a r d͡ʒ aː n
بنجر	b a n d͡ʒ a r
حنظل	ħ a n ðˤ a l
بسكرة	b i s k a r a
رزداق	r u z d aː q
غرب	ɣ a r b
أرز	ʔ a r z
كراث	k a r r aː θ
قملة	q a m l a
فتة	f a t t aː t
متكلم	m u t a k a l l i m
يلب	j a l a b
طمي	tˤ a m j
ابتلى	i b t a l aː
عنقاد	ʕ i n q aː d
متين	m a t iː n
أدهش	ʔ u d h i ʃ a
آنك	ʔ aː n u k
جنيه	d͡ʒ u n a j h
مع	m a ʕ a
معادلة	m u ʕ aː d a l a
إطريفل	ʔ i tˤ r iː f a l
فيديو	v i d j oː
أحسن	ʔ a ħ s a n
كهرباء	k a h r u b aː ʔ
راء	r aː ʔ
سكار	s u k k aː r
استفسار	i s t i f s aː r
زنبور	z u m b uː r
ثرب	θ a r b
شاة	ʃ aː h
زوجة	z oː d͡ʒ a
أعفر	ʔ a ʕ f a r
ملكوت	m a l a k uː t
جد	d͡ʒ i d d
جبة	d͡ʒ u b b a
شن	ʃ a n n a
رزتاق	r u z t aː q
مؤنث	m u ʔ a n n a θ
جز	d͡ʒ a z z a
أستاذ	ʔ u s t aː d
كبير	k b iː r
غريب	ɣ a r iː b
طنجة	tˤ a n d͡ʒ a
تكدس	t a k d i s a
تهديد	t a h d iː d
باسور	b aː s uː r
إحدى	ʔ i ħ d aː
أغلب	ʔ u ɣ a l l a b
بغاء	b i ɣ aː ʔ
داء	d aː ʔ
عرين	ʕ a r iː n
صفحة	sˤ a f ħ a
معركة	m a ʕ r a k a
رضعاء	r u dˤ a ʕ aː ʔ
أرجواني	ʔ a r d͡ʒ u w aː n i j j
جبناء	d͡ʒ u b a n aː ʔ
بقرة	b a q a r a
دهنج	d a h n a d͡ʒ
مرحاض	m i r ħ aː dˤ
أمازيغي	ʔ a m aː z iː ɣ i j j
اليسع	a l j a s a ʕ
حدا	ħ a d aː
رطوبة	r u tˤ uː b a
غزة	ɣ a z z a
اكترى	i k t a r aː
غ	ɣ
لدغ	l a d a ɣ a
وقار	w a q aː r
أدهش	ʔ u d h a ʃ u
تكميلي	t a k m iː l i j j
مقدار	m i ɡ d aː r
سعد	s u ʕ d
صنج	sˤ a n d͡ʒ
دقيقة	d a q iː q a
أدمن	ʔ a d m a n a
سنبك	s u m b u k
حج	ħ a ʒ ʒ
بيت	b iː t a
مرزبان	m a r z a b aː n
قداد	q a d aː d
بلجيكا	b i l d͡ʒ iː k aː
ذنب	ð a n b
كلمة	k a l i m a
ذ	ð
لثم	l a θ a m a
خدش	x a d ʃ
التشيك	a t t ʃ iː k
اسكتلندي	i s k u t l a n d i j j
دكتور	d u k t oː r
أوتوماتيكي	ʔ u t u m aː t iː k i j j
زفيزف	z u f a j z a f
أشابة	ʔ u ʃ aː b a
فور	f a w r a
مزورة	m u z a w w a r a
زميل	z a m iː l
انتفاضة	i n t i f aː dˤ a
قشف	q a ʃ u f a
أبدى	ʔ a b d aː
كاذب	k aː ð i b
رحيق	r a ħ iː q
حر	ħ a r r
جهاد	d͡ʒ i h aː d
مسى	m a s aː
نحال	n a ħ ħ aː l
شفنين	ʃ i f n iː n
بلس	b i l i s
مدرك	m u d r a k
استأنف	i s t a ʔ n a f a
سندس	s u n d u s
محاصر	m u ħ aː sˤ a r
بكين	p i k iː n
نعاس	n u ʕ aː s
سذاب	s a ð aː b
فاكهة	f aː k i h a
نفاذ	n a f aː ð
تحريض	t a ħ r iː dˤ
قلاية	q a l l aː j a
جمعي	d͡ʒ a m m i ʕ iː
عجلة	ʕ a d͡ʒ i l a
وزراء	w u z a r aː ʔ
حسل	ħ i s l
إسلام	ʔ i s l aː m
دم	d a m m
تشيلي	t ʃ iː l iː
فتاحة	f a t t aː ħ a
أم	ʔ a m m
بكى	b u k a n
بصل	b a sˤ a l
زحمة	z a ħ m a
تجوف	t a d͡ʒ a w w u f
نخشوش	n a x ʃ uː ʃ
غشيم	ɣ a ʃ iː m
خريف	x a r iː f
محيط	m u ħ iː tˤ
حربة	ħ a r b a
زحف	z a ħ f
مأوى	m a ʔ w a n
استشراق	i s t i ʃ r aː q
رأسي	r a ʔ s i j j
ميناء	m iː n aː ʔ
قرر	q a r r a r
شمس	ʃ a m a s a
لاوس	l aː w o s
ضرب	dˤ a r r a b a
بركة	b u r k a
بلاستيك	b l a s t iː k
سرنديب	s a r a n d iː b
رحمن	r u ħ i m n a
صغار	sˤ u ɣ aː r
تدريج	t a d r iː d͡ʒ
وجهة	w u d͡ʒ h a
إكوادور	ʔ i k w a d oː r
نيجيريا	n iː d͡ʒ iː r i j aː
أمكن	ʔ a m k a n a
عجان	ʕ i d͡ʒ aː n
أدحية	ʔ u d ħ i j j a
هواء	h a w aː ʔ
بحري	b a ħ r i j j
ثفروق	θ u f r uː q
محجمة	m i ħ d͡ʒ a m a
غلب	ɣ a l b
قيثار	q iː θ aː r
مقداد	m i q d æː d
راء	r aː ʔ i n
كروية	k a r a w j a
ران	r aː n a
بحار	b a ħ ħ aː r
هذر	h a ð a r a
رأى	r a ʔ aː
فتحة	f a t ħ a
نور	n uː r
عرف	ʕ a r f
جرارة	d͡ʒ a r r aː r a
بربرية	b a r b a r i j j a
اعتدى	i ʕ t a d aː
وروار	w a r w aː r
ليزر	l eː z a r
ليس	l a j i s a
فطيس	f i tˤ tˤ iː s
ضحك	dˤ a ħ i k
جوهري	d͡ʒ a w h a r i j j
ديسمبر	d iː s a m b a r
إيمان	ʔ iː m aː n
زعتر	z a ʕ t a r
سيف	s iː f
بلاهة	b a l aː h a
استطار	i s t a tˤ aː r a
تغريدة	t a ɣ r iː d a
آنسة	ʔ aː n i s a h
صدق	sˤ i d q
تحرش	t a ħ a r r u ʃ
معير	m u ʕ a j j i r
هم	h i m
رأل	r a ʔ l
إسقنقور	ʔ i s q a n q uː r
فراطة	f u r aː tˤ a
إطفائي	ʔ i tˤ f aː ʔ i j j
اطرد	u tˤ r u d
قطران	q i tˤ r aː n
حبل	ħ a b a l
عشية	ʕ a ʃ i j j a
مكاء	m u k k aː ʔ
قلم	q ə l ə m
قنبلة	q u n b u l a
داعش	d aː ʕ i ʃ
رجل	r a d͡ʒ l
تقضى	t a q a dˤ dˤ aː
لزاق	l i z aː q
دارجة	d aː r i d͡ʒ a
شكوهج	ʃ a k uː h a d͡ʒ
بطرخ	b a tˤ r a x
لؤلؤ	l u ʔ l u ʔ
قصار	q i sˤ aː r
كمأة	k a m ʔ a
مهارة	m a h aː r a
أجهد	ʔ a d͡ʒ h a d a
ليس	l a j s a
ولاعة	w a l l aː ʕ a
غبن	ɣ u b n
قاعدة	q aː ʕ i d a
شعب	ʃ a ʕ b
علم	ʕ a l i m a
حرص	ħ i r sˤ
قشر	q a ʃ a r a
مغلق	m i ɣ l a q
طرق	tˤ a r r a q a
تاكسي	t a k s iː
دمقس	d i m a q s
أكرى	ʔ a k r aː
نزلة	n a z l a
رتينج	r a t iː n a d͡ʒ
تنفس	t a n a f f a s a
قلم	q a l m
أيل	ʔ u j j a l
تزحلق	t a z a ħ l a q a
أسوأ	ʔ a s w a ʔ
أجزاء	ʔ a d͡ʒ z aː ʔ
تاب	t aː b a
رداء	r i d aː ʔ
تحرش	t u ħ r a ʃ u
ركن	r u k n
صغر	sˤ a ɣ u r a
صفن	sˤ a f a n
مبكرا	m u b a k k i r a n
مسود	m u s w a d d
انتهى	i n t a h aː
بنين	b i n iː n
وعليكم	w æ ʕ æ l æ j k u m
قبلا	q a b l a n
قيتارة	q iː t aː r a
ملح	m u l ħ a
سكن	s a k k a n a
كلخ	k a l x
رد	r a d d
شرعية	ʃ a r ʕ i j j a
ذوق	ð a w q
سجنجل	s a d͡ʒ a n d͡ʒ a l
سفيه	s a f iː h
ن	n uː n
فيج	f a j d͡ʒ
أمغر	ʔ a m ɣ a r
وهمي	w a h m i j j
دفاع	d i f aː ʕ
بنان	b a n aː n
قطع	q a tˤ a ʕ
بركار	b i r k aː r
بغداد	b a ɣ d aː d
نحن	n a ħ n i
قفص	ɡ a f a sˤ
دليل	d a l iː l
نافلة	n aː f i l a
بزرقطونا	b a z r a q a tˤ uː n aː
جامع	d͡ʒ aː m i ʕ
عشب	ʕ u ʃ b
أنت	ʔ a n t a
رهينة	r a h iː n a
طاق	tˤ aː q
مخرج	m u x r a d͡ʒ
راجل	r aː d͡ʒ i l
غبيراء	ɣ u b a j r aː ʔ
لحاق	l a ħ aː q
أونصة	ʔ u n sˤ a
بديهي	b a d iː h i j j
خ	x
ضرط	dˤ a r a tˤ a
زورق	z a w r a q
تنفس	t u n f a s u
آمن	ʔ aː m u n a
انتمى	i n t a m aː
سبب	s a b a b
غرور	ɣ u r uː r
صدر	sˤ a d a r a
قد	q u d d
متناول	m u t a n aː w i l
موقع	m a w q i ʕ
تل	t a l l
سياج	s i j aː d͡ʒ
طابق	tˤ aː b a q
طموحات	tˤ u m uː ħ aː t
عام	ʕ aː m m
مخبول	m a x b uː l
مهرجان	m a h r a d͡ʒ aː n
بلغاريا	b a l ɣ aː r j a
اشتهى	i ʃ t a h aː
دابر	d aː b i r
إبيقوري	ʔ i b iː q uː r i j j
مستوصف	m u s t a w sˤ a f
ظمئ	ðˤ a m i ʔ a
مرصد	m a r sˤ a d
مغامر	m u ɣ aː m i r
موسمي	m a w s i m i j j
خلنجان	x a l a n d͡ʒ aː n
ذاكرة	ð aː k i r a
الحبشة	a l ħ a b a ʃ a
جسماني	d͡ʒ i s m aː n i j j
فتح	f a t a ħ a
دقنيش	d a q n iː ʃ
حائط	ħ aː ʔ i tˤ
قفقف	q a f q a f a
صغار	sˤ i ɣ aː r
صقر	sˤ a q r
كسوة	k u s w a
عمودي	ʕ a m uː d i j j
سقنقور	s a q a n q uː r
مؤامرة	m u ʔ aː m a r a
غاسول	ɣ aː s uː l
مدهش	m u d h a ʃ
ملاحظ	m u l aː ħ a ðˤ
قشر	q i ʃ r
قدم	q a d m
كذاب	k a ð ð aː b
ثلج	θ a l d͡ʒ
لسع	l a s a ʕ a
سخبر	s a x b a r
برقوق	b a r q uː q
بادية	b aː d i j a
استغرق	i s t a ɣ r a q a
طرشي	tˤ u r ʃ i j j
أنفق	ʔ a n f a q a
بوط	b uː tˤ
شوبك	ʃ a w b a k
صابح	sˤ aː b i ħ
مذي	m a ð i
بالون	b aː l uː n
معاينة	m u ʕ aː j a n a
كثيف	k a θ iː f
اعتزام	i ʕ t i z aː m
أغلب	ʔ a ɣ l a b a
خلاعي	x a l aː ʕ i j j
راع	r aː ʕ i n
تكشف	t a k a ʃ ʃ a f a
ذنب	ð a n a b a
رحمن	r a ħ ħ i m n a
ضاد	dˤ aː d d a
بواب	b a w w aː b
منارة	m a n aː r a
كدس	k a d d a s a
كشوت	k u ʃ uː θ
قنبر	ɡ ə m b r i
أجمع	ʔ a d͡ʒ m a ʕ a
زقوم	z a q q uː m
حلقوس	ħ a l q uː s
ناطف	n aː tˤ i f
أعقد	ʔ a ʕ q a d
وتدي	w a t a d i j j
طاولة	tˤ aː w i l a
شرطة	ʃ u r tˤ a
عربة	ʕ a r a b a
أخدر	ʔ a x d a r a
طاء	tˤ aː ʔ
رتيلاء	r u t a j l aː ʔ
منذ	m u n ð u
مشعل	m a ʃ ʕ a l
خثي	x i θ j
هبة	h i b b a
بحر	b a ħ a r a
راسخت	r aː s u x t
ق	q aː f
روسيا	r uː s i j aː
علة	ʕ i l l a
لمى	l a m aː
هذيان	h a ð a j aː n
معى	m i ʕ a n
كوخ	k uː x
شيخوخة	ʃ a j x uː x a
رفقة	r i f q a
أسترالي	ʔ u s t u r aː l i j j
طيارة	tˤ i j j aː r a
أحاط	ʔ a ħ aː tˤ a
سبتمبر	s a b t a m b a r
وفاء	w æ f æː ʔ
ركبة	r a k a b a
شياف	ʃ i j aː f
غبي	ɣ a b i j a
إنجليزي	ʔ i n d͡ʒ l iː z i j j
خطف	x a tˤ i f a
كره	k a r u h a
دكان	d u k k aː n
مسن	m u s i n n
سلاف	s u l aː f
رئيس	r a ʔ iː s
تساءل	t a s aː ʔ a l a
شوكي	ʃ a w k i j j
تراجيديا	t r aː d͡ʒ iː d j aː
يؤيؤ	j u ʔ j u ʔ
حنة	ħ i n n a
مشتريات	m u ʃ t a r a j aː t
أساسي	ʔ a s aː s i j j
سكة	s i k k a
وقت	w a q t
ملاحظ	m u l aː ħ i ðˤ
بولندا	p oː l a n d aː
حجة	ħ i d͡ʒ d͡ʒ a
لاح	l aː ħ a
استقدم	i s t a q d a m a
محافظ	m a ħ aː f i ðˤ
يحيى	j a ħ j aː
سنت	s u n n a t
راعدة	r aː ʕ i d a
استقل	i s t a q a l l a
شفاف	ʃ a f f aː f
ض	ðˤ
موريتانيا	m uː r iː t aː n i j aː
واحة	w aː ħ a
صوت	sˤ a w t
عجب	ʕ a d͡ʒ a b
وقف	w a q q a f a
اغتصب	i ɣ t a sˤ a b a
نسبي	n i s b i j j
أكثرية	ʔ a k θ a r i j j a
فعل	f a ʕ a l a
غني	ɣ a n i j j
كدس	k a d a s a
عباءة	ʕ a b aː ʔ a
حالة	ħ aː l a
أسرة	ʔ u s r a
أعذب	ʔ a ʕ ð a b a
عاصف	ʕ aː sˤ i f
شابانج	ʃ aː b aː n a d͡ʒ
يد	j a d
هوندوراس	h o n d uː r a s
تعادل	t a ʕ aː d a l a
ورى	w a r aː
مزمن	m u z m i n
قرش	q a r ʃ
فرشاة	f u r ʃ aː h
زوج	z a w d͡ʒ
عسجد	ʕ a s d͡ʒ a d
دستوري	d u s t uː r i j j
شطر	ʃ a tˤ a r a
أولى	ʔ uː l aː
أنفحة	ʔ a n f i ħ a
منغوليا	m o n ɣ oː l i j aː
جزدان	d͡ʒ i z d aː n
مكالمة	m u k aː l a m a
نهض	n a h dˤ
بعيثران	b u ʕ a j θ a r aː n
صحيفة	sˤ a ħ iː f a
باطني	b aː tˤ i n i j j
مالك	m aː l i k
هميان	h i m j aː n
فأر	f a ʔ r
وزغ	w a z a ɣ
أخ	ʔ a x
أشعل	ʔ a ʃ ʕ a l
لم	l a m
جلنار	d͡ʒ u l l a n aː r
استنتاج	i s t i n t aː d͡ʒ
محيل	m u ħ iː l
فوذنج	f uː ð a n a d͡ʒ
لوطي	l uː tˤ iː
إدارة	ʔ i d aː r a
حنجري	ħ a n d͡ʒ a r i j j
حرمل	ħ a r m a l
طقس	tˤ a ʔ s
طقس	tˤ a q s
تدرب	t a d a r r u b
غير	ɣ a j j a r a
إنترنت	ʔ i n t a r n a t
تعزل	t a ʕ a z z a l a
شمشاد	ʃ a m ʃ aː d
قنجة	q a n d͡ʒ a
شب	ʃ a b b a
حقق	ħ u q a q
قبج	q a b a d͡ʒ
أصغى	ʔ a sˤ ɣ aː
سئم	s a ʔ i m a
آخر	ʔ aː x a r
مشواة	m i ʃ w aː h
أرجواني	ʔ u r d͡ʒ u w aː n i j j
درس	d a r r a s a
علي	ʕ a l i j a
أراد	ʔ a r aː d a
توزيع	t a w z iː ʕ
دين	d a j j a n a
نسكي	n u s u k i j j
استجهل	i s t a d͡ʒ h a l a
كهنوت	k a h a n uː t
سكران	s a k r aː n
ط	tˤ
تغريد	t a ɣ r iː d
جذع	d͡ʒ a ð a ʕ
بثور	b u θ uː r
زنجبيل	z a n d͡ʒ a b iː l
بطروخ	b a tˤ r uː x
أخلاقية	ʔ a x l aː q i j j a
اصهب	i sˤ h a b b a
أعتن	ʔ a ʕ t a n a
ترجمة	t a r d͡ʒ a m a
رمل	r a m l
تدرج	t a d a r r u d͡ʒ
القسطنطينية	a l q u s tˤ a n tˤ iː n i j j a
ؤ	ʔ u