외할머니	w e̞ ɦ a̠ ɭ m ʌ̹ n i
밀랍	m i ɭ ɭ a̠ p̚
사랑하다	sʰ a̠ ɾ a̠ ŋ ɦ a̠ d a̠
이교	iː ɡ j o
복리	p o̞ ŋ n i
덧글	t ʌ̹ t̚ k͈ ɯ ɭ
날	n a̠ ɭ
카메룬	kʰ a̠ m e̞ ɾ u n
우간다	u ɡ a̠ n d a̠
걱정하다	k ʌ̹ k̚ t͡ɕ͈ ʌ̹ ŋ ɦ a̠ d a̠
각본	k a̠ k̚ p͈ o̞ n
문어	m u n ʌ̹
본뜨다	p o̞ n t͈ ɯ d a̠
특수	tʰ ɯ k s͈ u
규칙적	k j u t͡ɕʰ i k̚ t͡ɕ͈ ʌ̹ k̚
모듬	m o̞ d ɯ m
접속	t͡ɕ ʌ̹ p s͈ o̞ k̚
주정	t͡ɕ uː d͡ʑ ʌ̹ ŋ
싱겁다	ɕʰ i ŋ ɡ ʌ̹ p̚ t͈ a̠
북괴	p u k̚ k͈ w e̞
메토끼	m e̞ tʰ o̞ k͈ i
화산학	ɸ w a̠ sʰ a̠ n ɦ a̠ k̚
너무	n ʌ̹ m u
뗀노	t͈ e̞ n n o̞
아흐레	a̠ ɣ ɯ ɾ e̞
맹세	m ɛː ŋ sʰ e̞
밀다	m i ɭ d a̠
관념	k w a̠ n ɲ j ʌ̹ m
순교	sʰ u n ɡ j o
과학자	k w a̠ ɦ a̠ k̚ t͡ɕ͈ a̠
박이	p a̠ ɡ i
잡수시다	t͡ɕ a̠ p s͈ u ɕʰ i d a̠
혼자	ɸʷ o̞ ɲ d͡ʑ a̠
뇌	n w e̞ː
라볶이	ɾ a̠ b o̞ k͈ i
익살	i k s͈ a̠ ɭ
두셋	t u sʰ e̞ t̚
그레이트브리튼	k ɯ ɾ e̞ i tʰ ɯ b ɯ ɾ i tʰ ɯ n
이기주의	iː ɡ i d͡ʑ u ɰ i
멸종	m j ʌ̹ ʎ t͡ɕ͈ o̞ ŋ
옥잠화	o̞ k̚ t͡ɕ͈ a̠ m β w a̠
업둥이	ʌ̹ p̚ t͈ u ŋ i
유리	j u ɾ i
목적론	m o̞ k̚ t͡ɕ͈ ʌ̹ ŋ n o̞ n
절다	t͡ɕ ɘː ɭ d a̠
대리석	t ɛː ɾ i sʰ ʌ̹ k̚
한꺼번에	h a̠ n k͈ ʌ̹ b ʌ̹ n e̞
특권	tʰ ɯ k̚ k͈ w ʌ̹ n
플루토늄	pʰ ɯ ɭ ɭ u tʰ o̞ ɲ j u m
관련하다	k w a̠ ʎ ʎ j ʌ̹ n ɦ a̠ d a̠
농경	n o̞ ŋ ɡ j ʌ̹ ŋ
풀오버	pʰ u ɾ o̞ b ʌ̹
페샤와르	pʰ e̞ ɕʰ a̠ w a̠ ɾ ɯ
습도	sʰ ɯ p̚ t͈ o̞
마요네즈	m a̠ j o n e̞ d͡ʑ ɯ
무중력	m u d͡ʑ u ŋ ɲ j ʌ̹ k̚
눈두덩	n u n d u d ʌ̹ ŋ
변압기	p j ʌ̹ n a̠ p̚ k͈ i
기름	k i ɾ ɯ m
외국어	w e̞ː ɡ u ɡ ʌ̹
플라스마	pʰ ɯ ɭ ɭ a̠ sʰ ɯ m a̠
브레이크	p ɯ ɾ e̞ i k x ɯ
활동적	ɸ w a̠ ɭ t͈ o̞ ŋ d͡ʑ ʌ̹ k̚
카디건	kʰ a̠ d i ɡ ʌ̹ n
가공하다	k a̠ ɡ o̞ ŋ ɦ a̠ d a̠
무사도	m u sʰ a̠ d o̞
기름사탕	k i ɾ ɯ m sʰ a̠ tʰ a̠ ŋ
나소	n a̠ sʰ o̞
실제로	ɕʰ i ʎ t͡ɕ͈ e̞ ɾ o̞
처방전	t͡ɕʰ ɘː b a̠ ŋ d͡ʑ ʌ̹ n
볼	p o̞ ɭ
도꾜	t o̞ k͈ j o
통사리	tʰ o̞ ŋ sʰ a̠ ɾ i
자폐증	t͡ɕ a̠ pʰ j e̞ t͡ɕ͈ ɯ ŋ
첨	t͡ɕʰ ʌ̹ m
부족	p u d͡ʑ o̞ k̚
절	t͡ɕ ʌ̹ ɭ
당류	t a̠ ŋ ɲ j u
프테리딘	pʰ ɯ tʰ e̞ ɾ i d i n
도둑	t o̞ d u k̚
울	u ɭ
에미	e̞ m i
모듈	m o̞ d j u ɭ
슈인	ɕʰ u i n
스웨덴	sʰ ɯ w e̞ d e̞ n
국물	k u ŋ m u ɭ
쌍꺼풀	s͈ a̠ ŋ k͈ ʌ̹ pʰ u ɭ
이르쿠츠크	i ɾ ɯ kʰ u t͡ɕʰ ɯ k x ɯ
아야	a̠ j a̠
보살피다	p o̞ sʰ a̠ ɭ pʰ i d a̠
만엽집	m a̠ ɲ j ʌ̹ p̚ t͡ɕ͈ i p̚
찐	t͡ɕ͈ i n
연락하다	j ʌ̹ ɭ ɭ a̠ kʰ a̠ d a̠
언제	ɘː ɲ d͡ʑ e̞
시계	ɕʰ iː ɡ j e̞
마케도니아어	m a̠ kʰ e̞ d o̞ n i a̠ ʌ̹
같다	k a̠ t̚ t͈ a̠
인증하다	i ɲ d͡ʑ ɯ ŋ ɦ a̠ d a̠
딱다그르르딱다그르르하다	t͈ a̠ k̚ t͈ a̠ ɡ ɯ ɾ ɯ ɾ ɯ t͈ a̠ k̚ t͈ a̠ ɡ ɯ ɾ ɯ ɾ ɯ ɦ a̠ d a̠
공습	k o̞ ŋ sʰ ɯ p̚
남월	n a̠ m w ʌ̹ ɭ
귀염둥이	k ɥ iː j ʌ̹ m d u ŋ i
무진	m u d͡ʑ i n
심하다	ɕʰ iː m ɦ a̠ d a̠
옳아	o̞ ɾ a̠
산불	sʰ a̠ n b u ɭ
튼튼하다	tʰ ɯ n tʰ ɯ n ɦ a̠ d a̠
곤란하다	k o̞ː ɭ ɭ a̠ n ɦ a̠ d a̠
성질	sʰ ɘː ŋ d͡ʑ i ɭ
구취	k u t͡ɕʰ ɥ i
마구간	m a̠ː ɡ u k͈ a̠ n
에멜무지로	e̞ m e̞ ɭ m u d͡ʑ i ɾ o̞
들어오다	t ɯ ɾ ʌ̹ o̞ d a̠
사망	sʰ a̠ː m a̠ ŋ
필요성	pʰ i ɾ j o s͈ ʌ̹ ŋ
통나무	tʰ o̞ ŋ n a̠ m u
클리토리스	k x ɯ ʎ ʎ i tʰ o̞ ɾ i sʰ ɯ
안와	a̠ː n w a̠
공리	k o̞ ŋ n i
헤아리다	h e̞ː a̠ ɾ i d a̠
쿵후	kʰ u ŋ β u
금발	k ɯ m b a̠ ɭ
연기자	j ɘː n ɡ i d͡ʑ a̠
돌드	t o̞ ɭ d ɯ
담당하다	t a̠ m d a̠ ŋ ɦ a̠ d a̠
꾸다	k͈ u d a̠
비비다	p i b i d a̠
아귀	a̠ː ɡ ɥ i
로씨야	ɾ o̞ ɕ͈ i j a̠
성장하다	sʰ ʌ̹ ŋ d͡ʑ a̠ ŋ ɦ a̠ d a̠
부뚜막	p u t͈ u m a̠ k̚
암스테르담	a̠ m sʰ ɯ tʰ e̞ ɾ ɯ d a̠ m
대주교	t ɛː d͡ʑ u ɡ j o
눈빛	n u n p͈ i t̚
고구마	k o̞ː ɡ u m a̠
눈앞	n u n a̠ p̚
말썽꾸러기	m a̠ː ɭ s͈ ʌ̹ ŋ k͈ u ɾ ʌ̹ ɡ i
페루	pʰ e̞ ɾ u
버들치	p ʌ̹ d ɯ ʎ t͡ɕʰ i
관광	k w a̠ n ɡ w a̠ ŋ
한문	h a̠ n m u n
이	i
꼬리	k͈ o̞ ɾ i
구혼	k u β o̞ n
흔들다	x ɯ n d ɯ ɭ d a̠
밤	p a̠ m
정음	t͡ɕ ʌ̹ ŋ ɯ m
도착하다	t o̞ː t͡ɕʰ a̠ kʰ a̠ d a̠
분석하다	p u n sʰ ʌ̹ kʰ a̠ d a̠
참수리	t͡ɕʰ a̠ m sʰ u ɾ i
함수	h a̠ː m s͈ u
제보	t͡ɕ e̞ b o̞
널빤지	n ɘː ɭ p͈ a̠ ɲ d͡ʑ i
포옹하다	pʰ o̞ː o̞ ŋ ɦ a̠ d a̠
어떻다	ʌ̹ t͈ ʌ̹ tʰ a̠
섹스	s͈ e̞ k s͈ ɯ
최면술	t͡ɕʰ w e̞ m j ʌ̹ n sʰ u ɭ
십구	ɕʰ i p̚ k͈ u
동글	t o̞ ŋ ɡ ɯ ɭ
불가결	p u ɭ ɡ a̠ ɡ j ʌ̹ ɭ
편리	pʰ j ʌ̹ ʎ ʎ i
광화문	k w a̠ ŋ β w a̠ m u n
근질근질하다	k ɯ ɲ d͡ʑ i ɭ ɡ ɯ ɲ d͡ʑ i ɾ ɦ a̠ d a̠
쏘가리	s͈ o̞ ɡ a̠ ɾ i
다롄	t a̠ ɾ j e̞ n
ᆸ니다	m n i d a̠
테스트	tʰ e̞ sʰ ɯ tʰ ɯ
흐름	x ɯ ɾ ɯ m
혼약	ɸʷ o̞ ɲ j a̠ k̚
스파이	sʰ ɯ pʰ a̠ i
예쁘다	j e̞ː p͈ ɯ d a̠
보도하다	p o̞ d o̞ ɦ a̠ d a̠
어떻게	ʌ̹ t͈ ʌ̹ kʰ e̞
굶주리다	k uː m d͡ʑ u ɾ i d a̠
훔치다	ɸʷ u m t͡ɕʰ i d a̠
게으름	k e̞ ɯ ɾ ɯ m
누렁이	n u ɾ ʌ̹ ŋ i
갯과	k ɛː t̚ k͈ w a̠
아빠트	a̠ p͈ a̠ tʰ ɯ
사과	sʰ a̠ː ɡ w a̠
명령법	m j ɘː ŋ ɲ j ʌ̹ ŋ b ʌ̹ p̚
가랑비	k a̠ ɾ a̠ ŋ b i
정치권	t͡ɕ ʌ̹ ŋ t͡ɕʰ i k͈ w ʌ̹ n
사마귀	sʰ a̠ː m a̠ ɡ ɥ i
로마자	ɾ o̞ m a̠ d͡ʑ a̠
가봉	k a̠ b o̞ ŋ
세제	sʰ e̞ː d͡ʑ e̞
표준	pʰ j o d͡ʑ u n
어감	ɘː ɡ a̠ m
콘셉트	kʰ o̞ n sʰ e̞ p̚ tʰ ɯ
그러므로	k ɯ ɾ ʌ̹ m ɯ ɾ o̞
변절	p j ɘː ɲ d͡ʑ ʌ̹ ɭ
오데사	o̞ d e̞ sʰ a̠
카르복실기	kʰ a̠ ɾ ɯ b o̞ k ɕ͈ i ɭ ɡ i
나흘	n a̠ ɣ ɯ ɭ
민주화	m i ɲ d͡ʑ u β w a̠
레슬링	ɾ e̞ sʰ ɯ ʎ ʎ i ŋ
홍수	ɸʷ o̞ ŋ sʰ u
온천	o̞ ɲ t͡ɕʰ ʌ̹ n
리스본	ɾ i sʰ ɯ b o̞ n
스타디오	sʰ ɯ tʰ a̠ d i o̞
함부로	h a̠ m b u ɾ o̞
노처녀	n o̞ː t͡ɕʰ ʌ̹ ɲ j ʌ̹
크로켓	k x ɯ ɾ o̞ kʰ e̞ t̚
엎드리다	ʌ̹ p̚ t͈ ɯ ɾ i d a̠
세미콜론	sʰ e̞ m i kʰ o̞ ɭ ɭ o̞ n
한두	h a̠ n d u
멈추다	m ʌ̹ m t͡ɕʰ u d a̠
중거	t͡ɕ u ŋ ɡ ʌ̹
학자	h a̠ k̚ t͡ɕ͈ a̠
모이다	m o̞ i d a̠
등줄쥐	t ɯ ŋ d͡ʑ u ʎ d͡ʑ ɥ i
스트레이트	sʰ ɯ tʰ ɯ ɾ e̞ i tʰ ɯ
청춘	t͡ɕʰ ʌ̹ ŋ t͡ɕʰ u n
이빠이	i p͈ a̠ i
그냥	k ɯ ɲ j a̠ ŋ
노년	n o̞ː ɲ j ʌ̹ n
저항기	t͡ɕ ʌ̹ ɦ a̠ ŋ ɡ i
유가증권	j uː ɡ a̠ d͡ʑ ɯ ŋ k͈ w ʌ̹ n
아리랑	a̠ ɾ i ɾ a̠ ŋ
통찰력	tʰ o̞ː ŋ t͡ɕʰ a̠ ʎ ʎ j ʌ̹ k̚
살아남다	sʰ a̠ ɾ a̠ n a̠ m t͈ a̠
알콜	a̠ ɭ kʰ o̞ ɭ
부작용	p uː d͡ʑ a̠ ɡ j o ŋ
정장	t͡ɕ ɘː ŋ d͡ʑ a̠ ŋ
촌	t͡ɕʰ o̞ː n
나누다	n a̠ n u d a̠
을	ɯ ɭ
유일	j u i ɭ
마라톤	m a̠ ɾ a̠ tʰ o̞ n
여인숙	j ʌ̹ i n sʰ u k̚
반항하다	p a̠ n ɦ a̠ ŋ ɦ a̠ d a̠
손가락	sʰ o̞ n k͈ a̠ ɾ a̠ k̚
실로폰	ɕʰ i ɭ ɭ o̞ pʰ o̞ n
반드시	p a̠ n d ɯ ɕʰ i
지정학	t͡ɕ i d͡ʑ ʌ̹ ŋ ɦ a̠ k̚
무늬망둑	m u n i m a̠ ŋ d u k̚
몫	m o̞ k̚
교외	k j oː w e̞
연체동물	j ɘː ɲ t͡ɕʰ e̞ d o̞ ŋ m u ɭ
호북	ɸʷ o̞ b u k̚
무기고	m uː ɡ i ɡ o̞
더위	t ʌ̹ ɥ i
모방하다	m o̞ b a̠ ŋ ɦ a̠ d a̠
자루	t͡ɕ a̠ ɾ u
광석	k w a̠ː ŋ sʰ ʌ̹ k̚
섬돌	sʰ ʌ̹ m t͈ o̞ ɭ
왕홀	w a̠ ŋ β o̞ ɭ
공언	k o̞ ŋ ʌ̹ n
딸꾹질하다	t͈ a̠ ɭ k͈ u k̚ t͡ɕ͈ i ɾ ɦ a̠ d a̠
선진국	sʰ ʌ̹ ɲ d͡ʑ i n ɡ u k̚
전역	t͡ɕ ɘː ɲ j ʌ̹ k̚
습니까	s͈ ɯ m n i k͈ a̠
콜론	kʰ o̞ ɭ ɭ o̞ n
빌뉴스	p i ʎ ʎ j u sʰ ɯ
실록	ɕʰ i ɭ ɭ o̞ k̚
나트륨	n a̠ tʰ ɯ ɾ j u m
쇼크	ɕʰ o k x ɯ
연구자	j ɘː n ɡ u d͡ʑ a̠
꼬마	k͈ o̞ m a̠
아가	a̠ː ɡ a̠
비중	p iː d͡ʑ u ŋ
장음	t͡ɕ a̠ ŋ ɯ m
광호흡	k w a̠ ŋ β o̞ ɣ ɯ p̚
여남은	j ʌ̹ n a̠ m ɯ n
손전등	sʰ o̞ ɲ t͡ɕ͈ ʌ̹ n d ɯ ŋ
세계평화	sʰ e̞ ɡ j e̞ pʰ j ʌ̹ ŋ β w a̠
띄다	t͈ iː d a̠
처럼	t͡ɕʰ ʌ̹ ɾ ʌ̹ m
거스러미	k ʌ̹ sʰ ɯ ɾ ʌ̹ m i
청천벽력	t͡ɕʰ ʌ̹ ŋ t͡ɕʰ ʌ̹ n b j ʌ̹ ŋ ɲ j ʌ̹ k̚
떡국	t͈ ʌ̹ k̚ k͈ u k̚
수집하다	sʰ u d͡ʑ i pʰ a̠ d a̠
거리	k ɘː ɾ i
수요일	sʰ u j o i ɭ
방주	p a̠ ŋ d͡ʑ u
걸음	k ʌ̹ ɾ ɯ m
세균	sʰ e̞ː ɡ j u n
볼기	p o̞ː ɭ ɡ i
송구	sʰ o̞ː ŋ ɡ u
어리석다	ʌ̹ ɾ i sʰ ʌ̹ k̚ t͈ a̠
찰	t͡ɕʰ a̠ ɭ
바이오	p a̠ i o̞
어우러지다	ʌ̹ u ɾ ʌ̹ d͡ʑ i d a̠
송도	sʰ o̞ ŋ d o̞
가파르다	k a̠ pʰ a̠ ɾ ɯ d a̠
조용	t͡ɕ o̞ j o ŋ
안트라센	a̠ n tʰ ɯ ɾ a̠ sʰ e̞ n
큰고니	k x ɯ n ɡ o̞ n i
알까기	a̠ ɭ k͈ a̠ ɡ i
왕비	w a̠ ŋ b i
대응	t ɛː ɯ ŋ
광둥	k w a̠ ŋ d u ŋ
식사하다	ɕʰ i k s͈ a̠ ɦ a̠ d a̠
공중	k o̞ ŋ d͡ʑ u ŋ
튀르크	tʰ ɥ i ɾ ɯ k x ɯ
만남	m a̠ n n a̠ m
콤포트	kʰ o̞ m pʰ o̞ tʰ ɯ
나이	n a̠ i
권총	k w ɘː ɲ t͡ɕʰ o̞ ŋ
낙하하다	n a̠ kʰ a̠ ɦ a̠ d a̠
공손하다	k o̞ ŋ sʰ o̞ n ɦ a̠ d a̠
공황	k o̞ː ŋ β w a̠ ŋ
개다	k ɛː d a̠
사계	sʰ a̠ k͈ j e̞
외롭다	w e̞ ɾ o̞ p̚ t͈ a̠
축구	t͡ɕʰ u k̚ k͈ u
고량주	k o̞ ɾ j a̠ ŋ d͡ʑ u
스코페	sʰ ɯ kʰ o̞ pʰ e̞
분포하다	p u n pʰ o̞ ɦ a̠ d a̠
무빙워크	m u b i ŋ w ʌ̹ k x ɯ
사이렌	s͈ a̠ i ɾ e̞ n
흐르다	x ɯ ɾ ɯ d a̠
ㅘ	w a̠
소립자	sʰ o̞ː ɾ i p̚ t͡ɕ͈ a̠
시청	ɕʰ iː t͡ɕʰ ʌ̹ ŋ
라이베리아	ɾ a̠ i b e̞ ɾ i a̠
진언	t͡ɕ i n ʌ̹ n
십칠	ɕʰ i p̚ t͡ɕʰ i ɭ
그노시스	k ɯ n o̞ ɕʰ i sʰ ɯ
음목	ɯ m m o̞ k̚
저것	t͡ɕ ʌ̹ ɡ ʌ̹ t̚
흓	x ɯ k̚
콜카타	kʰ o̞ ɭ kʰ a̠ tʰ a̠
교차로	k j o t͡ɕʰ a̠ ɾ o̞
봄날	p o̞ m n a̠ ɭ
네바다	n e̞ b a̠ d a̠
음량	ɯ m ɲ j a̠ ŋ
조촐하다	t͡ɕ o̞ t͡ɕʰ o̞ ɾ ɦ a̠ d a̠
얼다	ɘː ɭ d a̠
스케이트	sʰ ɯ kʰ e̞ i tʰ ɯ
에스파냐	e̞ sʰ ɯ pʰ a̠ ɲ j a̠
저	t͡ɕ ʌ̹
좋다	t͡ɕ o̞ː tʰ a̠
프라세오디뮴	pʰ ɯ ɾ a̠ sʰ e̞ o̞ d i m j u m
보지	p o̞ː d͡ʑ i
꿩	k͈ w ʌ̹ ŋ
툴	tʰ u ɭ
정찰병	t͡ɕ ʌ̹ ŋ t͡ɕʰ a̠ ɭ b j ʌ̹ ŋ
삼수	sʰ a̠ m sʰ u
펄서	pʰ ʌ̹ ɭ sʰ ʌ̹
월일	w ʌ̹ ɾ i ɭ
돌상어	t o̞ ɭ sʰ a̠ ŋ ʌ̹
이크라	i k x ɯ ɾ a̠
부적	p uː d͡ʑ ʌ̹ k̚
만유인력	m a̠ː ɲ j u i ʎ ʎ j ʌ̹ k̚
늘어서다	n ɯ ɾ ʌ̹ sʰ ʌ̹ d a̠
소원	sʰ o̞ w ʌ̹ n
움짤	u m t͡ɕ͈ a̠ ɭ
노선	n o̞ sʰ ʌ̹ n
면역학	m j ʌ̹ ɲ j ʌ̹ kʰ a̠ k̚
멱살	m j ʌ̹ k s͈ a̠ ɭ
제품	t͡ɕ e̞ː pʰ u m
영국인	j ʌ̹ ŋ ɡ u ɡ i n
김정일화	k i m d͡ʑ ʌ̹ ŋ i ɾ β w a̠
가늠	k a̠ n ɯ m
우먼	u m ʌ̹ n
얼굴	ʌ̹ ɭ ɡ u ɭ
차이니스	t͡ɕʰ a̠ i n i sʰ ɯ
짭	t͡ɕ͈ a̠ p̚
엉망진창	ʌ̹ ŋ m a̠ ŋ d͡ʑ i ɲ t͡ɕʰ a̠ ŋ
잡종	t͡ɕ a̠ p̚ t͡ɕ͈ o̞ ŋ
시절	ɕʰ i d͡ʑ ʌ̹ ɭ
치르다	t͡ɕʰ i ɾ ɯ d a̠
거웃	k ʌ̹ u t̚
지능	t͡ɕ i n ɯ ŋ
미아	m i a̠
조직학	t͡ɕ o̞ d͡ʑ i kʰ a̠ k̚
찢다	t͡ɕ͈ i t̚ t͈ a̠
꿀벌	k͈ u ɭ b ʌ̹ ɭ
오른	o̞ ɾ ɯ n
아파르트헤이트	a̠ pʰ a̠ ɾ ɯ tʰ ɯ ɦ e̞ i tʰ ɯ
차돌박이	t͡ɕʰ a̠ d o̞ ɭ b a̠ ɡ i
순회심판소	sʰ u n β w e̞ ɕʰ i m pʰ a̠ n sʰ o̞
이후	i β u
몰타	m o̞ ɭ tʰ a̠
술	sʰ u ɭ
어디여	ʌ̹ d i j ʌ̹
기후학	k i β u ɦ a̠ k̚
삼십	sʰ a̠ m ɕʰ i p̚
아이	a̠ i
보존	p o̞ː d͡ʑ o̞ n
어울리다	ʌ̹ u ʎ ʎ i d a̠
만주국	m a̠ ɲ d͡ʑ u ɡ u k̚
온두라스	o̞ n d u ɾ a̠ sʰ ɯ
쌍동이	s͈ a̠ ŋ d o̞ ŋ i
음식점	ɯː m ɕʰ i k̚ t͡ɕ͈ ʌ̹ m
의지	ɰ iː d͡ʑ i
뒤늦다	t ɥ iː n ɯ t̚ t͈ a̠
알맞다	a̠ ɭ m a̠ t̚ t͈ a̠
유능하다	j u n ɯ ŋ ɦ a̠ d a̠
아버님	a̠ b ʌ̹ n i m
비로소	p i ɾ o̞ sʰ o̞
비용	p iː j o ŋ
로션	ɾ o̞ ɕʰ ʌ̹ n
매달다	m ɛː d a̠ ɭ d a̠
기차	k i t͡ɕʰ a̠
허용하다	h ʌ̹ j o ŋ ɦ a̠ d a̠
출신성분	t͡ɕʰ u ɭ ɕ͈ i n sʰ ʌ̹ ŋ b u n
마치다	m a̠ t͡ɕʰ i d a̠
자갈	t͡ɕ a̠ ɡ a̠ ɭ
골목	k o̞ː ɭ m o̞ k̚
염소	j ʌ̹ m sʰ o̞
나나니	n a̠ n a̠ n i
이제	i d͡ʑ e̞
이슬람교	i sʰ ɯ ɭ ɭ a̠ m ɡ j o
넓이	n ʌ̹ ɭ b i
조가비	t͡ɕ o̞ ɡ a̠ b i
지압	t͡ɕ i a̠ p̚
입학	i pʰ a̠ k̚
오리	o̞ː ɾ i
예후	j e̞ː β u
친척	t͡ɕʰ i ɲ t͡ɕʰ ʌ̹ k̚
용도	j o ŋ d o̞
표준화	pʰ j oː d͡ʑ u n β w a̠
만들다	m a̠ n d ɯ ɭ d a̠
강설	k a̠ː ŋ sʰ ʌ̹ ɭ
손상하다	sʰ o̞ː n sʰ a̠ ŋ ɦ a̠ d a̠
속마음	sʰ o̞ː ŋ m a̠ ɯ m
경기충청도방언	k j ʌ̹ ŋ ɡ i t͡ɕʰ u ŋ t͡ɕʰ ʌ̹ ŋ d o̞ b a̠ ŋ ʌ̹ n
좋아하다	t͡ɕ o̞ː a̠ ɦ a̠ d a̠
광역시	k w a̠ː ŋ j ʌ̹ k ɕ͈ i
겐	k e̞ n
남극	n a̠ m ɡ ɯ k̚
띠무늬물범	t͈ i m u n i m u ɭ b ʌ̹ m
호텔	ɸʷ o̞ tʰ e̞ ɭ
곱하다	k o̞ pʰ a̠ d a̠
게으르다	k e̞ ɯ ɾ ɯ d a̠
크기	k x ɯ ɡ i
멈칫	m ʌ̹ m t͡ɕʰ i t̚
할머님	h a̠ ɭ m ʌ̹ n i m
연적	j ɘː ɲ d͡ʑ ʌ̹ k̚
귀엣말	k ɥ i e̞ n m a̠ ɭ
달무리	t a̠ ɭ m u ɾ i
부르다	p u ɾ ɯ d a̠
청소하다	t͡ɕʰ ʌ̹ ŋ sʰ o̞ ɦ a̠ d a̠
이미다졸	i m i d a̠ d͡ʑ o̞ ɭ
눈보라	n u n b o̞ ɾ a̠
기린영양	k i ɾ i ɲ j ʌ̹ ŋ j a̠ ŋ
그람	k ɯ ɾ a̠ m
그리고	k ɯ ɾ i ɡ o̞
세네갈	s͈ e̞ n e̞ ɡ a̠ ɭ
전시	t͡ɕ ɘː n ɕʰ i
소박하다	sʰ o̞ b a̠ kʰ a̠ d a̠
네안데르탈인	n e̞ a̠ n d e̞ ɾ ɯ tʰ a̠ ɾ i n
용상어	j o ŋ sʰ a̠ ŋ ʌ̹
아비달마	a̠ b i d a̠ ɭ m a̠
도넛	t o̞ n ʌ̹ t̚
폏	pʰ j ʌ̹ t̚
옥심	o̞ k ɕ͈ i m
잎	i p̚
던데	t ʌ̹ n d e̞
급	k ɯ p̚
너머	n ʌ̹ m ʌ̹
목욕하다	m o̞ ɡ j o kʰ a̠ d a̠
뼒	p͈ j ʌ̹ m
곁	k j ʌ̹ t̚
서툴다	sʰ ɘː tʰ u ɭ d a̠
ㅝ	w ʌ̹
인종차별	i ɲ d͡ʑ o̞ ŋ t͡ɕʰ a̠ b j ʌ̹ ɭ
유르트	j u ɾ ɯ tʰ ɯ
다녀오다	t a̠ ɲ j ʌ̹ o̞ d a̠
표	pʰ j o
대수	t ɛː sʰ u
변소	p j ʌ̹ n sʰ o̞
일부러	iː ɭ b u ɾ ʌ̹
되돌리다	t w e̞ d o̞ ʎ ʎ i d a̠
일사천리	i ɭ s͈ a̠ t͡ɕʰ ʌ̹ ʎ ʎ i
극장	k ɯ k̚ t͡ɕ͈ a̠ ŋ
무당	m uː d a̠ ŋ
그것	k ɯ ɡ ʌ̹ t̚
빨찌산	p͈ a̠ ʎ t͡ɕ͈ i sʰ a̠ n
푸르디푸르다	pʰ u ɾ ɯ d i pʰ u ɾ ɯ d a̠
숫자	sʰ uː t̚ t͡ɕ͈ a̠
모나코	m o̞ n a̠ kʰ o̞
완전히	w a̠ ɲ d͡ʑ ʌ̹ n ʝ i
한인	h a̠ː n i n
은하단	ɯ n ɦ a̠ d a̠ n
고이다	k o̞ i d a̠
웬	w e̞ n
열둘	j ʌ̹ ɭ t͈ u ɭ
콘스탄티누스	kʰ o̞ n sʰ ɯ tʰ a̠ n tʰ i n u sʰ ɯ
환승	ɸ w a̠ː n sʰ ɯ ŋ
몰라	m o̞ ɭ ɭ a̠
수도권	sʰ u d o̞ k͈ w ʌ̹ n
한번	h a̠ n b ʌ̹ n
샴페인	ɕʰ a̠ m pʰ e̞ i n
베트남	p e̞ tʰ ɯ n a̠ m
어렵다	ʌ̹ ɾ j ʌ̹ p̚ t͈ a̠
변비	p j ʌ̹ n b i
성조	sʰ ʌ̹ ŋ d͡ʑ o̞
풍	pʰ u ŋ
원자폭탄	w ʌ̹ ɲ d͡ʑ a̠ pʰ o̞ k̚ tʰ a̠ n
더하다	t ʌ̹ ɦ a̠ d a̠
검역	k ʌ̹ m j ʌ̹ k̚
보이다	p o̞ i d a̠
박제	p a̠ k̚ t͡ɕ͈ e̞
년	ɲ j ʌ̹ n
자동	t͡ɕ a̠ d o̞ ŋ
반도체	p a̠ n d o̞ t͡ɕʰ e̞
갸웃거리다	k j a̠ u t̚ k͈ ʌ̹ ɾ i d a̠
대사	t ɛː sʰ a̠
소스	sʰ o̞ sʰ ɯ
니제르	n i d͡ʑ e̞ ɾ ɯ
알라딘	a̠ ɭ ɭ a̠ d i n
김멜	k i m m e̞ ɭ
반짝이다	p a̠ ɲ t͡ɕ͈ a̠ ɡ i d a̠
수능	sʰ u n ɯ ŋ
구약성경	k u j a̠ k s͈ ʌ̹ ŋ ɡ j ʌ̹ ŋ
악영향	a̠ ɡ j ʌ̹ ŋ ʝ j a̠ ŋ
로보트	ɾ o̞ b o̞ tʰ ɯ
솔로몬	sʰ o̞ ɭ ɭ o̞ m o̞ n
대다	t ɛː d a̠
한영	h a̠ː ɲ j ʌ̹ ŋ
기역	k i j ʌ̹ k̚
에너지	e̞ n ʌ̹ d͡ʑ i
충고	t͡ɕʰ u ŋ ɡ o̞
씹하다	ɕ͈ i pʰ a̠ d a̠
뽀뽀	p͈ o̞ p͈ o̞
가르다	k a̠ ɾ ɯ d a̠
가라데	k a̠ ɾ a̠ d e̞
눈꽃	n uː n k͈ o̞ t̚
스테이플러	sʰ ɯ tʰ e̞ i pʰ ɯ ɭ ɭ ʌ̹
의료	ɰ i ɾ j o
꺼풀	k͈ ʌ̹ pʰ u ɭ
확인하다	ɸ w a̠ ɡ i n ɦ a̠ d a̠
각국	k a̠ k̚ k͈ u k̚
양봉가	j a̠ː ŋ b o̞ ŋ ɡ a̠
섬서	sʰ ʌ̹ m sʰ ʌ̹
쌍	s͈ a̠ ŋ
조피볼락	t͡ɕ o̞ pʰ i b o̞ ɭ ɭ a̠ k̚
발달하다	p a̠ ɭ t͈ a̠ ɾ ɦ a̠ d a̠
쌍점	s͈ a̠ ŋ d͡ʑ ʌ̹ m
앙케트	a̠ ŋ kʰ e̞ tʰ ɯ
력	ɾ j ʌ̹ k̚
항공모함	h a̠ ŋ ɡ o̞ ŋ m o̞ ɦ a̠ m
수염수리	sʰ u j ʌ̹ m sʰ u ɾ i
동의	t o̞ ŋ ɰ i
페난트렌	pʰ e̞ n a̠ n tʰ ɯ ɾ e̞ n
일동	i ɭ t͈ o̞ ŋ
둥지	t u ŋ d͡ʑ i
달라지다	t a̠ ɭ ɭ a̠ d͡ʑ i d a̠
경험치	k j ʌ̹ ŋ ɦ ʌ̹ m t͡ɕʰ i
닦다	t a̠ k̚ t͈ a̠
나다	n a̠ d a̠
중계	t͡ɕ u ŋ ɡ j e̞
사업	sʰ a̠ː ʌ̹ p̚
타나크	tʰ a̠ n a̠ k x ɯ
임	i m
벤또	p e̞ n t͈ o̞
글씨	k ɯ ɭ ɕ͈ i
이심전심	i ɕʰ i m d͡ʑ ʌ̹ n ɕʰ i m
등장	t ɯ ŋ d͡ʑ a̠ ŋ
사무실	sʰ a̠ː m u ɕʰ i ɭ
공교	k o̞ː ŋ ɡ j o
정제	t͡ɕ ʌ̹ ŋ d͡ʑ e̞
꾸짖다	k͈ u d͡ʑ i t̚ t͈ a̠
마파람	m a̠ pʰ a̠ ɾ a̠ m
싣	ɕʰ i t̚
브리튼	p ɯ ɾ i tʰ ɯ n
직접적	t͡ɕ i k̚ t͡ɕ͈ ʌ̹ p̚ t͡ɕ͈ ʌ̹ k̚
려권	ɾ j ʌ̹ ɡ w ʌ̹ n
북동	p u k̚ t͈ o̞ ŋ
해면	h ɛː m j ʌ̹ n
낯	n a̠ t̚
반주	p a̠ː ɲ d͡ʑ u
잠열	t͡ɕ a̠ m j ʌ̹ ɭ
인삼	i n sʰ a̠ m
통조림	tʰ o̞ ŋ d͡ʑ o̞ ɾ i m
점	t͡ɕ ʌ̹ m
포크	pʰ o̞ k x ɯ
공기방석자동차	k o̞ ŋ ɡ i b a̠ ŋ sʰ ʌ̹ k̚ t͡ɕ͈ a̠ d o̞ ŋ t͡ɕʰ a̠
돌가자미	t o̞ ɭ ɡ a̠ d͡ʑ a̠ m i
폭동	pʰ o̞ k̚ t͈ o̞ ŋ
식물	ɕʰ i ŋ m u ɭ
털실	tʰ ʌ̹ ɭ ɕʰ i ɭ
과자	k w a̠ː d͡ʑ a̠
쌀미꾸리	s͈ a̠ ɭ m i k͈ u ɾ i
부활절	p uː β w a̠ ʎ t͡ɕ͈ ʌ̹ ɭ
띵호아	t͈ i ŋ β o̞ a̠
아프다	a̠ pʰ ɯ d a̠
창업	t͡ɕʰ a̠ː ŋ ʌ̹ p̚
유기체	j uː ɡ i t͡ɕʰ e̞
발랄라이카	p a̠ ɭ ɭ a̠ ɭ ɭ a̠ i kʰ a̠
계산서	k j e̞ː sʰ a̠ n sʰ ʌ̹
귀밑털	k ɥ i m i t̚ tʰ ʌ̹ ɭ
마취	m a̠ t͡ɕʰ ɥ i
나팔꽃	n a̠ pʰ a̠ ɭ k͈ o̞ t̚
출납계	t͡ɕʰ u ɭ ɭ a̠ p̚ k͈ j e̞
원주필	w ʌ̹ ɲ d͡ʑ u pʰ i ɭ
필드	pʰ i ɭ d ɯ
권하다	k w ɘː n ɦ a̠ d a̠
독자	t o̞ k̚ t͡ɕ͈ a̠
폴리머	pʰ o̞ ʎ ʎ i m ʌ̹
뷁	p w e̞ k̚
피란	pʰ i ɾ a̠ n
퇴근하다	tʰ w e̞ː ɡ ɯ n ɦ a̠ d a̠
통풍	tʰ o̞ː ŋ pʰ u ŋ
방치하다	p a̠ː ŋ t͡ɕʰ i ɦ a̠ d a̠
천자	t͡ɕʰ ʌ̹ ɲ d͡ʑ a̠
올림말	o̞ ʎ ʎ i m m a̠ ɭ
하도	h a̠ d o̞
마무리	m a̠ m u ɾ i
가루	k a̠ ɾ u
칼로리	kʰ a̠ ɭ ɭ o̞ ɾ i
뒹굴뒹굴	t ɥ i ŋ ɡ u ɭ d ɥ i ŋ ɡ u ɭ
일컫다	i ɭ kʰ ʌ̹ t̚ t͈ a̠
올라오다	o̞ ɭ ɭ a̠ o̞ d a̠
스타디움	sʰ ɯ tʰ a̠ d i u m
함께	h a̠ m k͈ e̞
회담	ɸ w e̞ː d a̠ m
권당	k w ʌ̹ n d a̠ ŋ
반년	p a̠ː n ɲ j ʌ̹ n
어찌하다	ʌ̹ t͡ɕ͈ i ɦ a̠ d a̠
무용하다	m u j o ŋ ɦ a̠ d a̠
페나진	pʰ e̞ n a̠ d͡ʑ i n
한쌍	h a̠ n s͈ a̠ ŋ
해동	h ɛː d o̞ ŋ
곭	k o̞ ɭ
차림	t͡ɕʰ a̠ ɾ i m
압도	a̠ p̚ t͈ o̞
다이아몬드	t a̠ i a̠ m o̞ n d ɯ
급여	k ɯ b j ʌ̹
빗	p i t̚
네모꼴	n e̞ː m o̞ k͈ o̞ ɭ
탄약고	tʰ a̠ː ɲ j a̠ k̚ k͈ o̞
대중문화	t ɛː d͡ʑ u ŋ m u n β w a̠
외손자	w e̞ː sʰ o̞ ɲ d͡ʑ a̠
호수	ɸʷ o̞ sʰ u
획득하다	ɸ w e̞ k̚ t͈ ɯ kʰ a̠ d a̠
의회	ɰ i β w e̞
남작	n a̠ m d͡ʑ a̠ k̚
시베리아	ɕʰ i b e̞ ɾ i a̠
가두녀성	k a̠ d u ɲ j ʌ̹ sʰ ʌ̹ ŋ
앞장서다	a̠ p̚ t͡ɕ͈ a̠ ŋ sʰ ʌ̹ d a̠
지부티	t͡ɕ i b u tʰ i
카르마	kʰ a̠ ɾ ɯ m a̠
구니	k u n i
메시지	m e̞ ɕʰ i d͡ʑ i
마르다	m a̠ ɾ ɯ d a̠
스칸듐	sʰ ɯ kʰ a̠ n d j u m
건설하다	k ɘː n sʰ ʌ̹ ɾ ɦ a̠ d a̠
화장장	ɸ w a̠ː d͡ʑ a̠ ŋ d͡ʑ a̠ ŋ
불구속	p u ɭ ɡ u sʰ o̞ k̚
펄럭펄럭	pʰ ʌ̹ ɭ ɭ ʌ̹ k̚ pʰ ʌ̹ ɭ ɭ ʌ̹ k̚
권	k w ʌ̹ n
감미료	k a̠ m m i ɾ j o
달콤하다	t a̠ ɭ kʰ o̞ m ɦ a̠ d a̠
사면	sʰ a̠ m j ʌ̹ n
홀로	ɸʷ o̞ ɭ ɭ o̞
벌이다	p ɘː ɾ i d a̠
편	pʰ j ʌ̹ n
보일러	p o̞ i ɭ ɭ ʌ̹
사기꾼	sʰ a̠ ɡ i k͈ u n
후견인	ɸʷ uː ɡ j ʌ̹ n i n
샅	sʰ a̠ t̚
이케바나	i kʰ e̞ b a̠ n a̠
열반	j ʌ̹ ɭ b a̠ n
관풍금	k w a̠ n pʰ u ŋ ɡ ɯ m
크로아티아	k x ɯ ɾ o̞ a̠ tʰ i a̠
구아니딘	k u a̠ n i d i n
코트디부아르	kʰ o̞ tʰ ɯ d i b u a̠ ɾ ɯ
열여덟	j ʌ̹ ʎ ʎ j ʌ̹ d ʌ̹ ɭ
경제	k j ʌ̹ ŋ d͡ʑ e̞
바	p a̠
감각적	k a̠ m ɡ a̠ k̚ t͡ɕ͈ ʌ̹ k̚
장관	t͡ɕ a̠ː ŋ ɡ w a̠ n
전한	t͡ɕ ʌ̹ n ɦ a̠ n
정적분	t͡ɕ ʌ̹ ŋ d͡ʑ ʌ̹ k̚ p͈ u n
슬기	sʰ ɯ ɭ ɡ i
할례쁘	h a̠ ʎ ʎ j e̞ p͈ ɯ
우정	uː d͡ʑ ʌ̹ ŋ
통로	tʰ o̞ ŋ n o̞
머리말	m ʌ̹ ɾ i m a̠ ɭ
오문	o̞ m u n
인제	i ɲ d͡ʑ e̞
쌀국수	s͈ a̠ ɭ ɡ u k s͈ u
닿다	t a̠ː tʰ a̠
얼룩말	ʌ̹ ɭ ɭ u ŋ m a̠ ɭ
매달리다	m ɛː d a̠ ʎ ʎ i d a̠
묘지	m j oː d͡ʑ i
굵다	k uː k̚ t͈ a̠
인권	i n k͈ w ʌ̹ n
보장	p o̞ː d͡ʑ a̠ ŋ
쌍둥이	s͈ a̠ ŋ d u ŋ i
각종	k a̠ k̚ t͡ɕ͈ o̞ ŋ
수은	sʰ u ɯ n
초능력	t͡ɕʰ o̞ n ɯ ŋ ɲ j ʌ̹ k̚
술집	sʰ u ʎ t͡ɕ͈ i p̚
파충	pʰ a̠ t͡ɕʰ u ŋ
당	t a̠ ŋ
비하다	p iː ɦ a̠ d a̠
팔미트산	pʰ a̠ ɭ m i tʰ ɯ sʰ a̠ n
의식	ɰ iː ɕʰ i k̚
기여하다	k i j ʌ̹ ɦ a̠ d a̠
대단하다	t ɛː d a̠ n ɦ a̠ d a̠
단엽기	t a̠ ɲ j ʌ̹ p̚ k͈ i
빈방	p iː n b a̠ ŋ
흡혈귀	x ɯ pʰ j ʌ̹ ɭ ɡ ɥ i
점차	t͡ɕ ɘː m t͡ɕʰ a̠
시인	ɕʰ iː i n
품갚음하다	pʰ u m ɡ a̠ pʰ ɯ m ɦ a̠ d a̠
위굴말	ɥ i ɡ u ɭ m a̠ ɭ
부근	p uː ɡ ɯ n
법원	p ʌ̹ b w ʌ̹ n
족	t͡ɕ o̞ k̚
뚜렷하다	t͈ u ɾ j ʌ̹ tʰ a̠ d a̠
안전	a̠ ɲ d͡ʑ ʌ̹ n
포함되다	pʰ o̞ ɦ a̠ m d w e̞ d a̠
기회	k i β w e̞
삥궐	p͈ i ŋ ɡ w ʌ̹ ɭ
고스트	k o̞ sʰ ɯ tʰ ɯ
승강기	sʰ ɯ ŋ ɡ a̠ ŋ ɡ i
더럽다	t ɘː ɾ ʌ̹ p̚ t͈ a̠
예상	j e̞ː sʰ a̠ ŋ
연월일	j ʌ̹ n w ʌ̹ ɾ i ɭ
속삭임	sʰ o̞ k s͈ a̠ ɡ i m
전혀	t͡ɕ ʌ̹ n ʝ j ʌ̹
낙천주의	n a̠ k̚ t͡ɕʰ ʌ̹ ɲ d͡ʑ u ɰ i
걸음마	k ʌ̹ ɾ ɯ m m a̠
굴비	k u ɭ b i
트럭	tʰ ɯ ɾ ʌ̹ k̚
무스카트	m u sʰ ɯ kʰ a̠ tʰ ɯ
파두츠	pʰ a̠ d u t͡ɕʰ ɯ
그끄제	k ɯ k͈ ɯ d͡ʑ e̞
양피지	j a̠ ŋ pʰ i d͡ʑ i
바이너리	p a̠ i n ʌ̹ ɾ i
에이즈	e̞ i d͡ʑ ɯ
해파리	h ɛː pʰ a̠ ɾ i
장난	t͡ɕ a̠ ŋ n a̠ n
사춘기	sʰ a̠ t͡ɕʰ u n ɡ i
주무르다	t͡ɕ u m u ɾ ɯ d a̠
늦가을	n ɯ t̚ k͈ a̠ ɯ ɭ
기획	k i β w e̞ k̚
잡담	t͡ɕ a̠ p̚ t͈ a̠ m
다투다	t a̠ tʰ u d a̠
몰	m o̞ ɭ
주부	t͡ɕ u b u
골반	k o̞ ɭ b a̠ n
평형	pʰ j ʌ̹ ŋ ʝ j ʌ̹ ŋ
메뉴	m e̞ ɲ j u
파파라치	pʰ a̠ pʰ a̠ ɾ a̠ t͡ɕʰ i
갉다	k a̠ k̚ t͈ a̠
방심	p a̠ ŋ ɕʰ i m
가능성	k a̠ː n ɯ ŋ s͈ ʌ̹ ŋ
쌍기역	s͈ a̠ ŋ ɡ i j ʌ̹ k̚
타슈켄트	tʰ a̠ ɕʰ u kʰ e̞ n tʰ ɯ
지방산	t͡ɕ i b a̠ ŋ sʰ a̠ n
칠성장어	t͡ɕʰ i ɭ s͈ ʌ̹ ŋ d͡ʑ a̠ ŋ ʌ̹
조혈	t͡ɕ o̞ ʝ j ʌ̹ ɭ
반시옷	p a̠ n ɕʰ i o̞ t̚
유익하다	j u i kʰ a̠ d a̠
스위스	sʰ ɯ ɥ i sʰ ɯ
담보물	t a̠ m b o̞ m u ɭ
비트코인	p i tʰ ɯ kʰ o̞ i n
바늘	p a̠ n ɯ ɭ
양치	j a̠ ŋ t͡ɕʰ i
뜨락또르	t͈ ɯ ɾ a̠ k̚ t͈ o̞ ɾ ɯ
사이즈	sʰ a̠ i d͡ʑ ɯ
지푸라기	t͡ɕ i pʰ u ɾ a̠ ɡ i
복권	p o̞ k̚ k͈ w ʌ̹ n
구이	k u i
유사하다	j uː sʰ a̠ ɦ a̠ d a̠
우사	u sʰ a̠
꾸구리	k͈ u ɡ u ɾ i
치는	t͡ɕʰ i n ɯ n
북돋다	p u k̚ t͈ o̞ t̚ t͈ a̠
톤	tʰ o̞ n
뒤쥐	t ɥ i d͡ʑ ɥ i
참	t͡ɕʰ a̠ m
뉴트리아	ɲ j u tʰ ɯ ɾ i a̠
폭우	pʰ o̞ ɡ u
농장	n o̞ ŋ d͡ʑ a̠ ŋ
발전하다	p a̠ ʎ t͡ɕ͈ ʌ̹ n ɦ a̠ d a̠
전도서	t͡ɕ ʌ̹ n d o̞ sʰ ʌ̹
돌아가다	t o̞ ɾ a̠ ɡ a̠ d a̠
사골	sʰ a̠ ɡ o̞ ɭ
긴급	k i n ɡ ɯ p̚
갑작스레	k a̠ p̚ t͡ɕ͈ a̠ k s͈ ɯ ɾ e̞
시발	ɕʰ iː b a̠ ɭ
거드름	k ɘː d ɯ ɾ ɯ m
뼡	p͈ j ʌ̹ t̚
파라과이	pʰ a̠ ɾ a̠ ɡ w a̠ i
죄악	t͡ɕ w e̞ː a̠ k̚
건축	k ɘː ɲ t͡ɕʰ u k̚
초음파	t͡ɕʰ o̞ ɯ m pʰ a̠
세벌식	sʰ e̞ b ʌ̹ ɭ ɕʰ i k̚
유모차	j u m o̞ t͡ɕʰ a̠
피트	pʰ i tʰ ɯ
막걸리	m a̠ k̚ k͈ ʌ̹ ʎ ʎ i
부티크	p u tʰ i k x ɯ
시달리다	ɕʰ i d a̠ ʎ ʎ i d a̠
변화하다	p j ɘː n β w a̠ ɦ a̠ d a̠
짚	t͡ɕ i p̚
광산	k w a̠ ŋ sʰ a̠ n
령	ɾ j ʌ̹ ŋ
방문	p a̠ː ŋ m u n
감싸다	k a̠ː m s͈ a̠ d a̠
자꾸만	t͡ɕ a̠ k͈ u m a̠ n
풀버전	pʰ u ɭ b ʌ̹ d͡ʑ ʌ̹ n
봐주다	p w a̠ː d͡ʑ u d a̠
엊	ʌ̹ t̚
싸	s͈ a̠
팝콘	pʰ a̠ p̚ kʰ o̞ n
확실히	ɸ w a̠ k ɕ͈ i ɾ ʝ i
타다	tʰ a̠ d a̠
서울	sʰ ʌ̹ u ɭ
가소제	k a̠ː sʰ o̞ d͡ʑ e̞
지옥	t͡ɕ i o̞ k̚
독서실	t o̞ k s͈ ʌ̹ ɕʰ i ɭ
횡령하다	ɸ w e̞ ŋ ɲ j ʌ̹ ŋ ɦ a̠ d a̠
낚시	n a̠ k ɕ͈ i
아말감	a̠ m a̠ ɭ ɡ a̠ m
흥겹다	x ɯː ŋ ɡ j ʌ̹ p̚ t͈ a̠
설명하다	sʰ ʌ̹ ɭ m j ʌ̹ ŋ ɦ a̠ d a̠
체르노빌	t͡ɕʰ e̞ ɾ ɯ n o̞ b i ɭ
전체	t͡ɕ ʌ̹ ɲ t͡ɕʰ e̞
약간	j a̠ k̚ k͈ a̠ n
칭찬하다	t͡ɕʰ i ŋ t͡ɕʰ a̠ n ɦ a̠ d a̠
대답하다	t ɛː d a̠ pʰ a̠ d a̠
습지	sʰ ɯ p̚ t͡ɕ͈ i
반역자	p a̠ː ɲ j ʌ̹ k̚ t͡ɕ͈ a̠
파충류	pʰ a̠ t͡ɕʰ u ŋ ɲ j u
깔	k͈ a̠ ɭ
대리인	t ɛː ɾ i i n
티탄	tʰ i tʰ a̠ n
카자흐스탄	kʰ a̠ d͡ʑ a̠ ɣ ɯ sʰ ɯ tʰ a̠ n
겨울	k j ʌ̹ u ɭ
싯	ɕʰ i t̚
비타민	p i tʰ a̠ m i n
위원장	ɥ i w ʌ̹ ɲ d͡ʑ a̠ ŋ
겹치다	k j ʌ̹ p̚ t͡ɕʰ i d a̠
상수	sʰ a̠ ŋ sʰ u
결합	k j ʌ̹ ɾ ɦ a̠ p̚
부인하다	p uː i n ɦ a̠ d a̠
그림분필	k ɯ ɾ i m b u n pʰ i ɭ
죽지	t͡ɕ u k̚ t͡ɕ͈ i
세뇌	sʰ e̞ n w e̞
카우보이	kʰ a̠ u b o̞ i
호정	ɸʷ o̞ d͡ʑ ʌ̹ ŋ
외교관	w e̞ː ɡ j o ɡ w a̠ n
우루과이	u ɾ u ɡ w a̠ i
다리미질	t a̠ ɾ i m i d͡ʑ i ɭ
구렁	k u ɾ ʌ̹ ŋ
마력	m a̠ː ɾ j ʌ̹ k̚
구리다	k u ɾ i d a̠
실명	ɕʰ i ɭ m j ʌ̹ ŋ
환경	ɸ w a̠ n ɡ j ʌ̹ ŋ
연주하다	j ɘː ɲ d͡ʑ u ɦ a̠ d a̠
파이프오르간	pʰ a̠ i pʰ ɯ o̞ ɾ ɯ ɡ a̠ n
학급	h a̠ k̚ k͈ ɯ p̚
첫날	t͡ɕʰ ʌ̹ n n a̠ ɭ
보석	p o̞ː sʰ ʌ̹ k̚
숙제	sʰ u k̚ t͡ɕ͈ e̞
짖다	t͡ɕ i t̚ t͈ a̠
마차	m a̠ː t͡ɕʰ a̠
대답	t ɛː d a̠ p̚
크리스마스이브	k x ɯ ɾ i sʰ ɯ m a̠ sʰ ɯ i b ɯ
안타나나리보	a̠ n tʰ a̠ n a̠ n a̠ ɾ i b o̞
기근	k i ɡ ɯ n
뢴트게늄	ɾ w e̞ n tʰ ɯ ɡ e̞ ɲ j u m
세차	sʰ e̞ː t͡ɕʰ a̠
고맙습니다	k o̞ m a̠ p s͈ ɯ m n i d a̠
침몰	t͡ɕʰ i m m o̞ ɭ
독살	t o̞ k s͈ a̠ ɭ
에서	e̞ sʰ ʌ̹
타갈로그어	tʰ a̠ ɡ a̠ ɭ ɭ o̞ ɡ ɯ ʌ̹
주님	t͡ɕ u n i m
원하다	w ɘː n ɦ a̠ d a̠
아무	a̠ː m u
밀림	m i ʎ ʎ i m
비둘기	p i d u ɭ ɡ i
샤프펜실	ɕʰ a̠ pʰ ɯ pʰ e̞ n ɕʰ i ɭ
투숙하다	tʰ u sʰ u kʰ a̠ d a̠
컬트	kʰ ʌ̹ ɭ tʰ ɯ
찰나	t͡ɕʰ a̠ ɭ ɭ a̠
복습	p o̞ k s͈ ɯ p̚
파인더	pʰ a̠ i n d ʌ̹
예약	j e̞ː j a̠ k̚
불평	p u ɭ pʰ j ʌ̹ ŋ
마무르다	m a̠ m u ɾ ɯ d a̠
군사	k u n sʰ a̠
손가락질	sʰ o̞ n ɡ a̠ ɾ a̠ k̚ t͡ɕ͈ i ɭ
혼인	ɸʷ o̞ n i n
일하다	iː ɾ ɦ a̠ d a̠
다리미질하다	t a̠ ɾ i m i d͡ʑ i ɾ ɦ a̠ d a̠
반지하	p a̠ ɲ d͡ʑ i ɦ a̠
계약	k j e̞ j a̠ k̚
리우데자네이루	ɾ i u d e̞ d͡ʑ a̠ n e̞ i ɾ u
가하다	k a̠ ɦ a̠ d a̠
합창단	h a̠ p̚ t͡ɕʰ a̠ ŋ d a̠ n
천왕성	t͡ɕʰ ʌ̹ n w a̠ ŋ sʰ ʌ̹ ŋ
베일	p e̞ i ɭ
준비	t͡ɕ uː n b i
국한문	k u kʰ a̠ n m u n
달필	t a̠ ɭ pʰ i ɭ
다이오드	t a̠ i o̞ d ɯ
열쇠	j ɘː ɭ s͈ w e̞
타이틀	tʰ a̠ i tʰ ɯ ɭ
어미	ɘː m i
가관	k a̠ː ɡ w a̠ n
여쭈다	j ɘː t͡ɕ͈ u d a̠
수량	sʰ uː ɾ j a̠ ŋ
통하다	tʰ o̞ ŋ ɦ a̠ d a̠
낱말	n a̠ː n m a̠ ɭ
외과	w e̞ː k͈ w a̠
망원경	m a̠ː ŋ w ʌ̹ n ɡ j ʌ̹ ŋ
국제	k u k̚ t͡ɕ͈ e̞
파나마	pʰ a̠ n a̠ m a̠
악당	a̠ k̚ t͈ a̠ ŋ
황천	ɸ w a̠ ŋ t͡ɕʰ ʌ̹ n
게우다	k e̞ u d a̠
발전	p a̠ ʎ t͡ɕ͈ ʌ̹ n
잡다	t͡ɕ a̠ p̚ t͈ a̠
블라디미르	p ɯ ɭ ɭ a̠ d i m i ɾ ɯ
충칭	t͡ɕʰ u ŋ t͡ɕʰ i ŋ
구호	k uː β o̞
놀이	n o̞ ɾ i
대음순	t ɛː ɯ m sʰ u n
정당	t͡ɕ ɘː ŋ d a̠ ŋ
돌아오다	t o̞ ɾ a̠ o̞ d a̠
재작년	t͡ɕ ɛː d͡ʑ a̠ ŋ ɲ j ʌ̹ n
면	m j ʌ̹ n
이디시어	i d i ɕʰ i ʌ̹
전자가마	t͡ɕ ʌ̹ ɲ d͡ʑ a̠ ɡ a̠ m a̠
쏘련	s͈ o̞ ɾ j ʌ̹ n
천갈궁	t͡ɕʰ ʌ̹ n ɡ a̠ ɭ ɡ u ŋ
사업가	sʰ a̠ː ʌ̹ p̚ k͈ a̠
산티아고	sʰ a̠ n tʰ i a̠ ɡ o̞
편찮으시다	pʰ j ʌ̹ ɲ t͡ɕʰ a̠ n ɯ ɕʰ i d a̠
예상되다	j e̞ː sʰ a̠ ŋ d w e̞ d a̠
야무수크로	j a̠ m u sʰ u k x ɯ ɾ o̞
근지럽다	k ɯ ɲ d͡ʑ i ɾ ʌ̹ p̚ t͈ a̠
입법자	i p̚ p͈ ʌ̹ p̚ t͡ɕ͈ a̠
후사	ɸʷ uː sʰ a̠
미끄럽다	m i k͈ ɯ ɾ ʌ̹ p̚ t͈ a̠
스토브	sʰ ɯ tʰ o̞ b ɯ
나방	n a̠ b a̠ ŋ
꽃잎	k͈ o̞ n n i p̚
초혼	t͡ɕʰ o̞ β o̞ n
말	m a̠ ɭ
불친절	p u ʎ t͡ɕʰ i ɲ d͡ʑ ʌ̹ ɭ
주어	t͡ɕ u ʌ̹
밀도	m i ɭ t͈ o̞
애완동물	ɛː w a̠ n d o̞ ŋ m u ɭ
머금다	m ʌ̹ ɡ ɯ m d a̠
도토리	t o̞ tʰ o̞ ɾ i
당황	t a̠ ŋ β w a̠ ŋ
직관	t͡ɕ i k̚ k͈ w a̠ n
씹다	ɕ͈ i p̚ t͈ a̠
가만두다	k a̠ m a̠ n d u d a̠
류형	ɾ j uː ʝ j ʌ̹ ŋ
벌어지다	p ɘː ɾ ʌ̹ d͡ʑ i d a̠
성경	sʰ ɘː ŋ ɡ j ʌ̹ ŋ
보르시	p o̞ ɾ ɯ ɕʰ i
코스타리카	kʰ o̞ sʰ ɯ tʰ a̠ ɾ i kʰ a̠
맛없다	m a̠ d ʌ̹ p̚ t͈ a̠
길이	k i ɾ i
간질이다	k a̠ ɲ d͡ʑ i ɾ i d a̠
당신들	t a̠ ŋ ɕʰ i n d ɯ ɭ
야자	j a̠ː d͡ʑ a̠
진동수	t͡ɕ i n d o̞ ŋ sʰ u
일왕	i ɾ w a̠ ŋ
집다	t͡ɕ i p̚ t͈ a̠
삐딱하다	p͈ i t͈ a̠ kʰ a̠ d a̠
신고하다	ɕʰ i n ɡ o̞ ɦ a̠ d a̠
젖당못견딤증	t͡ɕ ʌ̹ t̚ t͈ a̠ ŋ m o̞ t̚ k͈ j ʌ̹ n d i m d͡ʑ ɯ ŋ
직후	t͡ɕ i kʰ u
여럿	j ʌ̹ ɾ ʌ̹ t̚
뜬소문	t͈ ɯ n sʰ o̞ m u n
제비	t͡ɕ e̞ b i
기름밥	k i ɾ ɯ m b a̠ p̚
삼륜차	sʰ a̠ m ɲ j u ɲ t͡ɕʰ a̠
소시지	sʰ o̞ ɕʰ i d͡ʑ i
코리아	kʰ o̞ ɾ i a̠
기울	k i u ɭ
하수도	h a̠ː sʰ u d o̞
안도라	a̠ n d o̞ ɾ a̠
가시납지리	k a̠ ɕʰ i n a̠ p̚ t͡ɕ͈ i ɾ i
결혼	k j ʌ̹ ɾ β o̞ n
슈	ɕʰ u
린	ɾ i n
동등하다	t o̞ ŋ d ɯ ŋ ɦ a̠ d a̠
작다	t͡ɕ a̠ː k̚ t͈ a̠
자라다	t͡ɕ a̠ ɾ a̠ d a̠
퀴륨	kʰ ɥ i ɾ j u m
등유	t ɯ ŋ j u
맞이	m a̠ d͡ʑ i
나쁘다	n a̠ p͈ ɯ d a̠
사랑	sʰ a̠ ɾ a̠ ŋ
아티스트	a̠ tʰ i sʰ ɯ tʰ ɯ
오늬	o̞ n i
세요	sʰ e̞ j o
문어다리	m u n ʌ̹ d a̠ ɾ i
귀국하다	k ɥ iː ɡ u kʰ a̠ d a̠
카라카스	kʰ a̠ ɾ a̠ kʰ a̠ sʰ ɯ
용서하다	j o ŋ sʰ ʌ̹ ɦ a̠ d a̠
사단	sʰ a̠ d a̠ n
호두	ɸʷ o̞ d u
싫어하다	ɕʰ i ɾ ʌ̹ ɦ a̠ d a̠
들기름	t ɯ ɭ ɡ i ɾ ɯ m
지라프	t͡ɕ i ɾ a̠ pʰ ɯ
말없이	m a̠ː ɾ ʌ̹ p ɕ͈ i
동물	t o̞ː ŋ m u ɭ
조깅	t͡ɕ o̞ ɡ i ŋ
악수하다	a̠ k s͈ u ɦ a̠ d a̠
칼납자루	kʰ a̠ ɭ ɭ a̠ p̚ t͡ɕ͈ a̠ ɾ u
수판	sʰ uː pʰ a̠ n
공용어	k o̞ ŋ j o ŋ ʌ̹
설농탕	sʰ ʌ̹ ɭ ɭ o̞ ŋ tʰ a̠ ŋ
귀구멍	k ɥ i ɡ u m ʌ̹ ŋ
시험하다	ɕʰ i ɦ ʌ̹ m ɦ a̠ d a̠
고혈압	k o̞ ʝ j ʌ̹ ɾ a̠ p̚
암유	a̠ː m j u
홍콩	ɸʷ o̞ ŋ kʰ o̞ ŋ
성남	sʰ ʌ̹ ŋ n a̠ m
침낭	t͡ɕʰ iː m n a̠ ŋ
구판	k u pʰ a̠ n
종양	t͡ɕ o̞ː ŋ j a̠ ŋ
간단하다	k a̠ː n d a̠ n ɦ a̠ d a̠
범부	p ɘː m b u
논의하다	n o̞ n ɰ i ɦ a̠ d a̠
동사	t o̞ ŋ sʰ a̠
베른	p e̞ ɾ ɯ n
클리닝	k x ɯ ʎ ʎ i n i ŋ
탈취제	tʰ a̠ ʎ t͡ɕʰ ɥ i d͡ʑ e̞
고순쥐	k o̞ sʰ u ɲ d͡ʑ ɥ i
소꿉친구	sʰ o̞ k͈ u p̚ t͡ɕʰ i n ɡ u
숙이다	sʰ u ɡ i d a̠
원산	w ʌ̹ n sʰ a̠ n
바쿠	p a̠ kʰ u
팔	pʰ a̠ ɭ
소지품	sʰ o̞ː d͡ʑ i pʰ u m
쉬리	ʃʰ ɥ i ɾ i
추적하다	t͡ɕʰ u d͡ʑ ʌ̹ kʰ a̠ d a̠
심사숙고	ɕʰ i m sʰ a̠ sʰ u k̚ k͈ o̞
비겁	p iː ɡ ʌ̹ p̚
마찬가지	m a̠ t͡ɕʰ a̠ n ɡ a̠ d͡ʑ i
고향	k o̞ ʝ j a̠ ŋ
호떡	ɸʷ o̞ t͈ ʌ̹ k̚
회복	ɸ w e̞ b o̞ k̚
남자친구	n a̠ m d͡ʑ a̠ t͡ɕʰ i n ɡ u
대포	t ɛː pʰ o̞
속칭	sʰ o̞ k̚ t͡ɕʰ i ŋ
방수하다	p a̠ː ŋ sʰ u ɦ a̠ d a̠
법률학	p ʌ̹ m ɲ j u ɾ ɦ a̠ k̚
옴스크	o̞ m sʰ ɯ k x ɯ
장과	t͡ɕ a̠ ŋ ɡ w a̠
안심	a̠ n ɕʰ i m
수렴	sʰ u ɾ j ʌ̹ m
유가	j u ɡ a̠
음료수	ɯː m ɲ j o sʰ u
홍학	ɸʷ o̞ ŋ ɦ a̠ k̚
중년	t͡ɕ u ŋ ɲ j ʌ̹ n
운전자	uː ɲ d͡ʑ ʌ̹ ɲ d͡ʑ a̠
교가	k j o ɡ a̠
메이스	m e̞ i sʰ ɯ
목자	m o̞ k̚ t͡ɕ͈ a̠
너	n ʌ̹
사진기	sʰ a̠ d͡ʑ i n ɡ i
조그맣다	t͡ɕ o̞ ɡ ɯ m a̠ tʰ a̠
수달	sʰ u d a̠ ɭ
이룩하다	i ɾ u kʰ a̠ d a̠
터지다	tʰ ɘː d͡ʑ i d a̠
포함하다	pʰ o̞ ɦ a̠ m ɦ a̠ d a̠
웅데	u ŋ d e̞
통제	tʰ o̞ː ŋ d͡ʑ e̞
한숨짓다	h a̠ n sʰ u m d͡ʑ i t̚ t͈ a̠
별별	p j ʌ̹ ɭ b j ʌ̹ ɭ
작품집	t͡ɕ a̠ k̚ pʰ u m d͡ʑ i p̚
통	tʰ o̞ ŋ
세관	sʰ e̞ː ɡ w a̠ n
곱다	k o̞ː p̚ t͈ a̠
데모	t e̞ m o̞
외치다	w e̞ t͡ɕʰ i d a̠
답하다	t a̠ pʰ a̠ d a̠
천부적	t͡ɕʰ ʌ̹ n b u d͡ʑ ʌ̹ k̚
는데	n ɯ n d e̞
리야드	ɾ i j a̠ d ɯ
평화	pʰ j ʌ̹ ŋ β w a̠
레악토르	ɾ e̞ a̠ k̚ tʰ o̞ ɾ ɯ
터미널	tʰ ʌ̹ m i n ʌ̹ ɭ
기만	k i m a̠ n
갹출	k j a̠ k̚ t͡ɕʰ u ɭ
된장	t w e̞ː ɲ d͡ʑ a̠ ŋ
간신	k a̠ n ɕʰ i n
북극곰	p u k̚ k͈ ɯ k̚ k͈ o̞ m
우세	u sʰ e̞
해달	h ɛː d a̠ ɭ
고기	k o̞ ɡ i
갈다	k a̠ ɭ d a̠
체제	t͡ɕʰ e̞ d͡ʑ e̞
세트	sʰ e̞ tʰ ɯ
정가	t͡ɕ ɘː ŋ k͈ a̠
다르다	t a̠ ɾ ɯ d a̠
사자	sʰ a̠ː d͡ʑ a̠
요구되다	j o ɡ u d w e̞ d a̠
패	pʰ ɛː
사거리	sʰ a̠ː ɡ ʌ̹ ɾ i
공정	k o̞ ŋ d͡ʑ ʌ̹ ŋ
자판기	t͡ɕ a̠ pʰ a̠ n ɡ i
답사	t a̠ p s͈ a̠
지저귀다	t͡ɕ i d͡ʑ ʌ̹ ɡ ɥ i d a̠
북숲쥐	p u k s͈ u p̚ t͡ɕ͈ ɥ i
촌락	t͡ɕʰ o̞ː ɭ ɭ a̠ k̚
열차	j ʌ̹ ʎ t͡ɕʰ a̠
문화적	m u n β w a̠ d͡ʑ ʌ̹ k̚
서민	sʰ ʌ̹ m i n
제거하다	t͡ɕ e̞ ɡ ʌ̹ ɦ a̠ d a̠
가보	k a̠ b o̞
셀러리	sʰ e̞ ɭ ɭ ʌ̹ ɾ i
서양	sʰ ʌ̹ j a̠ ŋ
에스토니아어	e̞ sʰ ɯ tʰ o̞ n i a̠ ʌ̹
역학	j ʌ̹ kʰ a̠ k̚
집단	t͡ɕ i p̚ t͈ a̠ n
이동	i d o̞ ŋ
길냥이	k iː ʎ ʎ j a̠ ŋ i
진원지	t͡ɕ i n w ʌ̹ ɲ d͡ʑ i
해안	h ɛː a̠ n
트럼펫	tʰ ɯ ɾ ʌ̹ m pʰ e̞ t̚
정신분열증	t͡ɕ ʌ̹ ŋ ɕʰ i n p u ɲ j ʌ̹ ʎ d͡ʑ ɯ ŋ
북방중고기	p u k̚ p͈ a̠ ŋ d͡ʑ u ŋ ɡ o̞ ɡ i
유난히	j uː n a̠ n ʝ i
고체	k o̞ t͡ɕʰ e̞
최고	t͡ɕʰ w e̞ ɡ o̞
공기	k o̞ː ŋ ɡ i
어휘소	ʌ̹ ɦ ɥ i sʰ o̞
참가하다	t͡ɕʰ a̠ m ɡ a̠ ɦ a̠ d a̠
본	p o̞ n
고방오리	k o̞ b a̠ ŋ o̞ ɾ i
말솜씨	m a̠ː ɭ s͈ o̞ m ɕ͈ i
공동	k o̞ː ŋ d o̞ ŋ
교파	k j oː pʰ a̠
기억력	k i ʌ̹ ŋ ɲ j ʌ̹ k̚
숟가락	sʰ u t̚ k͈ a̠ ɾ a̠ k̚
족발	t͡ɕ o̞ k̚ p͈ a̠ ɭ
조선어	t͡ɕ o̞ sʰ ʌ̹ n ʌ̹
황도	ɸ w a̠ː ŋ d o̞
터뜨리다	tʰ ɘː t͈ ɯ ɾ i d a̠
버지니아	p ʌ̹ d͡ʑ i n i a̠
촌	t͡ɕʰ o̞ n
구체	k u t͡ɕʰ e̞
계좌	k j e̞ː d͡ʑ w a̠
제조업	t͡ɕ e̞ː d͡ʑ o̞ ʌ̹ p̚
나무늘보	n a̠ m u n ɯ ɭ b o̞
직접	t͡ɕ i k̚ t͡ɕ͈ ʌ̹ p̚
중국인	t͡ɕ u ŋ ɡ u ɡ i n
인공지능	i n ɡ o̞ ŋ d͡ʑ i n ɯ ŋ
국밥	k u k̚ p͈ a̠ p̚
노랗다	n o̞ː ɾ a̠ tʰ a̠
곰국	k o̞ː m k͈ u k̚
모리타니	m o̞ ɾ i tʰ a̠ n i
식료품	ɕʰ i ŋ ɲ j o pʰ u m
월요일	w ʌ̹ ɾ j o i ɭ
잊어버리다	i d͡ʑ ʌ̹ b ʌ̹ ɾ i d a̠
인니	i n n i
천지인	t͡ɕʰ ʌ̹ ɲ d͡ʑ i i n
가산	k a̠ sʰ a̠ n
성찬	sʰ ʌ̹ ŋ t͡ɕʰ a̠ n
우라늄	u ɾ a̠ ɲ j u m
창조하다	t͡ɕʰ a̠ː ŋ d͡ʑ o̞ ɦ a̠ d a̠
화장	ɸ w a̠ː d͡ʑ a̠ ŋ
폊	pʰ j ʌ̹ t̚
닮다	t a̠ː m t͈ a̠
처음	t͡ɕʰ ʌ̹ ɯ m
가시	k a̠ ɕʰ i
살찌다	sʰ a̠ ʎ t͡ɕ͈ i d a̠
신형코로나비루스감염증	ɕʰ i n ʝ j ʌ̹ ŋ kʰ o̞ ɾ o̞ n a̠ b i ɾ u sʰ ɯ ɡ a̠ m j ʌ̹ m d͡ʑ ɯ ŋ
계약하다	k j e̞ː j a̠ kʰ a̠ d a̠
소유자	sʰ o̞ː j u d͡ʑ a̠
노느다	n o̞ n ɯ d a̠
마스카라	m a̠ sʰ ɯ kʰ a̠ ɾ a̠
전기통신사	t͡ɕ ɘː n ɡ i tʰ o̞ ŋ ɕʰ i n sʰ a̠
아름답다	a̠ ɾ ɯ m d a̠ p̚ t͈ a̠
해치다	h ɛː t͡ɕʰ i d a̠
기육	k i j u k̚
연습하다	j ɘː n sʰ ɯ pʰ a̠ d a̠
씨	ɕ͈ i
검은금	k ʌ̹ m ɯ n ɡ ɯ m
작업	t͡ɕ a̠ ɡ ʌ̹ p̚
왁자그르르	w a̠ k̚ t͡ɕ͈ a̠ ɡ ɯ ɾ ɯ ɾ ɯ
몽강	m o̞ː ŋ ɡ a̠ ŋ
짧다	t͡ɕ͈ a̠ ɭ t͈ a̠
서체	sʰ ʌ̹ t͡ɕʰ e̞
지적	t͡ɕ i d͡ʑ ʌ̹ k̚
는	n ɯ n
중요하다	t͡ɕ uː ŋ j o ɦ a̠ d a̠
일천	i ʎ t͡ɕʰ ʌ̹ n
조선인	t͡ɕ o̞ sʰ ʌ̹ n i n
북아메리카	p u ɡ a̠ m e̞ ɾ i kʰ a̠
라인	ɾ a̠ i n
방접원	p a̠ ŋ d͡ʑ ʌ̹ b w ʌ̹ n
약품	j a̠ k̚ pʰ u m
농민	n o̞ ŋ m i n
행인	h ɛː ŋ i n
함성	h a̠ m sʰ ʌ̹ ŋ
이사회	iː sʰ a̠ β w e̞
누치	n u t͡ɕʰ i
따라오다	t͈ a̠ ɾ a̠ o̞ d a̠
곽밥	k w a̠ k̚ p͈ a̠ p̚
음소문자	ɯ m sʰ o̞ m u ɲ d͡ʑ a̠
문구점	m u n ɡ u d͡ʑ ʌ̹ m
박동	p a̠ː k̚ t͈ o̞ ŋ
과로사	k w a̠ ɾ o̞ sʰ a̠
호실	ɸʷ o̞ː ɕʰ i ɭ
지질학	t͡ɕ i d͡ʑ i ɾ ɦ a̠ k̚
비다	p i d a̠
반값	p a̠ n k͈ a̠ p̚
라자냐	ɾ a̠ d͡ʑ a̠ ɲ j a̠
아르메니아	a̠ ɾ ɯ m e̞ n i a̠
질서	t͡ɕ i ɭ s͈ ʌ̹
가르치다	k a̠ ɾ ɯ t͡ɕʰ i d a̠
스님	sʰ ɯ n i m
커닝	kʰ ʌ̹ n i ŋ
흐려지다	x ɯ ɾ j ʌ̹ d͡ʑ i d a̠
프로트악티늄	pʰ ɯ ɾ o̞ tʰ ɯ a̠ k̚ tʰ i ɲ j u m
다정하다	t a̠ d͡ʑ ʌ̹ ŋ ɦ a̠ d a̠
먼저	m ʌ̹ ɲ d͡ʑ ʌ̹
마한	m a̠ ɦ a̠ n
상자	sʰ a̠ ŋ d͡ʑ a̠
중국	t͡ɕ u ŋ ɡ u k̚
려관	ɾ j ʌ̹ ɡ w a̠ n
한가	h a̠ n ɡ a̠
소변	sʰ o̞ b j ʌ̹ n
내주다	n ɛː d͡ʑ u d a̠
고조선	k o̞ d͡ʑ o̞ sʰ ʌ̹ n
걷다	k ʌ̹ t̚ t͈ a̠
버터밀크	p ʌ̹ tʰ ʌ̹ m i ɭ k x ɯ
칼날	kʰ a̠ ɭ ɭ a̠ ɭ
도입	t o̞ː i p̚
게	k e̞ː
곰팡이	k o̞ m pʰ a̠ ŋ i
훈민정음	ɸʷ uː n m i ɲ d͡ʑ ʌ̹ ŋ ɯ m
표하다	pʰ j oː ɦ a̠ d a̠
머구리	m ʌ̹ ɡ u ɾ i
레늄	ɾ e̞ ɲ j u m
둘러싸다	t u ɭ ɭ ʌ̹ s͈ a̠ d a̠
헐다	h ɘː ɭ d a̠
출판하다	t͡ɕʰ u ɭ pʰ a̠ n ɦ a̠ d a̠
산	sʰ a̠ n
서부	sʰ ʌ̹ b u
개선하다	k ɛː sʰ ʌ̹ n ɦ a̠ d a̠
자연스럽다	t͡ɕ a̠ j ʌ̹ n sʰ ɯ ɾ ʌ̹ p̚ t͈ a̠
변절하다	p j ɘː ɲ d͡ʑ ʌ̹ ɾ ɦ a̠ d a̠
의무	ɰ iː m u
강남천자국	k a̠ ŋ n a̠ m t͡ɕʰ ʌ̹ ɲ d͡ʑ a̠ ɡ u k̚
복무하다	p o̞ ŋ m u ɦ a̠ d a̠
실뜨기	ɕʰ i ɭ t͈ ɯ ɡ i
참기름	t͡ɕʰ a̠ m ɡ i ɾ ɯ m
정량	t͡ɕ ɘː ŋ ɲ j a̠ ŋ
앞치마	a̠ p̚ t͡ɕʰ i m a̠
궤	k w e̞
메터	m e̞ tʰ ʌ̹
속음	sʰ o̞ ɡ ɯ m
답다	t a̠ p̚ t͈ a̠
강조하다	k a̠ ŋ d͡ʑ o̞ ɦ a̠ d a̠
큰흰죽지	k x ɯ n ʝ i ɲ d͡ʑ u k̚ t͡ɕ͈ i
취미	t͡ɕʰ ɥ iː m i
개지랄하다	k ɛː d͡ʑ i ɾ a̠ ɾ ɦ a̠ d a̠
두다	t u d a̠
큰귀박쥐	k x ɯ n ɡ ɥ i b a̠ k̚ t͡ɕ͈ ɥ i
정수	t͡ɕ ʌ̹ ŋ sʰ u
가계	k a̠ ɡ j e̞
흑설탕	x ɯː k s͈ ʌ̹ ɭ tʰ a̠ ŋ
찻주전자	t͡ɕʰ a̠ t̚ t͡ɕ͈ u d͡ʑ ʌ̹ ɲ d͡ʑ a̠
케이팝	kʰ e̞ i pʰ a̠ p̚
녀성	ɲ j ʌ̹ sʰ ʌ̹ ŋ
로조	ɾ o̞ d͡ʑ o̞
브로민	p ɯ ɾ o̞ m i n
웃프다	u t̚ pʰ ɯ d a̠
굽이	k u b i
장모님	t͡ɕ a̠ː ŋ m o̞ n i m
분말	p u n m a̠ ɭ
우단	uː d a̠ n
우주선	uː d͡ʑ u sʰ ʌ̹ n
분단	p u n d a̠ n
서고	sʰ ʌ̹ ɡ o̞
플립플롭	pʰ ɯ ʎ ʎ i p̚ pʰ ɯ ɭ ɭ o̞ p̚
자비	t͡ɕ a̠ b i
시보	ɕʰ i b o̞
반란	p a̠ː ɭ ɭ a̠ n
가시어머니	k a̠ ɕʰ i ʌ̹ m ʌ̹ n i
소나무	sʰ o̞ n a̠ m u
건전하다	k ʌ̹ ɲ d͡ʑ ʌ̹ n ɦ a̠ d a̠
촉지	t͡ɕʰ o̞ k̚ t͡ɕ͈ i
발음	p a̠ ɾ ɯ m
어른	ɘː ɾ ɯ n
저자	t͡ɕ ʌ̹ d͡ʑ a̠
짓궂다	t͡ɕ iː t̚ k͈ u t̚ t͈ a̠
기승위	k i sʰ ɯ ŋ ɥ i
내지	n ɛː d͡ʑ i
칼럼	kʰ a̠ ɭ ɭ ʌ̹ m
목도리	m o̞ k̚ t͈ o̞ ɾ i
교도	k j oː d o̞
죽이다	t͡ɕ u ɡ i d a̠
안구	a̠ː n ɡ u
중죄	t͡ɕ uː ŋ d͡ʑ w e̞
및	m i t̚
농담	n o̞ː ŋ d a̠ m
대전차포	t ɛː d͡ʑ ʌ̹ ɲ t͡ɕʰ a̠ pʰ o̞
닮음	t a̠ ɭ m ɯ m
사슴	sʰ a̠ sʰ ɯ m
쿠바	kʰ u b a̠
민스크	m i n sʰ ɯ k x ɯ
표고버섯	pʰ j o ɡ o̞ b ʌ̹ sʰ ʌ̹ t̚
지퍼	t͡ɕ i pʰ ʌ̹
모사	m o̞ sʰ a̠
회기	ɸ w e̞ː ɡ i
강아지	k a̠ ŋ a̠ d͡ʑ i
조선반도	t͡ɕ o̞ sʰ ʌ̹ n b a̠ n d o̞
구미호	k u m i β o̞
숙녀	sʰ u ŋ ɲ j ʌ̹
명칭	m j ʌ̹ ŋ t͡ɕʰ i ŋ
근절하다	k ɯ ɲ d͡ʑ ʌ̹ ɾ ɦ a̠ d a̠
여과	j ɘː ɡ w a̠
어그러지다	ʌ̹ ɡ ɯ ɾ ʌ̹ d͡ʑ i d a̠
잡신	t͡ɕ a̠ p ɕ͈ i n
종로	t͡ɕ o̞ ŋ n o̞
우편	u pʰ j ʌ̹ n
타협	tʰ a̠ː ʝ j ʌ̹ p̚
토하다	tʰ o̞ː ɦ a̠ d a̠
일심단결	i ɭ ɕ͈ i m d a̠ n ɡ j ʌ̹ ɭ
필터	pʰ i ɭ tʰ ʌ̹
타자하다	tʰ a̠ː d͡ʑ a̠ ɦ a̠ d a̠
브리지타운	p ɯ ɾ i d͡ʑ i tʰ a̠ u n
종	t͡ɕ o̞ː ŋ
관수리	k w a̠ n sʰ u ɾ i
퀴놀린	kʰ ɥ i n o̞ ʎ ʎ i n
블루길	p ɯ ɭ ɭ u ɡ i ɭ
줍다	t͡ɕ uː p̚ t͈ a̠
싸고돌다	s͈ a̠ ɡ o̞ d o̞ ɭ d a̠
필살기	pʰ i ɭ s͈ a̠ ɭ ɡ i
어렵사리	ʌ̹ ɾ j ʌ̹ p s͈ a̠ ɾ i
구로나	k u ɾ o̞ n a̠
간계	k a̠ n ɡ j e̞
허베이	h ʌ̹ b e̞ i
운전	u ɲ d͡ʑ ʌ̹ n
동남아시아	t o̞ ŋ n a̠ m a̠ ɕʰ i a̠
오버클럭	o̞ b ʌ̹ k x ɯ ɭ ɭ ʌ̹ k̚
곳	k o̞ t̚
밀리다	m i ʎ ʎ i d a̠
유월	j u w ʌ̹ ɭ
용돈	j oː ŋ d o̞ n
여드름	j ʌ̹ d ɯ ɾ ɯ m
그다음	k ɯ d a̠ ɯ m
구입	k u i p̚
네	n e̞
위도	ɥ iː d o̞
고집스럽다	k o̞ d͡ʑ i p s͈ ɯ ɾ ʌ̹ p̚ t͈ a̠
흕	x ɯ n
쇼케이스	ɕʰ o kʰ e̞ i sʰ ɯ
나무	n a̠ m u
비상	p i sʰ a̠ ŋ
존경	t͡ɕ o̞ n ɡ j ʌ̹ ŋ
신청	ɕʰ i ɲ t͡ɕʰ ʌ̹ ŋ
파	pʰ a̠ː
두부	t u b u
수습	sʰ u sʰ ɯ p̚
활성	ɸ w a̠ ɭ s͈ ʌ̹ ŋ
인화지	i n β w a̠ d͡ʑ i
사학	sʰ a̠ ɦ a̠ k̚
떠들썩하다	t͈ ʌ̹ d ɯ ɭ s͈ ʌ̹ kʰ a̠ d a̠
속쓰림	sʰ o̞ː k s͈ ɯ ɾ i m
예언자	j e̞ː ʌ̹ ɲ d͡ʑ a̠
미팅	m i tʰ i ŋ
불상	p uː ɭ sʰ a̠ ŋ
뱀	p ɛː m
환영	ɸ w a̠ ɲ j ʌ̹ ŋ
꾸준히	k͈ u d͡ʑ u n ʝ i
블라디보스토크	p ɯ ɭ ɭ a̠ d i b o̞ sʰ ɯ tʰ o̞ k x ɯ
묻다	m uː t̚ t͈ a̠
퀸	kʰ ɥ i n
돌	t o̞ː ɭ
재다	t͡ɕ ɛː d a̠
남부	n a̠ m b u
지	t͡ɕ i
남녀노소	n a̠ m ɲ j ʌ̹ n o̞ sʰ o̞
번역	p ʌ̹ ɲ j ʌ̹ k̚
포트오브스페인	pʰ o̞ tʰ ɯ o̞ b ɯ sʰ ɯ pʰ e̞ i n
발명	p a̠ ɭ m j ʌ̹ ŋ
아랍에미리트	a̠ ɾ a̠ b e̞ m i ɾ i tʰ ɯ
각시붕어	k a̠ k ɕ͈ i b u ŋ ʌ̹
곰	k o̞ː m
숨바꼭질	sʰ u m b a̠ k͈ o̞ k̚ t͡ɕ͈ i ɭ
기여	k i j ʌ̹
약하다	j a̠ kʰ a̠ d a̠
의견란	ɰ iː ɡ j ʌ̹ n n a̠ n
년도	ɲ j ʌ̹ n d o̞
허리케인	h ʌ̹ ɾ i kʰ e̞ i n
수시로	sʰ u ɕʰ i ɾ o̞
뇌물	n w e̞ m u ɭ
아랍어	a̠ ɾ a̠ b ʌ̹
보너스	p o̞ n ʌ̹ sʰ ɯ
공국	k o̞ː ŋ ɡ u k̚
원망하다	w ɘː n m a̠ ŋ ɦ a̠ d a̠
게타	k͈ e̞ tʰ a̠
ㅇㄱㄹㅇ	i ɡ ʌ̹ ɾ e̞ a̠ ɭ
눈알	n u n a̠ ɭ
관형사	k w a̠ n ʝ j ʌ̹ ŋ sʰ a̠
띠동갑	t͈ i d o̞ ŋ ɡ a̠ p̚
남조선	n a̠ m d͡ʑ o̞ sʰ ʌ̹ n
우민	u m i n
픻	pʰ i t̚
방명	p a̠ ŋ m j ʌ̹ ŋ
솔직	sʰ o̞ ʎ t͡ɕ͈ i k̚
땋다	t͈ a̠ː tʰ a̠
명왕성	m j ʌ̹ ŋ w a̠ ŋ sʰ ʌ̹ ŋ
이과	iː k͈ w a̠
통가	tʰ o̞ ŋ ɡ a̠
유곽	j u ɡ w a̠ k̚
PC방	pʰ i ɕ͈ i b a̠ ŋ
좋아지다	t͡ɕ o̞ː a̠ d͡ʑ i d a̠
요구하다	j o ɡ u ɦ a̠ d a̠
사자고추	sʰ a̠ d͡ʑ a̠ ɡ o̞ t͡ɕʰ u
에티오피아	e̞ tʰ i o̞ pʰ i a̠
주권	t͡ɕ u k͈ w ʌ̹ n
응원	ɯː ŋ w ʌ̹ n
불곰	p u ɭ ɡ o̞ m
참으로	t͡ɕʰ a̠ m ɯ ɾ o̞
시조조	ɕʰ iː d͡ʑ o̞ d͡ʑ o̞
사막화	sʰ a̠ː m a̠ kʰ w a̠
괴다	k w e̞ː d a̠
따오다	t͈ a̠ o̞ d a̠
끌어안다	k͈ ɯː ɾ ʌ̹ a̠ n t͈ a̠
무슬림	m u sʰ ɯ ʎ ʎ i m
의학	ɰ i ɦ a̠ k̚
쇠뼈	sʰ w e̞ p͈ j ʌ̹
설연타	sʰ ʌ̹ ɾ j ʌ̹ n tʰ a̠
대륙송사리	t ɛː ɾ j u k s͈ o̞ ŋ sʰ a̠ ɾ i
손발톱	sʰ o̞ n b a̠ ɭ tʰ o̞ p̚
변동	p j ɘː n d o̞ ŋ
자명종	t͡ɕ a̠ m j ʌ̹ ŋ d͡ʑ o̞ ŋ
소곡	sʰ o̞ ɡ o̞ k̚
차분몫	t͡ɕʰ a̠ b u n m o̞ k̚
마쟈르	m a̠ d͡ʑ a̠ ɾ ɯ
시다	ɕʰ i d a̠
올리고	o̞ ʎ ʎ i ɡ o̞
균계	k j u n ɡ j e̞
난시	n a̠ː n ɕʰ i
알곡	a̠ ɭ ɡ o̞ k̚
음가	ɯ m ɡ a̠
분권	p u n k͈ w ʌ̹ n
통역사	tʰ o̞ ŋ j ʌ̹ k s͈ a̠
브로커	p ɯ ɾ o̞ kʰ ʌ̹
데뷔	t e̞ b ɥ i
제노바	t͡ɕ e̞ n o̞ b a̠
마녀	m a̠ ɲ j ʌ̹
비각	p i ɡ a̠ k̚
꼬부랑국수	k͈ o̞ b u ɾ a̠ ŋ ɡ u k s͈ u
흡인력	x ɯ b i ʎ ʎ j ʌ̹ k̚
파문	pʰ a̠ː m u n
가지고	k a̠ d͡ʑ i ɡ o̞
직접화법	t͡ɕ i k̚ t͡ɕ͈ ʌ̹ pʰ w a̠ b ʌ̹ p̚
구경	k uː ɡ j ʌ̹ ŋ
뮈슬리	m ɥ i sʰ ɯ ʎ ʎ i
손상	sʰ o̞ n sʰ a̠ ŋ
스도쿠	sʰ ɯ d o̞ kʰ u
천문학	t͡ɕʰ ʌ̹ n m u n ɦ a̠ k̚
세모꼴	sʰ e̞ː m o̞ k͈ o̞ ɭ
유청	j u t͡ɕʰ ʌ̹ ŋ
명예	m j ʌ̹ ŋ j e̞
벌리다	p ɘː ʎ ʎ i d a̠
개장	k ɛː d͡ʑ a̠ ŋ
한	h a̠ː n
배교	p ɛː ɡ j o
제복	t͡ɕ e̞ː b o̞ k̚
소비	sʰ o̞ b i
대한제국	t ɛː ɦ a̠ ɲ d͡ʑ e̞ ɡ u k̚
청바지	t͡ɕʰ ʌ̹ ŋ b a̠ d͡ʑ i
증권사	t͡ɕ ɯ ŋ k͈ w ʌ̹ n sʰ a̠
덧니	t ʌ̹ n n i
누님	n u n i m
도다리	t o̞ d a̠ ɾ i
할	h a̠ ɭ
단풍나무	t a̠ n pʰ u ŋ n a̠ m u
우울하다	u u ɾ ɦ a̠ d a̠
니코시아	n i kʰ o̞ ɕʰ i a̠
장례	t͡ɕ a̠ː ŋ ɲ j e̞
총리	t͡ɕʰ o̞ː ŋ n i
레	ɾ e̞
노예	n o̞ j e̞
옥	o̞ k̚
수화	sʰ u β w a̠
아스타나	a̠ sʰ ɯ tʰ a̠ n a̠
마멋	m a̠ m ʌ̹ t̚
자동화	t͡ɕ a̠ d o̞ ŋ β w a̠
아바나	a̠ b a̠ n a̠
능하다	n ɯ ŋ ɦ a̠ d a̠
성군	sʰ ʌ̹ ŋ ɡ u n
검둥오리사촌	k ʌ̹ m d u ŋ o̞ ɾ i sʰ a̠ t͡ɕʰ o̞ n
서거	sʰ ɘː ɡ ʌ̹
우언	uː ʌ̹ n
일신론	i ɭ ɕ͈ i n n o̞ n
독물	t o̞ ŋ m u ɭ
뽈스카	p͈ o̞ ɭ sʰ ɯ kʰ a̠
아비장	a̠ b i d͡ʑ a̠ ŋ
하	h a̠ː
열넷	j ʌ̹ ɭ ɭ e̞ t̚
트리폴리	tʰ ɯ ɾ i pʰ o̞ ʎ ʎ i
중위	t͡ɕ u ŋ ɥ i
응징하다	ɯ ŋ d͡ʑ i ŋ ɦ a̠ d a̠
헤라	h e̞ ɾ a̠
보름	p o̞ ɾ ɯ m
비버	p i b ʌ̹
출석	t͡ɕʰ u ɭ s͈ ʌ̹ k̚
측위	t͡ɕʰ ɯ ɡ ɥ i
우습다	uː sʰ ɯ p̚ t͈ a̠
편집자	pʰ j ʌ̹ ɲ d͡ʑ i p̚ t͡ɕ͈ a̠
후식	ɸʷ uː ɕʰ i k̚
정권	t͡ɕ ʌ̹ ŋ k͈ w ʌ̹ n
그날	k ɯ n a̠ ɭ
다랗다	t a̠ ɾ a̠ tʰ a̠
꽃집	k͈ o̞ t̚ t͡ɕ͈ i p̚
제육	t͡ɕ e̞ j u k̚
수리남	sʰ u ɾ i n a̠ m
밭	p a̠ t̚
토	tʰ o̞
표현형	pʰ j o ʝ j ʌ̹ n ʝ j ʌ̹ ŋ
물어보다	m u ɾ ʌ̹ b o̞ d a̠
녹다	n o̞ k̚ t͈ a̠
다름없다	t a̠ ɾ ɯ m ʌ̹ p̚ t͈ a̠
오르가슴	o̞ ɾ ɯ ɡ a̠ sʰ ɯ m
곧바로	k o̞ t̚ p͈ a̠ ɾ o̞
복선	p o̞ k s͈ ʌ̹ n
검둥오리	k ʌ̹ m d u ŋ o̞ ɾ i
박다	p a̠ k̚ t͈ a̠
그레이비	k ɯ ɾ e̞ i b i
묘사	m j oː sʰ a̠
그저	k ɯ d͡ʑ ʌ̹
예언	j e̞ː ʌ̹ n
네덜란드어	n e̞ d ʌ̹ ɭ ɭ a̠ n d ɯ ʌ̹
돋보기	t o̞ t̚ p͈ o̞ ɡ i
솜땀	sʰ o̞ m t͈ a̠ m
침목	t͡ɕʰ i m m o̞ k̚
인종	i ɲ d͡ʑ o̞ ŋ
실시	ɕʰ i ɭ ɕ͈ i
성신	sʰ ɘː ŋ ɕʰ i n
높임말	n o̞ pʰ i m m a̠ ɭ
수납장	sʰ u n a̠ p̚ t͡ɕ͈ a̠ ŋ
가이드	k a̠ i d ɯ
휘	h ɥ iː
대신	t ɛː ɕʰ i n
소학교	sʰ o̞ ɦ a̠ k̚ k͈ j o
솜털	sʰ o̞ m tʰ ʌ̹ ɭ
중간	t͡ɕ u ŋ ɡ a̠ n
아비	a̠ b i
제트기	t͡ɕ e̞ tʰ ɯ ɡ i
야경	j a̠ː ɡ j ʌ̹ ŋ
안심하다	a̠ n ɕʰ i m ɦ a̠ d a̠
만두	m a̠ n d u
스풀	sʰ ɯ pʰ u ɭ
일체	i ʎ t͡ɕʰ e̞
깡치	k͈ a̠ ŋ t͡ɕʰ i
관박쥐	k w a̠ n b a̠ k̚ t͡ɕ͈ ɥ i
저주	t͡ɕ ɘː d͡ʑ u
시원하다	ɕʰ i w ʌ̹ n ɦ a̠ d a̠
금자탑	k ɯ m d͡ʑ a̠ tʰ a̠ p̚
슬라브	sʰ ɯ ɭ ɭ a̠ b ɯ
이간질	iː ɡ a̠ ɲ d͡ʑ i ɭ
두세	t u sʰ e̞
겨리	k j ʌ̹ ɾ i
발뒤꿈치	p a̠ ɭ t͈ ɥ i k͈ u m t͡ɕʰ i
부럼	p u ɾ ʌ̹ m
노크	n o̞ k x ɯ
죄	t͡ɕ w e̞ː
옆	j ʌ̹ p̚
돌아가시다	t o̞ ɾ a̠ ɡ a̠ ɕʰ i d a̠
빙상관	p i ŋ sʰ a̠ ŋ ɡ w a̠ n
토네이도	tʰ o̞ n e̞ i d o̞
설교자	sʰ ʌ̹ ɭ ɡ j o d͡ʑ a̠
안면승마	a̠ n m j ʌ̹ n sʰ ɯ ŋ m a̠
방사능	p a̠ː ŋ sʰ a̠ n ɯ ŋ
소수	sʰ o̞ s͈ u
이슬람교도	i sʰ ɯ ɭ ɭ a̠ m ɡ j o d o̞
피페리딘	pʰ i pʰ e̞ ɾ i d i n
복호	p o̞ kʰ o̞
포트루이스	pʰ o̞ tʰ ɯ ɾ u i sʰ ɯ
알아차리다	a̠ ɾ a̠ t͡ɕʰ a̠ ɾ i d a̠
매주	m ɛː d͡ʑ u
눈싸움	n u n s͈ a̠ u m
국제어	k uː k̚ t͡ɕ͈ e̞ ʌ̹
도로	t o̞ː ɾ o̞
파이팅	pʰ a̠ i tʰ i ŋ
야금야금	j a̠ ɡ ɯ m j a̠ ɡ ɯ m
석	sʰ ʌ̹ k̚
차트	t͡ɕʰ a̠ tʰ ɯ
돌보다	t o̞ː ɭ b o̞ d a̠
긋다	k ɯː t̚ t͈ a̠
카르빌아민	kʰ a̠ ɾ ɯ b i ɾ a̠ m i n
예외	j e̞ː w e̞
추출	t͡ɕʰ u t͡ɕʰ u ɭ
열람실	j ʌ̹ ɭ ɭ a̠ m ɕʰ i ɭ
해변	h ɛː b j ʌ̹ n
버튼	p ʌ̹ tʰ ɯ n
ㅖ	j e̞
물리학	m u ʎ ʎ i ɦ a̠ k̚
사탕	sʰ a̠ tʰ a̠ ŋ
예수회	j e̞ sʰ u β w e̞
북한	p u kʰ a̠ n
보통화	p o̞ tʰ o̞ ŋ β w a̠
북돋우다	p u k̚ t͈ o̞ d u d a̠
군중가요	k u ɲ d͡ʑ u ŋ ɡ a̠ j o
먹이그물	m ʌ̹ ɡ i ɡ ɯ m u ɭ
어근	ɘː ɡ ɯ n
염병	j ɘː m b j ʌ̹ ŋ
헤모글로빈	h e̞ m o̞ ɡ ɯ ɭ ɭ o̞ b i n
원본	w ʌ̹ n b o̞ n
가능	k a̠ː n ɯ ŋ
맞추다	m a̠ t̚ t͡ɕʰ u d a̠
양력	j a̠ ŋ ɲ j ʌ̹ k̚
흑흑	x ɯ k x ɯ k̚
다음	t a̠ ɯ m
이발	iː b a̠ ɭ
린스	ɾ i n sʰ ɯ
접근	t͡ɕ ʌ̹ p̚ k͈ ɯ n
일어	i ɾ ʌ̹
숲	sʰ u p̚
스웨터	sʰ ɯ w e̞ tʰ ʌ̹
교차위	k j o t͡ɕʰ a̠ ɥ i
피리딘	pʰ i ɾ i d i n
프롤레타리아	pʰ ɯ ɾ o̞ ɭ ɭ e̞ tʰ a̠ ɾ i a̠
말다	m a̠ ɭ d a̠
여체	j ʌ̹ t͡ɕʰ e̞
미분법	m i b u n b ʌ̹ p̚
화가	ɸ w a̠ː ɡ a̠
구	k u
스리랑카	sʰ ɯ ɾ i ɾ a̠ ŋ kʰ a̠
불구하다	p u ɭ ɡ u ɦ a̠ d a̠
닉	n i k̚
주중	t͡ɕ u d͡ʑ u ŋ
뵙다	p w e̞ p̚ t͈ a̠
뭍	m u t̚
받침	p a̠ t̚ t͡ɕʰ i m
비취	p iː t͡ɕʰ ɥ i
자벌레	t͡ɕ a̠ b ʌ̹ ɭ ɭ e̞
수력	sʰ u ɾ j ʌ̹ k̚
기각	k i ɡ a̠ k̚
간호원	k a̠ n β o̞ w ʌ̹ n
스노보드	sʰ ɯ n o̞ b o̞ d ɯ
귀뚜라미	k ɥ i t͈ u ɾ a̠ m i
지하도	t͡ɕ i ɦ a̠ d o̞
픽업	pʰ i ɡ ʌ̹ p̚
꾹저구	k͈ u k̚ t͡ɕ͈ ʌ̹ ɡ u
연예인	j ɘː ɲ j e̞ i n
치욕	t͡ɕʰ i j o k̚
정육점	t͡ɕ ʌ̹ ŋ j u k̚ t͡ɕ͈ ʌ̹ m
대한민국	t ɛː ɦ a̠ n m i n ɡ u k̚
티브이	tʰ i b ɯ i
당연하다	t a̠ ŋ j ʌ̹ n ɦ a̠ d a̠
잇몸	i n m o̞ m
구레나룻	k u ɾ e̞ n a̠ ɾ u t̚
과학	k w a̠ ɦ a̠ k̚
모방	m o̞ b a̠ ŋ
유튜브	j u tʰ j u b ɯ
깃	k i t̚
불편하다	p u ɭ pʰ j ʌ̹ n ɦ a̠ d a̠
노력하다	n o̞ ɾ j ʌ̹ kʰ a̠ d a̠
농어	n o̞ ŋ ʌ̹
충심	t͡ɕʰ u ŋ ɕʰ i m
우웩	u w e̞ k̚
진출하다	t͡ɕ iː ɲ t͡ɕʰ u ɾ ɦ a̠ d a̠
삿갓	sʰ a̠ t̚ k͈ a̠ t̚
셀카	sʰ e̞ ɭ kʰ a̠
종족	t͡ɕ o̞ ŋ d͡ʑ o̞ k̚
부신	p uː ɕʰ i n
사투르누스	sʰ a̠ tʰ u ɾ ɯ n u sʰ ɯ
리눅스	ɾ i n u k s͈ ɯ
성적	sʰ ʌ̹ ŋ d͡ʑ ʌ̹ k̚
두드리다	t u d ɯ ɾ i d a̠
오케스트라	o̞ kʰ e̞ sʰ ɯ tʰ ɯ ɾ a̠
감탄사	k a̠ m tʰ a̠ n sʰ a̠
가슴	k a̠ sʰ ɯ m
록	ɾ o̞ k̚
삼다	sʰ a̠ː m t͈ a̠
벌떡	p ʌ̹ ɭ t͈ ʌ̹ k̚
빈	p i n
양자	j a̠ ŋ d͡ʑ a̠
기본	k i b o̞ n
깜둥이	k͈ a̠ m d u ŋ i
사양하다	sʰ a̠ j a̠ ŋ ɦ a̠ d a̠
들여다보다	t ɯ ɾ j ʌ̹ d a̠ b o̞ d a̠
설마	sʰ ʌ̹ ɭ m a̠
몰디브	m o̞ ɭ d i b ɯ
경시	k j ʌ̹ ŋ ɕʰ i
마시나	m a̠ ɕʰ i n a̠
담황	t a̠ː m β w a̠ ŋ
출산율	t͡ɕʰ u ɭ sʰ a̠ ɲ j u ɭ
천지	t͡ɕʰ ʌ̹ ɲ d͡ʑ i
부유	p u j u
다리미	t a̠ ɾ i m i
인감	i n ɡ a̠ m
코코넛	kʰ o̞ kʰ o̞ n ʌ̹ t̚
전국	t͡ɕ ʌ̹ n ɡ u k̚
가축	k a̠ t͡ɕʰ u k̚
타밀어	tʰ a̠ m i ɾ ʌ̹
쫓기다	t͡ɕ͈ o̞ t̚ k͈ i d a̠
산장	sʰ a̠ ɲ d͡ʑ a̠ ŋ
민주주의자	m i ɲ d͡ʑ u d͡ʑ u ɰ i d͡ʑ a̠
맹꽁이	m ɛː ŋ k͈ o̞ ŋ i
흥미롭다	x ɯː ŋ m i ɾ o̞ p̚ t͈ a̠
부농	p uː n o̞ ŋ
땜납	t͈ ɛː m n a̠ p̚
정상	t͡ɕ ɘː ŋ sʰ a̠ ŋ
이날	i n a̠ ɭ
벌주다	p ʌ̹ ʎ d͡ʑ u d a̠
공허하다	k o̞ ŋ ɦ ʌ̹ ɦ a̠ d a̠
일본인	i ɭ b o̞ n i n
뭐	m w ɘː
트로트	tʰ ɯ ɾ o̞ tʰ ɯ
간선도로	k a̠ n sʰ ʌ̹ n d o̞ ɾ o̞
지구	t͡ɕ i ɡ u
하남	h a̠ n a̠ m
부럽다	p u ɾ ʌ̹ p̚ t͈ a̠
파렴치	pʰ a̠ː ɾ j ʌ̹ m t͡ɕʰ i
쇠오리	sʰ w e̞ o̞ ɾ i
대신하다	t ɛː ɕʰ i n ɦ a̠ d a̠
조끼	t͡ɕ o̞ k͈ i
풀밭	pʰ u ɭ b a̠ t̚
참주	t͡ɕʰ a̠ː m d͡ʑ u
롭다	ɾ o̞ p̚ t͈ a̠
흪	x ɯ p̚
세다	sʰ e̞ː d a̠
시도하다	ɕʰ iː d o̞ ɦ a̠ d a̠
승리	sʰ ɯ ŋ n i
연출	j ɘː ɲ t͡ɕʰ u ɭ
연금	j ʌ̹ n ɡ ɯ m
끊임없이	k͈ ɯ n i m ʌ̹ p ɕ͈ i
모리셔스	m o̞ ɾ i ɕʰ ʌ̹ sʰ ɯ
운동장	uː n d o̞ ŋ d͡ʑ a̠ ŋ
토치	tʰ o̞ t͡ɕʰ i
천안문	t͡ɕʰ ʌ̹ n a̠ n m u n
참석하다	t͡ɕʰ a̠ m sʰ ʌ̹ kʰ a̠ d a̠
절강	t͡ɕ ʌ̹ ɭ ɡ a̠ ŋ
조류	t͡ɕ o̞ ɾ j u
검정망둑	k ʌ̹ m d͡ʑ ʌ̹ ŋ m a̠ ŋ d u k̚
구더기	k u d ʌ̹ ɡ i
유통	j u tʰ o̞ ŋ
루테늄	ɾ u tʰ e̞ ɲ j u m
갈아타다	k a̠ ɾ a̠ tʰ a̠ d a̠
일여덟	i ɾ j ʌ̹ d ʌ̹ ɭ
ㅌ.ㄷ	tʰ ɯ d ɯ
피넨	pʰ i n e̞ n
뼈	p͈ j ʌ̹
성욕	sʰ ɘː ŋ j o k̚
파전	pʰ a̠ d͡ʑ ʌ̹ n
여전하다	j ʌ̹ d͡ʑ ʌ̹ n ɦ a̠ d a̠
로씨야말	ɾ o̞ ɕ͈ i j a̠ m a̠ ɭ
연회	j ɘː n β w e̞
각기	k a̠ k̚ k͈ i
진지하다	t͡ɕ i ɲ d͡ʑ i ɦ a̠ d a̠
누이	n u i
신명기	ɕʰ i n m j ʌ̹ ŋ ɡ i
아세나프텐	a̠ sʰ e̞ n a̠ pʰ ɯ tʰ e̞ n
포탈	pʰ o̞ tʰ a̠ ɭ
관리인	k w a̠ ʎ ʎ i i n
작은땃쥐	t͡ɕ a̠ ɡ ɯ n t͈ a̠ t̚ t͡ɕ͈ ɥ i
아줌마	a̠ d͡ʑ u m m a̠
쌓다	s͈ a̠ tʰ a̠
난추니	n a̠ː ɲ t͡ɕʰ u n i
기르다	k i ɾ ɯ d a̠
양다리	j a̠ ŋ d a̠ ɾ i
계렬	k j e̞ ɾ j ʌ̹ ɭ
도미니카	t o̞ m i n i kʰ a̠
와이파이	w a̠ i pʰ a̠ i
거스름돈	k ʌ̹ sʰ ɯ ɾ ɯ m t͈ o̞ n
디제이	t i d͡ʑ e̞ i
치약	t͡ɕʰ i j a̠ k̚
상의하다	sʰ a̠ ŋ ɰ i ɦ a̠ d a̠
잔	t͡ɕ a̠ n
예멘	j e̞ m e̞ n
디스크	t i sʰ ɯ k x ɯ
강준치	k a̠ ŋ d͡ʑ u ɲ t͡ɕʰ i
논다니	n o̞ː n d a̠ n i
아야톨라	a̠ j a̠ tʰ o̞ ɭ ɭ a̠
탄화	tʰ a̠ː n β w a̠
전시회	t͡ɕ ɘː n ɕʰ i β w e̞
개선	k ɛː sʰ ʌ̹ n
흠잡다	x ɯː m d͡ʑ a̠ p̚ t͈ a̠
광물학	k w a̠ ŋ m u ɾ ɦ a̠ k̚
개나리	k ɛː n a̠ ɾ i
줘	t͡ɕ w ʌ̹
암호	a̠ː m β o̞
타입	tʰ a̠ i p̚
부시	p u ɕʰ i
시작하다	ɕʰ iː d͡ʑ a̠ kʰ a̠ d a̠
울다	uː ɭ d a̠
피처폰	pʰ i t͡ɕʰ ʌ̹ pʰ o̞ n
문지르다	m u ɲ d͡ʑ i ɾ ɯ d a̠
제시하다	t͡ɕ e̞ ɕʰ i ɦ a̠ d a̠
요약하다	j o j a̠ kʰ a̠ d a̠
남녘	n a̠ m ɲ j ʌ̹ k̚
공모	k o̞ː ŋ m o̞
개천	k ɛː t͡ɕʰ ʌ̹ n
호르몬	ɸʷ o̞ ɾ ɯ m o̞ n
마드리드	m a̠ d ɯ ɾ i d ɯ
추기경	t͡ɕʰ u ɡ i ɡ j ʌ̹ ŋ
어눌	ɘː n u ɭ
흠	x ɯ m
아줄렌	a̠ d͡ʑ u ɭ ɭ e̞ n
크산텐	k x ɯ sʰ a̠ n tʰ e̞ n
명부	m j ʌ̹ ŋ b u
체질	t͡ɕʰ e̞ d͡ʑ i ɭ
턱	tʰ ʌ̹ k̚
혹가이도	ɸʷ o̞ k̚ k͈ a̠ i d o̞
어머	ʌ̹ m ʌ̹
잠자리	t͡ɕ a̠ m d͡ʑ a̠ ɾ i
테오도시우스	tʰ e̞ o̞ d o̞ ɕʰ i u sʰ ɯ
두덩	t u d ʌ̹ ŋ
우연히	u j ʌ̹ n ʝ i
주의	t͡ɕ uː ɰ i
루안다	ɾ u a̠ n d a̠
투탕카멘	tʰ u tʰ a̠ ŋ kʰ a̠ m e̞ n
중화	t͡ɕ u ŋ β w a̠
친하다	t͡ɕʰ i n ɦ a̠ d a̠
융자	j u ŋ d͡ʑ a̠
귀엣말하다	k ɥ i e̞ n m a̠ ɾ ɦ a̠ d a̠
임신	iː m ɕʰ i n
속견	sʰ o̞ k̚ k͈ j ʌ̹ n
노동자	n o̞ d o̞ ŋ d͡ʑ a̠
가차	k a̠ t͡ɕʰ a̠
짙다	t͡ɕ i t̚ t͈ a̠
논문	n o̞ n m u n
물소	m u ɭ s͈ o̞
토지	tʰ o̞ d͡ʑ i
꼬집다	k͈ o̞ d͡ʑ i p̚ t͈ a̠
빼다	p͈ ɛː d a̠
사흘	sʰ a̠ ɣ ɯ ɭ
라듐	ɾ a̠ d j u m
적분	t͡ɕ ʌ̹ k̚ p͈ u n
검은목논병아리	k ʌ̹ m ɯ n m o̞ ŋ n o̞ n b j ʌ̹ ŋ a̠ ɾ i
평범	pʰ j ʌ̹ ŋ b ʌ̹ m
이모	i m o̞
입자	i p̚ t͡ɕ͈ a̠
지각	t͡ɕ i ɡ a̠ k̚
베란다	p e̞ ɾ a̠ n d a̠
핏	pʰ i t̚
련합	ɾ j ʌ̹ n ɦ a̠ p̚
교통사고	k j o tʰ o̞ ŋ sʰ a̠ ɡ o̞
씨발	ɕ͈ i b a̠ ɭ
철갑상어	t͡ɕʰ ʌ̹ ɭ ɡ a̠ p s͈ a̠ ŋ ʌ̹
과거시제	k w a̠ː ɡ ʌ̹ ɕʰ i d͡ʑ e̞
계산원	k j e̞ː sʰ a̠ n w ʌ̹ n
철도	t͡ɕʰ ʌ̹ ɭ t͈ o̞
시신경	ɕʰ iː ɕʰ i n ɡ j ʌ̹ ŋ
도안	t o̞ a̠ n
전문일꾼	t͡ɕ ʌ̹ n m u n i ɭ k͈ u n
단체	t a̠ ɲ t͡ɕʰ e̞
싸움	s͈ a̠ u m
마피아	m a̠ pʰ i a̠
다루다	t a̠ ɾ u d a̠
왈	w a̠ ɭ
기녀	k iː ɲ j ʌ̹
농담	n o̞ ŋ d a̠ m
밍크	m i ŋ k x ɯ
잇따르다	iː t̚ t͈ a̠ ɾ ɯ d a̠
한학	h a̠ː n ɦ a̠ k̚
미싸일	m i s͈ a̠ i ɭ
치통	t͡ɕʰ i tʰ o̞ ŋ
자의	t͡ɕ a̠ ɰ i
미치다	m i t͡ɕʰ i d a̠
동티모르	t o̞ ŋ tʰ i m o̞ ɾ ɯ
뇌우	n w e̞ u
관음	k w a̠ n ɯ m
잠언	t͡ɕ a̠ m ʌ̹ n
방금	p a̠ ŋ ɡ ɯ m
안	a̠ n
ㅑ	j a̠
리본	ɾ i b o̞ n
화합물	ɸ w a̠ː ɦ a̠ m m u ɭ
초점	t͡ɕʰ o̞ t͡ɕ͈ ʌ̹ m
탄탈럼	tʰ a̠ n tʰ a̠ ɭ ɭ ʌ̹ m
일반인	i ɭ b a̠ n i n
간호사	k a̠ n β o̞ sʰ a̠
제한	t͡ɕ e̞ː ɦ a̠ n
오룔	o̞ ɾ j o ɭ
갈쓰뚝	k a̠ ɭ s͈ ɯ t͈ u k̚
이십	iː ɕʰ i p̚
드물다	t ɯ m u ɭ d a̠
목	m o̞ k̚
께서	k͈ e̞ sʰ ʌ̹
유서	j u sʰ ʌ̹
겁먹다	k ʌ̹ m m ʌ̹ k̚ t͈ a̠
분필	p u n pʰ i ɭ
가드	k a̠ d ɯ
위하다	ɥ i ɦ a̠ d a̠
써우지	s͈ ʌ̹ u d͡ʑ i
농촌	n o̞ ŋ t͡ɕʰ o̞ n
타이어	tʰ a̠ i ʌ̹
뮌헨	m ɥ i n ɦ e̞ n
렉	ɾ e̞ k̚
도가니	t o̞ ɡ a̠ n i
역원	j ʌ̹ ɡ w ʌ̹ n
감동사	k a̠ː m d o̞ ŋ sʰ a̠
묘사하다	m j oː sʰ a̠ ɦ a̠ d a̠
이울다	i u ɭ d a̠
마중하다	m a̠ d͡ʑ u ŋ ɦ a̠ d a̠
십자	ɕʰ i p̚ t͡ɕ͈ a̠
주무시다	t͡ɕ u m u ɕʰ i d a̠
염기	j ʌ̹ m ɡ i
상념	sʰ a̠ː ŋ ɲ j ʌ̹ m
똑	t͈ o̞ k̚
제목	t͡ɕ e̞ m o̞ k̚
여울마자	j ʌ̹ u ɭ m a̠ d͡ʑ a̠
개	k ɛː
카피바라	kʰ a̠ pʰ i b a̠ ɾ a̠
모로코	m o̞ ɾ o̞ kʰ o̞
녹음	n o̞ ɡ ɯ m
갓	k a̠ː t̚
하여간	h a̠ j ʌ̹ ɡ a̠ n
치다	t͡ɕʰ i d a̠
빙결	p i ŋ ɡ j ʌ̹ ɭ
테크네튬	tʰ e̞ k x ɯ n e̞ tʰ j u m
파슈토어	pʰ a̠ ɕʰ u tʰ o̞ ʌ̹
모용	m o̞ j o ŋ
양모	j a̠ ŋ m o̞
질소	t͡ɕ i ɭ sʰ o̞
투표하다	tʰ u pʰ j o ɦ a̠ d a̠
빠지다	p͈ a̠ː d͡ʑ i d a̠
일원	i ɾ w ʌ̹ n
사리원	sʰ a̠ ɾ i w ʌ̹ n
모란봉	m o̞ ɾ a̠ n b o̞ ŋ
몰리브데넘	m o̞ ʎ ʎ i b ɯ d e̞ n ʌ̹ m
삼엽기	sʰ a̠ m j ʌ̹ p̚ k͈ i
육수	j u k s͈ u
검은머리흰따오기	k ʌ̹ m ɯ n m ʌ̹ ɾ i ʝ i n t͈ a̠ o̞ ɡ i
ᆫ지	ɲ d͡ʑ i
건너오다	k ɘː n n ʌ̹ o̞ d a̠
카이만	kʰ a̠ i m a̠ n
프로필렌	pʰ ɯ ɾ o̞ pʰ i ɭ ɭ e̞ n
양동이	j a̠ ŋ d o̞ ŋ i
총알열차	t͡ɕʰ o̞ ŋ a̠ ɾ j ʌ̹ ʎ t͡ɕʰ a̠
기본적	k i b o̞ ɲ d͡ʑ ʌ̹ k̚
붉은기	p u ɭ ɡ ɯ n ɡ i
발견	p a̠ ɭ ɡ j ʌ̹ n
탈주자	tʰ a̠ ʎ t͡ɕ͈ u d͡ʑ a̠
멧토끼	m e̞ t̚ tʰ o̞ k͈ i
신청자	ɕʰ i ɲ t͡ɕʰ ʌ̹ ŋ d͡ʑ a̠
명함	m j ʌ̹ ŋ ɦ a̠ m
편안하다	pʰ j ʌ̹ n a̠ n ɦ a̠ d a̠
딸기	t͈ a̠ː ɭ ɡ i
아메리카홍머리오리	a̠ m e̞ ɾ i kʰ a̠ β o̞ ŋ m ʌ̹ ɾ i o̞ ɾ i
주거	t͡ɕ uː ɡ ʌ̹
암석	a̠ m sʰ ʌ̹ k̚
성씨	sʰ ɘː ŋ ɕ͈ i
시민	ɕʰ iː m i n
격언	k j ʌ̹ ɡ ʌ̹ n
성전환	sʰ ɘː ŋ d͡ʑ ʌ̹ n β w a̠ n
비닐	p i n i ɭ
날망둑	n a̠ ɭ m a̠ ŋ d u k̚
세워지다	sʰ e̞ w ʌ̹ d͡ʑ i d a̠
알데하이드	a̠ ɭ d e̞ ɦ a̠ i d ɯ
영웅	j ʌ̹ ŋ u ŋ
라벨	ɾ a̠ b e̞ ɭ
바게트	p͈ a̠ ɡ e̞ tʰ ɯ
가솔린	k a̠ sʰ o̞ ʎ ʎ i n
실정	ɕʰ i ʎ t͡ɕ͈ ʌ̹ ŋ
카페	k͈ a̠ pʰ e̞
에스토니아	e̞ sʰ ɯ tʰ o̞ n i a̠
공부하다	k o̞ ŋ b u ɦ a̠ d a̠
술탄	sʰ u ɭ tʰ a̠ n
다거다	t a̠ ɡ ʌ̹ d a̠
말씀하다	m a̠ː ɭ s͈ ɯ m ɦ a̠ d a̠
푸나푸티	pʰ u n a̠ pʰ u tʰ i
알아보다	a̠ ɾ a̠ b o̞ d a̠
륙	ɾ j u k̚
바로	p a̠ ɾ o̞
구이저우	k u i d͡ʑ ʌ̹ u
리튬	ɾ i tʰ j u m
슬로베니아어	sʰ ɯ ɭ ɭ o̞ b e̞ n i a̠ ʌ̹
궁륭	k u ŋ ɲ j u ŋ
방영	p a̠ː ŋ j ʌ̹ ŋ
필수	pʰ i ɭ sʰ u
클럽	k x ɯ ɭ ɭ ʌ̹ p̚
브리지	p ɯ ɾ i d͡ʑ i
전관예우	t͡ɕ ʌ̹ n ɡ w a̠ n ɲ j e̞ u
부르죠아	p u ɾ ɯ d͡ʑ o a̠
흑기사	x ɯ k̚ k͈ i sʰ a̠
잘잘못	t͡ɕ a̠ ʎ d͡ʑ a̠ ɭ m o̞ t̚
고관	k o̞ ɡ w a̠ n
오하이오	o̞ ɦ a̠ i o̞
펌프	pʰ ʌ̹ m pʰ ɯ
복섬	p o̞ k s͈ ʌ̹ m
수상	sʰ u sʰ a̠ ŋ
맞흥정	m a̠ tʰ ɯ ŋ d͡ʑ ʌ̹ ŋ
사용되다	sʰ a̠ː j o ŋ d w e̞ d a̠
모세	m o̞ sʰ e̞
예약하다	j e̞ː j a̠ kʰ a̠ d a̠
짐작	t͡ɕ i m d͡ʑ a̠ k̚
신성하다	ɕʰ i n sʰ ʌ̹ ŋ ɦ a̠ d a̠
위반	ɥ i b a̠ n
예카테린부르크	j e̞ kʰ a̠ tʰ e̞ ɾ i n b u ɾ ɯ k x ɯ
개량	k ɛː ɾ j a̠ ŋ
굳다	k u t̚ t͈ a̠
이혼하다	iː β o̞ n ɦ a̠ d a̠
돌리다	t o̞ ʎ ʎ i d a̠
숭어	sʰ uː ŋ ʌ̹
양반	j a̠ ŋ b a̠ n
여닫다	j ɘː d a̠ t̚ t͈ a̠
캄보디아	kʰ a̠ m b o̞ d i a̠
신주	ɕʰ i ɲ d͡ʑ u
시간	ɕʰ i ɡ a̠ n
화학전달물질	ɸ w a̠ ɦ a̠ k̚ t͡ɕ͈ ʌ̹ n d a̠ ɭ m u ʎ t͡ɕ͈ i ɭ
들어가다	t ɯ ɾ ʌ̹ ɡ a̠ d a̠
음독	ɯ m d o̞ k̚
순간	sʰ u n ɡ a̠ n
피아니스트	pʰ i a̠ n i sʰ ɯ tʰ ɯ
고리	k o̞ ɾ i
구호금	k uː β o̞ ɡ ɯ m
퇴비	tʰ w e̞ b i
달	t a̠ ɭ
좆	t͡ɕ o̞ t̚
정직하다	t͡ɕ ɘː ŋ d͡ʑ i kʰ a̠ d a̠
광원	k w a̠ ŋ w ʌ̹ n
구두쇠	k u d u sʰ w e̞
종료	t͡ɕ o̞ ŋ ɲ j o
포도당	pʰ o̞ d o̞ d a̠ ŋ
눋다	n uː t̚ t͈ a̠
자네들	t͡ɕ a̠ n e̞ d ɯ ɭ
반도	p a̠ n d o̞
마음	m a̠ ɯ m
약실	j a̠ k ɕ͈ i ɭ
한테	h a̠ n tʰ e̞
시방	ɕʰ i b a̠ ŋ
두줄망둑	t uː d͡ʑ u ɭ m a̠ ŋ d u k̚
뿐	p͈ u n
판결	pʰ a̠ n ɡ j ʌ̹ ɭ
젤	t͡ɕ e̞ ɭ
낭인	n a̠ː ŋ i n
짓다	t͡ɕ iː t̚ t͈ a̠
신나다	ɕʰ i n n a̠ d a̠
아르바이트	a̠ ɾ ɯ b a̠ i tʰ ɯ
은연어	ɯ n ɲ j ʌ̹ n ʌ̹
감비아	k a̠ m b i a̠
하이드라진	h a̠ i d ɯ ɾ a̠ d͡ʑ i n
청머리오리	t͡ɕʰ ʌ̹ ŋ m ʌ̹ ɾ i o̞ ɾ i
세금	sʰ e̞ː ɡ ɯ m
애벌레	ɛː b ʌ̹ ɭ ɭ e̞
시장하시다	ɕʰ i d͡ʑ a̠ ŋ ɦ a̠ ɕʰ i d a̠
서른	sʰ ʌ̹ ɾ ɯ n
카란	kʰ a̠ ɾ a̠ n
콘센트	kʰ o̞ n sʰ e̞ n tʰ ɯ
녹음실	n o̞ ɡ ɯ m ɕʰ i ɭ
서예	sʰ ʌ̹ j e̞
경기	k j ɘː ŋ ɡ i
사창	sʰ a̠ t͡ɕʰ a̠ ŋ
닭고기	t a̠ k̚ k͈ o̞ ɡ i
일치하다	i ʎ t͡ɕʰ i ɦ a̠ d a̠
가치	k a̠ t͡ɕʰ i
인력	i ʎ ʎ j ʌ̹ k̚
갈퀴	k a̠ ɭ kʰ ɥ i
목전	m o̞ k̚ t͡ɕ͈ ʌ̹ n
나가다	n a̠ ɡ a̠ d a̠
엽록체	j ʌ̹ m n o̞ k̚ t͡ɕʰ e̞
선풍기	sʰ ʌ̹ n pʰ u ŋ ɡ i
교리	k j oː ɾ i
암소	a̠ m sʰ o̞
양복	j a̠ ŋ b o̞ k̚
창녀	t͡ɕʰ a̠ ŋ ɲ j ʌ̹
찻물	t͡ɕʰ a̠ n m u ɭ
김	k i m
그네들	k ɯ n e̞ d ɯ ɭ
토치카	tʰ o̞ t͡ɕʰ i kʰ a̠
불기	p u ɭ ɡ i
초심리학	t͡ɕʰ o̞ ɕʰ i m n i ɦ a̠ k̚
돌솥	t o̞ː ɭ sʰ o̞ t̚
대하다	t ɛː ɦ a̠ d a̠
마다	m a̠ d a̠
ㅄ	p j ʌ̹ ŋ ɕʰ i n
폴더	pʰ o̞ ɭ d ʌ̹
맘	m a̠ː m
접	t͡ɕ ʌ̹ p̚
옥시토신	o̞ k ɕ͈ i tʰ o̞ ɕʰ i n
아동	a̠ d o̞ ŋ
어젯밤	ʌ̹ d͡ʑ e̞ t̚ p͈ a̠ m
크립톤	k x ɯ ɾ i p̚ tʰ o̞ n
귓구멍	k ɥ i t̚ k͈ u m ʌ̹ ŋ
연구하다	j ɘː n ɡ u ɦ a̠ d a̠
남편	n a̠ m pʰ j ʌ̹ n
찐만두	t͡ɕ͈ i n m a̠ n d u
들치기	t ɯ ʎ t͡ɕʰ i ɡ i
대륙밭쥐	t ɛː ɾ j u k̚ p͈ a̠ t̚ t͡ɕ͈ ɥ i
음악가	ɯ m a̠ k̚ k͈ a̠
남만	n a̠ m m a̠ n
금연	k ɯː m j ʌ̹ n
물레	m u ɭ ɭ e̞
초은하단	t͡ɕʰ o̞ ɯ n ɦ a̠ d a̠ n
대위	t ɛː ɥ i
교육하다	k j oː j u kʰ a̠ d a̠
브라질리아	p ɯ ɾ a̠ d͡ʑ i ʎ ʎ i a̠
제네바	t͡ɕ e̞ n e̞ b a̠
악수	a̠ k s͈ u
오	o̞ː
출출하다	t͡ɕʰ u ʎ t͡ɕʰ u ɾ ɦ a̠ d a̠
서벌	sʰ ʌ̹ b ʌ̹ ɭ
팔극권	pʰ a̠ ɭ ɡ ɯ k̚ k͈ w ʌ̹ n
칙	t͡ɕʰ i k̚
발사	p a̠ ɭ s͈ a̠
먹	m ʌ̹ k̚
비우다	p i u d a̠
손자	sʰ o̞ ɲ d͡ʑ a̠
와이프	w a̠ i pʰ ɯ
세계관	sʰ e̞ː ɡ j e̞ ɡ w a̠ n
두더지	t u d ʌ̹ d͡ʑ i
입다	i p̚ t͈ a̠
젖꼭지	t͡ɕ ʌ̹ t̚ k͈ o̞ k̚ t͡ɕ͈ i
수질	sʰ u d͡ʑ i ɭ
가만가만	k a̠ m a̠ n ɡ a̠ m a̠ n
수평	sʰ u pʰ j ʌ̹ ŋ
국민	k u ŋ m i n
사로잡다	sʰ a̠ ɾ o̞ d͡ʑ a̠ p̚ t͈ a̠
제출하다	t͡ɕ e̞ t͡ɕʰ u ɾ ɦ a̠ d a̠
분포	p u n pʰ o̞
질병	t͡ɕ i ɭ b j ʌ̹ ŋ
우도	u d o̞
뉘우치다	n ɥ i u t͡ɕʰ i d a̠
국시	k u k ɕ͈ i
신종	ɕʰ iː ɲ d͡ʑ o̞ ŋ
중국말	t͡ɕ u ŋ ɡ u ŋ m a̠ ɭ
포획하다	pʰ o̞ː β w e̞ kʰ a̠ d a̠
기관차	k i ɡ w a̠ ɲ t͡ɕʰ a̠
골격	k o̞ ɭ ɡ j ʌ̹ k̚
까마귀	k͈ a̠ m a̠ ɡ ɥ i
묘미	m j oː m i
발표	p a̠ ɭ pʰ j o
칸	kʰ a̠ n
부러뜨리다	p u ɾ ʌ̹ t͈ ɯ ɾ i d a̠
묻다	m u t̚ t͈ a̠
잦다	t͡ɕ a̠ t̚ t͈ a̠
끓이다	k͈ ɯː ɾ i d a̠
본격적	p o̞ n k͈ j ʌ̹ k̚ t͡ɕ͈ ʌ̹ k̚
타협하다	tʰ a̠ː ʝ j ʌ̹ pʰ a̠ d a̠
학부	h a̠ k̚ p͈ u
분	p u n
이사악	i sʰ a̠ a̠ k̚
으로	ɯ ɾ o̞
촌놈	t͡ɕʰ o̞ n n o̞ m
소총	sʰ o̞ː t͡ɕʰ o̞ ŋ
가두리	k a̠ː d u ɾ i
강구다	k a̠ ŋ ɡ u d a̠
ᆫ다	n d a̠
북	p u k̚
천도	t͡ɕʰ ɘː n d o̞
단락	t a̠ ɭ ɭ a̠ k̚
에취	e̞ t͡ɕʰ ɥ i
성문	sʰ ʌ̹ ŋ m u n
카멜레온	kʰ a̠ m e̞ ɭ ɭ e̞ o̞ n
마케팅	m a̠ kʰ e̞ tʰ i ŋ
걸프렌드	k ʌ̹ ɭ pʰ ɯ ɾ e̞ n d ɯ
노인병학	n o̞ː i n b j ʌ̹ ŋ ɦ a̠ k̚
동물원	t o̞ː ŋ m u ɾ w ʌ̹ n
사향	sʰ a̠ː ʝ j a̠ ŋ
그게	k ɯ ɡ e̞
작곡자	t͡ɕ a̠ k̚ k͈ o̞ k̚ t͡ɕ͈ a̠
분탕질	p u n tʰ a̠ ŋ d͡ʑ i ɭ
합체	h a̠ p̚ t͡ɕʰ e̞
가	k a̠ː
맡기다	m a̠ t̚ k͈ i d a̠
가금	k a̠ ɡ ɯ m
디스플레이	t i sʰ ɯ pʰ ɯ ɭ ɭ e̞ i
냉장고	n ɛː ŋ d͡ʑ a̠ ŋ ɡ o̞
동전	t o̞ ŋ d͡ʑ ʌ̹ n
돈가스	t o̞ n ɡ a̠ sʰ ɯ
농학	n o̞ː ŋ ɦ a̠ k̚
공포	k o̞ː ŋ pʰ o̞
유치원	j u t͡ɕʰ i w ʌ̹ n
방점	p a̠ ŋ t͡ɕ͈ ʌ̹ m
집안	t͡ɕ i b a̠ n
감마	k a̠ m m a̠
표준어	pʰ j o d͡ʑ u n ʌ̹
원료	w ʌ̹ ʎ ʎ j o
베프	p e̞ pʰ ɯ
출구	t͡ɕʰ u ɭ ɡ u
예닐곱	j e̞ n i ɭ ɡ o̞ p̚
띠다	t͈ iː d a̠
알파벳	a̠ ɭ pʰ a̠ b e̞ t̚
오늘	o̞ n ɯ ɭ
산시	sʰ a̠ n ɕʰ i
게임	k͈ e̞ i m
호스	ɸʷ o̞ sʰ ɯ
고물	k o̞ m u ɭ
이체자	i t͡ɕʰ e̞ d͡ʑ a̠
다크서클	t a̠ k x ɯ s͈ ʌ̹ k x ɯ ɭ
드라이브하다	t ɯ ɾ a̠ i b ɯ ɦ a̠ d a̠
소꿉	sʰ o̞ k͈ u p̚
조리	t͡ɕ o̞ ɾ i
승진	sʰ ɯ ŋ d͡ʑ i n
어여쁘다	ʌ̹ j ʌ̹ p͈ ɯ d a̠
날씬하다	n a̠ ɭ ɕ͈ i n ɦ a̠ d a̠
짚다	t͡ɕ i p̚ t͈ a̠
포장	pʰ o̞ d͡ʑ a̠ ŋ
옥문	o̞ ŋ m u n
일어나라	i ɾ ʌ̹ n a̠ ɾ a̠
다니다	t a̠ n i d a̠
근혜	k ɯ n ʝ j e̞
사냥하다	sʰ a̠ ɲ j a̠ ŋ ɦ a̠ d a̠
펑	pʰ ʌ̹ ŋ
차량	t͡ɕʰ a̠ ɾ j a̠ ŋ
분위기	p u n ɥ i ɡ i
흡연	x ɯ b j ʌ̹ n
도망치다	t o̞ m a̠ ŋ t͡ɕʰ i d a̠
산살바도르	sʰ a̠ n sʰ a̠ ɭ b a̠ d o̞ ɾ ɯ
조약돌	t͡ɕ o̞ j a̠ k̚ t͈ o̞ ɭ
봉투	p o̞ ŋ tʰ u
갑각	k a̠ p̚ k͈ a̠ k̚
주	t͡ɕ u
갑자기	k a̠ p̚ t͡ɕ͈ a̠ ɡ i
역경	j ʌ̹ k̚ k͈ j ʌ̹ ŋ
즐기다	t͡ɕ ɯ ɭ ɡ i d a̠
유지하다	j u d͡ʑ i ɦ a̠ d a̠
바꼬락	p a̠ k͈ o̞ ɾ a̠ k̚
애인	ɛː i n
장식	t͡ɕ a̠ ŋ ɕʰ i k̚
기원전	k i w ʌ̹ ɲ d͡ʑ ʌ̹ n
오월	o̞ː w ʌ̹ ɭ
얻다	ɘː t̚ t͈ a̠
하숙집	h a̠ː sʰ u k̚ t͡ɕ͈ i p̚
프리토리아	pʰ ɯ ɾ i tʰ o̞ ɾ i a̠
전어	t͡ɕ ɘː n ʌ̹
위글말	ɥ i ɡ ɯ ɭ m a̠ ɭ
배신	p ɛː ɕʰ i n
공군	k o̞ ŋ ɡ u n
구경하다	k uː ɡ j ʌ̹ ŋ ɦ a̠ d a̠
콩	kʰ o̞ ŋ
승무원	sʰ ɯ ŋ m u w ʌ̹ n
꽃가루	k͈ o̞ t̚ k͈ a̠ ɾ u
검찰	k ɘː m t͡ɕʰ a̠ ɭ
유도	j u d o̞
이어폰	i ʌ̹ pʰ o̞ n
보다	p o̞ d a̠
순박하다	sʰ u n b a̠ kʰ a̠ d a̠
미스터	m i sʰ ɯ tʰ ʌ̹
국고	k u k̚ k͈ o̞
그러하다	k ɯ ɾ ʌ̹ ɦ a̠ d a̠
하지만	h a̠ d͡ʑ i m a̠ n
무렵	m u ɾ j ʌ̹ p̚
등	t ɯ ŋ
귀신	k ɥ iː ɕʰ i n
유라시아	j u ɾ a̠ ɕʰ i a̠
달려오다	t a̠ ʎ ʎ j ʌ̹ o̞ d a̠
감자	k a̠ m d͡ʑ a̠
제작	t͡ɕ e̞ː d͡ʑ a̠ k̚
자두나무	t͡ɕ a̠ d u n a̠ m u
바이올린	p a̠ i o̞ ʎ ʎ i n
둬	t w ɘː
기니비사우	k i n i b i sʰ a̠ u
증진하다	t͡ɕ ɯ ŋ d͡ʑ i n ɦ a̠ d a̠
공룡	k o̞ː ŋ ɲ j o ŋ
포드고리차	pʰ o̞ d ɯ ɡ o̞ ɾ i t͡ɕʰ a̠
얌차	j a̠ m t͡ɕʰ a̠
파도	pʰ a̠ d o̞
바퀴벌레	p a̠ kʰ ɥ i b ʌ̹ ɭ ɭ e̞
부르심	p u ɾ ɯ ɕʰ i m
항로	h a̠ː ŋ n o̞
뿔	p͈ u ɭ
활	ɸ w a̠ ɭ
바지	p a̠ d͡ʑ i
병원	p j ɘː ŋ w ʌ̹ n
가나	k a̠ n a̠
비료	p iː ɾ j o
뼞	p͈ j ʌ̹ t̚
개정	k ɛː d͡ʑ ʌ̹ ŋ
요가	j o ɡ a̠
사전	sʰ a̠ː d͡ʑ ʌ̹ n
레퍼토리	ɾ e̞ pʰ ʌ̹ tʰ o̞ ɾ i
오른손잡이	o̞ ɾ ɯ n sʰ o̞ ɲ d͡ʑ a̠ b i
소치	s͈ o̞ t͡ɕʰ i
그라프	k ɯ ɾ a̠ pʰ ɯ
판판하다	pʰ a̠ n pʰ a̠ n ɦ a̠ d a̠
질리다	t͡ɕ i ʎ ʎ i d a̠
스라소니	sʰ ɯ ɾ a̠ sʰ o̞ n i
건조하다	k ʌ̹ ɲ d͡ʑ o̞ ɦ a̠ d a̠
수하물	sʰ u ɦ a̠ m u ɭ
궁극적	k u ŋ ɡ ɯ k̚ t͡ɕ͈ ʌ̹ k̚
콘비프	kʰ o̞ n b i pʰ ɯ
이민	i m i n
광주	k w a̠ ŋ d͡ʑ u
고수	k o̞ sʰ u
화강암	ɸ w a̠ ɡ a̠ ŋ a̠ m
추구하다	t͡ɕʰ u ɡ u ɦ a̠ d a̠
눠	n w ɘː
떽	t͈ e̞ k̚
의하다	ɰ i ɦ a̠ d a̠
만주어	m a̠ ɲ d͡ʑ u ʌ̹
복장	p o̞ k̚ t͡ɕ͈ a̠ ŋ
야쿠자	j a̠ kʰ u d͡ʑ a̠
모충	m o̞ t͡ɕʰ u ŋ
틴에이저	tʰ i n e̞ i d͡ʑ ʌ̹
이상	iː sʰ a̠ ŋ
구경군	k uː ɡ j ʌ̹ ŋ ɡ u n
한자	h a̠ː ɲ t͡ɕ͈ a̠
눈동자	n u n d o̞ ŋ d͡ʑ a̠
결사옹위	k j ʌ̹ ɭ s͈ a̠ o̞ ŋ ɥ i
정거장	t͡ɕ ʌ̹ ŋ ɡ ʌ̹ d͡ʑ a̠ ŋ
악담	a̠ k̚ t͈ a̠ m
이튿날	i tʰ ɯ n n a̠ ɭ
된소리	t w e̞ː n sʰ o̞ ɾ i
시상	ɕʰ iː sʰ a̠ ŋ
조리	t͡ɕ o̞ː ɾ i
불지르다	p u ʎ d͡ʑ i ɾ ɯ d a̠
아콰리움	a̠ kʰ w a̠ ɾ i u m
긷다	k iː t̚ t͈ a̠
꽈리	k͈ w a̠ ɾ i
게사니	k e̞ sʰ a̠ n i
철밥통	t͡ɕʰ ʌ̹ ɭ b a̠ p̚ tʰ o̞ ŋ
서월	sʰ ʌ̹ w ʌ̹ ɭ
굽다	k uː p̚ t͈ a̠
바라보다	p a̠ ɾ a̠ b o̞ d a̠
마술	m a̠ sʰ u ɭ
면도하다	m j ɘː n d o̞ ɦ a̠ d a̠
하트	h a̠ tʰ ɯ
멥쌀	m e̞ p s͈ a̠ ɭ
옳다	o̞ ɭ tʰ a̠
차분법	t͡ɕʰ a̠ b u n b ʌ̹ p̚
장보다	t͡ɕ a̠ ŋ b o̞ d a̠
척추	t͡ɕʰ ʌ̹ k̚ t͡ɕʰ u
지르다	t͡ɕ i ɾ ɯ d a̠
석순	sʰ ʌ̹ k s͈ u n
중심닮음	t͡ɕ u ŋ ɕʰ i m d a̠ ɭ m ɯ m
규소수지	k j u sʰ o̞ sʰ u d͡ʑ i
미니버스	m i n i b ʌ̹ sʰ ɯ
당연	t a̠ ŋ j ʌ̹ n
단순	t a̠ n sʰ u n
라니	ɾ a̠ n i
더브늄	t ʌ̹ b ɯ ɲ j u m
등허리	t ɯ ŋ ɦ ʌ̹ ɾ i
양로원	j a̠ː ŋ n o̞ w ʌ̹ n
같이하다	k a̠ t͡ɕʰ i ɦ a̠ d a̠
단천	t a̠ ɲ t͡ɕʰ ʌ̹ n
편린	pʰ j ʌ̹ ʎ ʎ i n
바나듐	p a̠ n a̠ d j u m
거미줄	k ʌ̹ m i d͡ʑ u ɭ
이쪽	i t͡ɕ͈ o̞ k̚
반영	p a̠ː ɲ j ʌ̹ ŋ
남포	n a̠ m pʰ o̞
괌도	k w a̠ m d o̞
소낙비	sʰ o̞ n a̠ k̚ p͈ i
무척	m u t͡ɕʰ ʌ̹ k̚
복지	p o̞ k̚ t͡ɕ͈ i
다락같다	t a̠ ɾ a̠ k̚ k͈ a̠ t̚ t͈ a̠
구름	k u ɾ ɯ m
좁다	t͡ɕ o̞ p̚ t͈ a̠
경	k j ɘː ŋ
발견하다	p a̠ ɭ ɡ j ʌ̹ n ɦ a̠ d a̠
전부	t͡ɕ ʌ̹ n b u
관련성	k w a̠ ʎ ʎ j ʌ̹ n s͈ ʌ̹ ŋ
흥분하다	x ɯ ŋ b u n ɦ a̠ d a̠
베드로	p e̞ d ɯ ɾ o̞
갈옷	k a̠ ɾ o̞ t̚
무	m u
미닫이문	m iː d a̠ d i m u n
이야	i j a̠
한가운데	h a̠ n ɡ a̠ u n d e̞
통치하다	tʰ o̞ː ŋ t͡ɕʰ i ɦ a̠ d a̠
추락	t͡ɕʰ u ɾ a̠ k̚
자그레브	t͡ɕ a̠ ɡ ɯ ɾ e̞ b ɯ
선수	sʰ ɘː n sʰ u
기후	k i β u
타지크어	tʰ a̠ d͡ʑ i k x ɯ ʌ̹
참고서	t͡ɕʰ a̠ m ɡ o̞ sʰ ʌ̹
고려말	k o̞ ɾ j ʌ̹ m a̠ ɭ
성가	sʰ ɘː ŋ ɡ a̠
장갑	t͡ɕ a̠ː ŋ ɡ a̠ p̚
확성기	ɸ w a̠ k s͈ ʌ̹ ŋ ɡ i
민주주의	m i ɲ d͡ʑ u d͡ʑ u ɰ i
오슬로	o̞ sʰ ɯ ɭ ɭ o̞
호기심	ɸʷ o̞ː ɡ i ɕʰ i m
흒	x ɯ k̚
이따가	i t͈ a̠ ɡ a̠
불현듯	p u ɾ ʝ j ʌ̹ n d ɯ t̚
버터	p ʌ̹ tʰ ʌ̹
소음순	sʰ o̞ː ɯ m sʰ u n
ㅔ	e̞
끄리	k͈ ɯ ɾ i
우눈헥슘	u n u n ɦ e̞ k ɕ͈ u m
관목	k w a̠ː n m o̞ k̚
명명하다	m j ɘː ŋ m j ʌ̹ ŋ ɦ a̠ d a̠
동	t o̞ː ŋ
교향곡	k j o ʝ j a̠ ŋ ɡ o̞ k̚
그룹	k ɯ ɾ u p̚
풀	pʰ u ɭ
여호와	j ʌ̹ β o̞ w a̠
기다리다	k i d a̠ ɾ i d a̠
가설	k a̠ː sʰ ʌ̹ ɭ
쇠황조롱이	sʰ w e̞ β w a̠ ŋ d͡ʑ o̞ ɾ o̞ ŋ i
침범	t͡ɕʰ iː m b ʌ̹ m
매	m ɛː
쿵	kʰ u ŋ
방광염	p a̠ ŋ ɡ w a̠ ŋ ɲ j ʌ̹ m
스물	sʰ ɯ m u ɭ
가위	k a̠ ɥ i
시상하부	ɕʰ iː sʰ a̠ ŋ h a̠ b u
드리다	t ɯ ɾ i d a̠
코요테	kʰ o̞ j o tʰ e̞
카드	kʰ a̠ d ɯ
표제	pʰ j o d͡ʑ e̞
불알	p u ɾ a̠ ɭ
모시다	m o̞ː ɕʰ i d a̠
꽃다발	k͈ o̞ t̚ t͈ a̠ b a̠ ɭ
썩다	s͈ ʌ̹ k̚ t͈ a̠
벼랑	p j ʌ̹ ɾ a̠ ŋ
쥐며느리	t͡ɕ ɥ i m j ʌ̹ n ɯ ɾ i
무조건	m u d͡ʑ o̞ k͈ ʌ̹ n
민물검정망둑	m i n m u ɭ ɡ ʌ̹ m d͡ʑ ʌ̹ ŋ m a̠ ŋ d u k̚
수원	sʰ u w ʌ̹ n
천체	t͡ɕʰ ʌ̹ ɲ t͡ɕʰ e̞
뒤보다	t ɥ i b o̞ d a̠
스포일러	s͈ ɯ pʰ o̞ i ɭ ɭ ʌ̹
토스트	tʰ o̞ sʰ ɯ tʰ ɯ
군도	k u n d o̞
첫	t͡ɕʰ ʌ̹ t̚
최초	t͡ɕʰ w e̞ː t͡ɕʰ o̞
감사하다	k a̠ː m sʰ a̠ ɦ a̠ d a̠
조심하다	t͡ɕ o̞ː ɕʰ i m ɦ a̠ d a̠
시리다	ɕʰ i ɾ i d a̠
방식	p a̠ ŋ ɕʰ i k̚
누리다	n u ɾ i d a̠
실력	ɕʰ i ʎ ʎ j ʌ̹ k̚
기함	k i ɦ a̠ m
의장	ɰ i d͡ʑ a̠ ŋ
라우터	ɾ a̠ u tʰ ʌ̹
실제	ɕʰ i ʎ t͡ɕ͈ e̞
메아리	m e̞ a̠ ɾ i
들	t ɯ ɭ
허둥지둥	h ʌ̹ d u ŋ d͡ʑ i d u ŋ
포	pʰ o̞
빙산	p i ŋ sʰ a̠ n
마니	m a̠ n i
사탄교	sʰ a̠ tʰ a̠ n ɡ j o
그리움	k ɯ ɾ i u m
위원회	ɥ i w ʌ̹ n β w e̞
플러스	pʰ ɯ ɭ ɭ ʌ̹ sʰ ɯ
감리교	k a̠ m n i ɡ j o
럭비	ɾ ʌ̹ k̚ p͈ i
우연	u j ʌ̹ n
탈출기	tʰ a̠ ʎ t͡ɕʰ u ɭ ɡ i
뛰다	t͈ ɥ i d a̠
우주론	u d͡ʑ u ɾ o̞ n
발뒤꿈	p a̠ ɭ t͈ ɥ i k͈ u m
옛날이야기	j e̞ː n n a̠ ʎ ʎ i j a̠ ɡ i
악습	a̠ k s͈ ɯ p̚
요도	j o d o̞
토르	tʰ o̞ ɾ ɯ
다다미	t a̠ d a̠ m i
압도하다	a̠ p̚ t͈ o̞ ɦ a̠ d a̠
펴다	pʰ j ʌ̹ d a̠
애무	ɛː m u
노병	n o̞ː b j ʌ̹ ŋ
작용	t͡ɕ a̠ ɡ j o ŋ
저지르다	t͡ɕ ʌ̹ d͡ʑ i ɾ ɯ d a̠
헤드폰	h e̞ d ɯ pʰ o̞ n
기반	k i b a̠ n
교편	k j oː pʰ j ʌ̹ n
춘절	t͡ɕʰ u ɲ d͡ʑ ʌ̹ ɭ
여신	j ʌ̹ ɕʰ i n
에어쿠션	e̞ ʌ̹ kʰ u ɕʰ ʌ̹ n
뜯기	t͈ ɯ t̚ k͈ i
젖가공품	t͡ɕ ʌ̹ t̚ k͈ a̠ ɡ o̞ ŋ pʰ u m
핀셋	pʰ i n sʰ e̞ t̚
보따리	p o̞ t͈ a̠ ɾ i
네	n e̞ː
통합	tʰ o̞ː ŋ ɦ a̠ p̚
약사	j a̠ k s͈ a̠
창제	t͡ɕʰ a̠ ŋ d͡ʑ e̞
고양이	k o̞ j a̠ ŋ i
빗다	p i t̚ t͈ a̠
거꾸로	k ʌ̹ k͈ u ɾ o̞
기다랗다	k iː d a̠ ɾ a̠ tʰ a̠
세탁기	sʰ e̞ː tʰ a̠ k̚ k͈ i
닳다	t a̠ ɭ tʰ a̠
운동하다	uː n d o̞ ŋ ɦ a̠ d a̠
누에	n u e̞
임신하다	iː m ɕʰ i n ɦ a̠ d a̠
전당포	t͡ɕ ɘː n d a̠ ŋ pʰ o̞
와셔	w a̠ ɕʰ ʌ̹
공민	k o̞ ŋ m i n
내용	n ɛː j o ŋ
간장	k a̠ ɲ d͡ʑ a̠ ŋ
접두사	t͡ɕ ʌ̹ p̚ t͈ u sʰ a̠
하늘다람쥐	h a̠ n ɯ ɭ d a̠ ɾ a̠ m d͡ʑ ɥ i
갈비탕	k a̠ ɭ b i tʰ a̠ ŋ
어지럽다	ʌ̹ d͡ʑ i ɾ ʌ̹ p̚ t͈ a̠
자살	t͡ɕ a̠ sʰ a̠ ɭ
앙카라	a̠ ŋ kʰ a̠ ɾ a̠
단념	t a̠ː n ɲ j ʌ̹ m
성망	sʰ ɘː ŋ m a̠ ŋ
되찾다	t w e̞ t͡ɕʰ a̠ t̚ t͈ a̠
조선옷	t͡ɕ o̞ sʰ ʌ̹ n o̞ t̚
ㅞ	w e̞
소유물	sʰ o̞ː j u m u ɭ
날카롭다	n a̠ ɭ kʰ a̠ ɾ o̞ p̚ t͈ a̠
됭경모치	t w e̞ ŋ ɡ j ʌ̹ ŋ m o̞ t͡ɕʰ i
기선	k i sʰ ʌ̹ n
멸시	m j ʌ̹ ɭ ɕʰ i
바로가기	p a̠ ɾ o̞ ɡ a̠ ɡ i
핫라인	h a̠ n n a̠ i n
산보	sʰ a̠ n b o̞
강제	k a̠ː ŋ d͡ʑ e̞
종국	t͡ɕ o̞ ŋ ɡ u k̚
만억	m a̠ː n ʌ̹ k̚
방향	p a̠ ŋ ʝ j a̠ ŋ
귀	k ɥ i
자장면	t͡ɕ a̠ d͡ʑ a̠ ŋ m j ʌ̹ n
서술하다	sʰ ɘː sʰ u ɾ ɦ a̠ d a̠
녜	ɲ j e̞
진리	t͡ɕ i ʎ ʎ i
약혼녀	j a̠ kʰ o̞ n ɲ j ʌ̹
회계사	ɸ w e̞ː ɡ j e̞ sʰ a̠
사인하다	sʰ a̠ i n ɦ a̠ d a̠
엉겁결에	ʌ̹ ŋ ɡ ʌ̹ p̚ k͈ j ʌ̹ ɾ e̞
인공	i n ɡ o̞ ŋ
까타르	k͈ a̠ tʰ a̠ ɾ ɯ
콤바인	kʰ o̞ m b a̠ i n
경계하다	k j ɘː ŋ ɡ j e̞ ɦ a̠ d a̠
피라미드	pʰ i ɾ a̠ m i d ɯ
존중하다	t͡ɕ o̞ ɲ d͡ʑ u ŋ ɦ a̠ d a̠
베이징	p e̞ i d͡ʑ i ŋ
섞이다	sʰ ʌ̹ k͈ i d a̠
소반	sʰ o̞ b a̠ n
아냐	a̠ ɲ j a̠
까렐리야	k͈ a̠ ɾ e̞ ʎ ʎ i j a̠
벡터	p e̞ k̚ tʰ ʌ̹
방망이	p a̠ ŋ m a̠ ŋ i
다묵장어	t a̠ m u k̚ t͡ɕ͈ a̠ ŋ ʌ̹
정역학	t͡ɕ ʌ̹ ŋ ɲ j ʌ̹ kʰ a̠ k̚
소제하다	sʰ o̞ː d͡ʑ e̞ ɦ a̠ d a̠
이렇다	i ɾ ʌ̹ tʰ a̠
목마	m o̞ ŋ m a̠
대륙	t ɛː ɾ j u k̚
독서	t o̞ k s͈ ʌ̹
마음쓰다	m a̠ ɯ m s͈ ɯ d a̠
빗기다	p i t̚ k͈ i d a̠
과외	k w a̠ w e̞
까먹다	k͈ a̠ m ʌ̹ k̚ t͈ a̠
수로	sʰ u ɾ o̞
명사	m j ʌ̹ ŋ sʰ a̠
병기창	p j ʌ̹ ŋ ɡ i t͡ɕʰ a̠ ŋ
분리	p u ʎ ʎ i
추밀원	t͡ɕʰ u m i ɾ w ʌ̹ n
자전	t͡ɕ a̠ d͡ʑ ʌ̹ n
미장원	m iː d͡ʑ a̠ ŋ w ʌ̹ n
그리워하다	k ɯ ɾ i w ʌ̹ ɦ a̠ d a̠
상점	sʰ a̠ ŋ d͡ʑ ʌ̹ m
천산갑	t͡ɕʰ ɘː n sʰ a̠ n ɡ a̠ p̚
미리보기	m i ɾ i b o̞ ɡ i
봉건	p o̞ ŋ ɡ ʌ̹ n
스트레스	sʰ ɯ tʰ ɯ ɾ e̞ s͈ ɯ
학교	h a̠ k̚ k͈ j o
아베크	a̠ b e̞ k x ɯ
가만히	k a̠ m a̠ n ʝ i
말다	m a̠ː ɭ d a̠
케익	kʰ e̞ i k̚
갈까마귀	k a̠ ɭ k͈ a̠ m a̠ ɡ ɥ i
중세	t͡ɕ u ŋ sʰ e̞
음역자	ɯ m j ʌ̹ k̚ t͡ɕ͈ a̠
외계어	w e̞ː ɡ j e̞ ʌ̹
복무	p o̞ ŋ m u
편복	pʰ j ʌ̹ n b o̞ k̚
야하다	j a̠ː ɦ a̠ d a̠
양말	j a̠ ŋ m a̠ ɭ
가뭄	k a̠ m u m
페이지	pʰ e̞ i d͡ʑ i
옷걸이	o̞ t̚ k͈ ʌ̹ ɾ i
놔두다	n w a̠ d u d a̠
일요일	i ɾ j o i ɭ
구굴무치	k u ɡ u ɭ m u t͡ɕʰ i
호주머니	ɸʷ o̞ d͡ʑ u m ʌ̹ n i
금	k ɯ m
도망	t o̞ m a̠ ŋ
아제르바이잔	a̠ d͡ʑ e̞ ɾ ɯ b a̠ i d͡ʑ a̠ n
초반	t͡ɕʰ o̞ b a̠ n
가마	k a̠ m a̠
모니터	m o̞ n i tʰ ʌ̹
불쌍하다	p u ɭ s͈ a̠ ŋ ɦ a̠ d a̠
폭	pʰ o̞ k̚
중순	t͡ɕ u ŋ sʰ u n
기체	k i t͡ɕʰ e̞
스케줄	sʰ ɯ kʰ e̞ d͡ʑ u ɭ
살롱	sʰ a̠ ɭ ɭ o̞ ŋ
듯하다	t ɯ tʰ a̠ d a̠
화신	ɸ w a̠ː ɕʰ i n
가설	k a̠ sʰ ʌ̹ ɭ
곶	k o̞ t̚
이교도	iː ɡ j o d o̞
차드	t͡ɕʰ a̠ d ɯ
훙	ɸʷ u ŋ
큰말똥가리	k x ɯ n m a̠ ɭ t͈ o̞ ŋ ɡ a̠ ɾ i
발꿈치	p a̠ ɭ k͈ u m t͡ɕʰ i
스테로이드	sʰ ɯ tʰ e̞ ɾ o̞ i d ɯ
더러워지다	t ɘː ɾ ʌ̹ w ʌ̹ d͡ʑ i d a̠
신수	ɕʰ i n sʰ u
말벌	m a̠ ɭ b ʌ̹ ɭ
릉	ɾ ɯ ŋ
마스다	m a̠ sʰ ɯ d a̠
가언적	k a̠ ʌ̹ ɲ d͡ʑ ʌ̹ k̚
피리	pʰ i ɾ i
화제한어	ɸ w a̠ d͡ʑ e̞ ɦ a̠ n ʌ̹
도시락	t o̞ ɕʰ i ɾ a̠ k̚
전지	t͡ɕ ɘː ɲ d͡ʑ i
식민주의	ɕʰ i ŋ m i ɲ d͡ʑ u ɰ i
콧물	kʰ o̞ n m u ɭ
고아원	k o̞ a̠ w ʌ̹ n
뻳	p͈ e̞ t̚
풍자문	pʰ u ŋ d͡ʑ a̠ m u n
외몽고	w e̞ m o̞ ŋ ɡ o̞
빈뇨	p i n ɲ j o
제안하다	t͡ɕ e̞ a̠ n ɦ a̠ d a̠
탈	tʰ a̠ː ɭ
주둥치	t͡ɕ u d u ŋ t͡ɕʰ i
늦잠	n ɯ t̚ t͡ɕ͈ a̠ m
광동어	k w a̠ ŋ d o̞ ŋ ʌ̹
영성체	j ɘː ŋ sʰ ʌ̹ ŋ t͡ɕʰ e̞
다치다	t a̠ t͡ɕʰ i d a̠
사우디아라비아	sʰ a̠ u d i a̠ ɾ a̠ b i a̠
중국화	t͡ɕ u ŋ ɡ u kʰ w a̠
양조장	j a̠ː ŋ d͡ʑ o̞ d͡ʑ a̠ ŋ
스페인어	sʰ ɯ pʰ e̞ i n ʌ̹
혹시	ɸʷ o̞ k ɕ͈ i
분광학	p u n ɡ w a̠ ŋ ɦ a̠ k̚
공급	k o̞ː ŋ ɡ ɯ p̚
경음기	k j ʌ̹ ŋ ɯ m ɡ i
쓰촨	s͈ ɯ t͡ɕʰ w a̠ n
구석차기	k u sʰ ʌ̹ k̚ t͡ɕʰ a̠ ɡ i
주민	t͡ɕ uː m i n
올려놓다	o̞ ʎ ʎ j ʌ̹ n o̞ tʰ a̠
여우원숭이	j ʌ̹ u w ʌ̹ n sʰ u ŋ i
옮다	o̞ː m t͈ a̠
쌍지읒	s͈ a̠ ŋ d͡ʑ i ɯ t̚
심다	ɕʰ iː m t͈ a̠
갈겨니	k a̠ ɭ ɡ j ʌ̹ n i
옮아오다	o̞ ɭ m a̠ o̞ d a̠
인체	i ɲ t͡ɕʰ e̞
곳곳	k o̞ t̚ k͈ o̞ t̚
관계	k w a̠ n ɡ j e̞
플러그	pʰ ɯ ɭ ɭ ʌ̹ ɡ ɯ
어린이	ʌ̹ ɾ i n i
티베리우스	tʰ i b e̞ ɾ i u sʰ ɯ
불꽃	p u ɭ k͈ o̞ t̚
가설법	k a̠ː sʰ ʌ̹ ɭ p͈ ʌ̹ p̚
총화	t͡ɕʰ o̞ ŋ β w a̠
식탁보	ɕʰ i k̚ tʰ a̠ k̚ p͈ o̞
헝가리어	h ʌ̹ ŋ ɡ a̠ ɾ i ʌ̹
업소	ʌ̹ p s͈ o̞
연필	j ʌ̹ n pʰ i ɭ
제독	t͡ɕ e̞ d o̞ k̚
구분	k u b u n
삼성	sʰ a̠ m sʰ ʌ̹ ŋ
싸울아비	s͈ a̠ u ɾ a̠ b i
벨벳	p e̞ ɭ b e̞ t̚
따라하다	t͈ a̠ ɾ a̠ ɦ a̠ d a̠
수컷	sʰ u kʰ ʌ̹ t̚
서버	s͈ ʌ̹ b ʌ̹
큰낫	k x ɯ n n a̠ t̚
선글라스	sʰ ʌ̹ n ɡ ɯ ɭ ɭ a̠ sʰ ɯ
시각	ɕʰ iː ɡ a̠ k̚
완벽하다	w a̠ n b j ʌ̹ kʰ a̠ d a̠
고온	k o̞ o̞ n
습	sʰ ɯ p̚
해고	h ɛː ɡ o̞
라한	ɾ a̠ ɦ a̠ n
무게	m u ɡ e̞
수적	sʰ uː t͡ɕ͈ ʌ̹ k̚
건강하다	k ɘː n ɡ a̠ ŋ ɦ a̠ d a̠
녹	n o̞ k̚
마이크	m a̠ i k x ɯ
원통	w ʌ̹ n tʰ o̞ ŋ
나그네	n a̠ ɡ ɯ n e̞
퓚	pʰ ɥ i p̚
지팡이	t͡ɕ i pʰ a̠ ŋ i
너덧	n ʌ̹ d ʌ̹ t̚
풀파워	pʰ u ɭ pʰ a̠ w ʌ̹
한탄하다	h a̠ː n tʰ a̠ n ɦ a̠ d a̠
황제	ɸ w a̠ ŋ d͡ʑ e̞
수학	sʰ u ɦ a̠ k̚
이루다	i ɾ u d a̠
경험하다	k j ʌ̹ ŋ ɦ ʌ̹ m ɦ a̠ d a̠
각다귀	k a̠ k̚ t͈ a̠ ɡ ɥ i
평원	pʰ j ʌ̹ ŋ w ʌ̹ n
바로잡다	p a̠ ɾ o̞ d͡ʑ a̠ p̚ t͈ a̠
신조어	ɕʰ i ɲ d͡ʑ o̞ ʌ̹
얼짱	ʌ̹ ʎ t͡ɕ͈ a̠ ŋ
운전하다	u ɲ d͡ʑ ʌ̹ n ɦ a̠ d a̠
심정	ɕʰ i m d͡ʑ ʌ̹ ŋ
과들루프	k w a̠ d ɯ ɭ ɭ u pʰ ɯ
알카인	a̠ ɭ kʰ a̠ i n
알루미늄	a̠ ɭ ɭ u m i ɲ j u m
전라남도	t͡ɕ ʌ̹ ɭ ɭ a̠ n a̠ m d o̞
얼굴빛	ʌ̹ ɭ ɡ u ɭ p͈ i t̚
성가시다	sʰ ʌ̹ ŋ ɡ a̠ ɕʰ i d a̠
은자메나	ɯ ɲ d͡ʑ a̠ m e̞ n a̠
나무껍질	n a̠ m u k͈ ʌ̹ p̚ t͡ɕ͈ i ɭ
운동화	uː n d o̞ ŋ β w a̠
쥐다	t͡ɕ ɥ i d a̠
병풍	p j ʌ̹ ŋ pʰ u ŋ
전국	t͡ɕ ɘː n ɡ u k̚
거기	k ʌ̹ ɡ i
잉부	iː ŋ b u
오가다	o̞ ɡ a̠ d a̠
합창	h a̠ p̚ t͡ɕʰ a̠ ŋ
퀴녹살린	kʰ ɥ i n o̞ k s͈ a̠ ʎ ʎ i n
리모넨	ɾ i m o̞ n e̞ n
한중	h a̠ː ɲ d͡ʑ u ŋ
세력	sʰ e̞ ɾ j ʌ̹ k̚
로켓	ɾ o̞ kʰ e̞ t̚
약혼자	j a̠ kʰ o̞ ɲ d͡ʑ a̠
기독교도	k i d o̞ k̚ k͈ j o d o̞
탐사	tʰ a̠ m sʰ a̠
지난주	t͡ɕ i n a̠ ɲ d͡ʑ u
공주병	k o̞ ŋ d͡ʑ u p͈ j ʌ̹ ŋ
후기	ɸʷ uː ɡ i
얼른	ʌ̹ ɭ ɭ ɯ n
강의	k a̠ː ŋ ɰ i
테러	tʰ e̞ ɾ ʌ̹
흡	x ɯ p̚
제작하다	t͡ɕ e̞ː d͡ʑ a̠ kʰ a̠ d a̠
플레로븀	pʰ ɯ ɭ ɭ e̞ ɾ o̞ b j u m
돌	t o̞ ɭ
기총	k i t͡ɕʰ o̞ ŋ
가끔	k a̠ k͈ ɯ m
미소	m i sʰ o̞
내외	n ɛː w e̞
반장	p a̠ ɲ d͡ʑ a̠ ŋ
관습	k w a̠ n sʰ ɯ p̚
보상	p o̞ː sʰ a̠ ŋ
지름	t͡ɕ i ɾ ɯ m
바곤	p a̠ ɡ o̞ n
예순	j e̞ sʰ u n
이트륨	i tʰ ɯ ɾ j u m
겨루다	k j ʌ̹ ɾ u d a̠
건널목	k ɘː n n ʌ̹ ɭ m o̞ k̚
다지다	t a̠ d͡ʑ i d a̠
장르	t͡ɕ a̠ ŋ n ɯ
적도	t͡ɕ ʌ̹ k̚ t͈ o̞
풍선	pʰ u ŋ sʰ ʌ̹ n
괴로움	k w e̞ ɾ o̞ u m
몬테네그로	m o̞ n tʰ e̞ n e̞ ɡ ɯ ɾ o̞
면양	m j ʌ̹ ɲ j a̠ ŋ
저금	t͡ɕ ɘː ɡ ɯ m
의향	ɰ iː ʝ j a̠ ŋ
아라사	a̠ ɾ a̠ sʰ a̠
나귀	n a̠ ɡ ɥ i
저녁놀	t͡ɕ ʌ̹ ɲ j ʌ̹ ŋ n o̞ ɭ
자극	t͡ɕ a̠ː ɡ ɯ k̚
남성중음	n a̠ m sʰ ʌ̹ ŋ d͡ʑ u ŋ ɯ m
섞다	sʰ ʌ̹ k̚ t͈ a̠
중얼거리다	t͡ɕ u ŋ ʌ̹ ɭ ɡ ʌ̹ ɾ i d a̠
순수하다	sʰ u n sʰ u ɦ a̠ d a̠
코스프레	kʰ o̞ sʰ ɯ pʰ ɯ ɾ e̞
이주	i d͡ʑ u
참붕어	t͡ɕʰ a̠ m b u ŋ ʌ̹
아라비아인	a̠ ɾ a̠ b i a̠ i n
OK	o̞ kʰ e̞ i
흑기러기	x ɯ k̚ k͈ i ɾ ʌ̹ ɡ i
이라크	i ɾ a̠ k x ɯ
노안	n o̞ː a̠ n
가는돌고기	k a̠ n ɯ n d o̞ ɭ ɡ o̞ ɡ i
전복	t͡ɕ ʌ̹ n b o̞ k̚
혹고니	ɸʷ o̞ k̚ k͈ o̞ n i
탐험가	tʰ a̠ m ɦ ʌ̹ m ɡ a̠
군바리	k u n b a̠ ɾ i
토양	tʰ o̞ j a̠ ŋ
고유명사	k o̞ j u m j ʌ̹ ŋ sʰ a̠
화기	ɸ w a̠ ɡ i
낚	n a̠ k̚
고문	k o̞ m u n
옥상	o̞ k s͈ a̠ ŋ
어구	ɘː ɡ u
장원	t͡ɕ a̠ ŋ w ʌ̹ n
큰논병아리	k x ɯ n n o̞ n b j ʌ̹ ŋ a̠ ɾ i
수습하다	sʰ u sʰ ɯ pʰ a̠ d a̠
탑승권	tʰ a̠ p s͈ ɯ ŋ k͈ w ʌ̹ n
사신	sʰ a̠ː ɕʰ i n
종횡	t͡ɕ o̞ ŋ β w e̞ ŋ
평일	pʰ j ʌ̹ ŋ i ɭ
문절망둑	m u ɲ d͡ʑ ʌ̹ ɭ m a̠ ŋ d u k̚
수법	sʰ u b ʌ̹ p̚
의	ɰ i
혼수	ɸʷ o̞ n sʰ u
나오다	n a̠ o̞ d a̠
파장	pʰ a̠ d͡ʑ a̠ ŋ
로토	ɾ o̞ tʰ o̞
몇몇	m j ʌ̹ n m j ʌ̹ t̚
장로교	t͡ɕ a̠ː ŋ n o̞ ɡ j o
망상	m a̠ ŋ sʰ a̠ ŋ
결정수	k j ʌ̹ ʎ t͡ɕ͈ ʌ̹ ŋ sʰ u
짊다	t͡ɕ i m t͈ a̠
명란	m j ʌ̹ ŋ n a̠ n
코로나바이러스	kʰ o̞ ɾ o̞ n a̠ b a̠ i ɾ ʌ̹ s͈ ɯ
저작권	t͡ɕ ɘː d͡ʑ a̠ k̚ k͈ w ʌ̹ n
돌아서다	t o̞ ɾ a̠ sʰ ʌ̹ d a̠
페럿	pʰ e̞ ɾ ʌ̹ t̚
깍두기	k͈ a̠ k̚ t͈ u ɡ i
모르다	m o̞ː ɾ ɯ d a̠
호놀룰루	ɸʷ o̞ n o̞ ɭ ɭ u ɭ ɭ u
회의	ɸ w e̞ ɰ i
워싱턴	w ʌ̹ ɕʰ i ŋ tʰ ʌ̹ n
영사관	j ʌ̹ ŋ sʰ a̠ ɡ w a̠ n
교미	k j o m i
주사	t͡ɕ uː sʰ a̠
쇠붙이	sʰ w e̞ b u t͡ɕʰ i
월식	w ʌ̹ ɭ ɕ͈ i k̚
어눌하다	ɘː n u ɾ ɦ a̠ d a̠
리무진	ɾ i m u d͡ʑ i n
나한	n a̠ ɦ a̠ n
살	sʰ a̠ ɭ
두음	t u ɯ m
열셋	j ʌ̹ ɭ s͈ e̞ t̚
실수하다	ɕʰ i ɭ s͈ u ɦ a̠ d a̠
로렌슘	ɾ o̞ ɾ e̞ n ɕʰ u m
티아진	tʰ i a̠ d͡ʑ i n
한파	h a̠ n pʰ a̠
녹두나물	n o̞ k̚ t͈ u n a̠ m u ɭ
낱	n a̠ t̚
값	k a̠ p̚
홀스터	ɸʷ o̞ ɭ sʰ ɯ tʰ ʌ̹
깁	k i p̚
상황	sʰ a̠ ŋ β w a̠ ŋ
없이	ɘː p ɕ͈ i
전문일군	t͡ɕ ʌ̹ n m u n i ɭ ɡ u n
음모	ɯ m m o̞
사안	sʰ a̠ː a̠ n
오락	o̞ː ɾ a̠ k̚
렌즈	ɾ e̞ ɲ d͡ʑ ɯ
숲들쥐	sʰ u p̚ t͈ ɯ ʎ d͡ʑ ɥ i
연안	j ʌ̹ n a̠ n
옛한글	j e̞ː tʰ a̠ n ɡ ɯ ɭ
관점	k w a̠ ɲ t͡ɕ͈ ʌ̹ m
야레	j a̠ ɾ e̞
굶기다	k u m ɡ i d a̠
동네	t o̞ː ŋ n e̞
슈퍼마켓	ɕʰ u pʰ ʌ̹ m a̠ kʰ e̞ t̚
민첩성	m i ɲ t͡ɕʰ ʌ̹ p s͈ ʌ̹ ŋ
기술	k i sʰ u ɭ
기쁘다	k i p͈ ɯ d a̠
성부	sʰ ɘː ŋ b u
어저께	ʌ̹ d͡ʑ ʌ̹ k͈ e̞
반듯이	p a̠ n d ɯ ɕʰ i
제의	t͡ɕ e̞ ɰ i
아이슬란드어	a̠ i sʰ ɯ ɭ ɭ a̠ n d ɯ ʌ̹
윤회	j u n β w e̞
어느	ʌ̹ n ɯ
남체	n a̠ m t͡ɕʰ e̞
가로	k a̠ ɾ o̞
음향	ɯ m ʝ j a̠ ŋ
배달	p ɛː d a̠ ɭ
국왕	k u ɡ w a̠ ŋ
기시감	k i ɕʰ i ɡ a̠ m
사랑스럽다	sʰ a̠ ɾ a̠ ŋ sʰ ɯ ɾ ʌ̹ p̚ t͈ a̠
제쳐놓다	t͡ɕ e̞ t͡ɕʰ ʌ̹ n o̞ tʰ a̠
엄	ʌ̹ m
쯔놈	t͡ɕ͈ ɯ n o̞ m
피로	pʰ i ɾ o̞
양식	j a̠ ŋ ɕʰ i k̚
외출하다	w e̞ː t͡ɕʰ u ɾ ɦ a̠ d a̠
네모	n e̞ː m o̞
콤플렉스	kʰ o̞ m pʰ ɯ ɭ ɭ e̞ k s͈ ɯ
수의사	sʰ u ɰ i sʰ a̠
국유화	k uː ɡ j u β w a̠
시작	ɕʰ iː d͡ʑ a̠ k̚
돋우다	t o̞ d u d a̠
병아	p j ɘː ŋ a̠
권리	k w ʌ̹ ʎ ʎ i
추진하다	t͡ɕʰ u d͡ʑ i n ɦ a̠ d a̠
얽다	ʌ̹ k̚ t͈ a̠
짜	t͡ɕ͈ a̠
일월	i ɾ w ʌ̹ ɭ
그만	k ɯ m a̠ n
영원	j ɘː ŋ w ʌ̹ n
귀밑	k ɥ i m i t̚
올바르다	o̞ ɭ b a̠ ɾ ɯ d a̠
오타쿠	o̞ tʰ a̠ kʰ u
절망	t͡ɕ ʌ̹ ɭ m a̠ ŋ
정크푸드	t͡ɕ ʌ̹ ŋ k x ɯ pʰ u d ɯ
갖다	k a̠ t̚ t͈ a̠
지읒	t͡ɕ i ɯ t̚
무덤	m u d ʌ̹ m
커다랗다	kʰ ɘː d a̠ ɾ a̠ tʰ a̠
네팔	n e̞ pʰ a̠ ɭ
말기	m a̠ ɭ ɡ i
몽골	m o̞ ŋ ɡ o̞ ɭ
뿌리	p͈ u ɾ i
례	ɾ j e̞
벽력	p j ʌ̹ ŋ ɲ j ʌ̹ k̚
세포	sʰ e̞ː pʰ o̞
페닐기	pʰ e̞ n i ɭ ɡ i
주변	t͡ɕ u b j ʌ̹ n
체리	t͡ɕʰ e̞ ɾ i
우승	u sʰ ɯ ŋ
진실	t͡ɕ i n ɕʰ i ɭ
둘	t uː ɭ
뜨겁다	t͈ ɯ ɡ ʌ̹ p̚ t͈ a̠
축축하다	t͡ɕʰ u k̚ t͡ɕʰ u kʰ a̠ d a̠
아첨하다	a̠ t͡ɕʰ ʌ̹ m ɦ a̠ d a̠
득점	t ɯ k̚ t͡ɕ͈ ʌ̹ m
교포	k j o pʰ o̞
졸리다	t͡ɕ o̞ ʎ ʎ i d a̠
뼠	p͈ j ʌ̹ k̚
다	t a̠ː
가수	k a̠ sʰ u
낮다	n a̠ t̚ t͈ a̠
박람회	p a̠ ŋ n a̠ m β w e̞
논하다	n o̞ n ɦ a̠ d a̠
공통점	k o̞ː ŋ tʰ o̞ ŋ t͡ɕ͈ ʌ̹ m
일쑤	i ɭ s͈ u
아요	a̠ j o
벤젠	p e̞ ɲ d͡ʑ e̞ n
주제	t͡ɕ u d͡ʑ e̞
여과기	j ɘː ɡ w a̠ ɡ i
침입	t͡ɕʰ iː m i p̚
윗	ɥ i t̚
차고	t͡ɕʰ a̠ ɡ o̞
고조	k o̞ d͡ʑ o̞
찰밥	t͡ɕʰ a̠ ɭ b a̠ p̚
은어	ɯ n ʌ̹
신분증	ɕʰ i n b u ɲ t͡ɕ͈ ɯ ŋ
늙다	n ɯ k̚ t͈ a̠
구조	k u d͡ʑ o̞
외심	w e̞ː ɕʰ i m
시장	ɕʰ iː d͡ʑ a̠ ŋ
슬픔	sʰ ɯ ɭ pʰ ɯ m
쒀이러우	s͈ w ʌ̹ i ɾ ʌ̹ u
지식인	t͡ɕ i ɕʰ i ɡ i n
면허증	m j ɘː n ɦ ʌ̹ t͡ɕ͈ ɯ ŋ
배경	p ɛː ɡ j ʌ̹ ŋ
당면	t a̠ ŋ m j ʌ̹ n
트러스트	tʰ ɯ ɾ ʌ̹ sʰ ɯ tʰ ɯ
카나리아	kʰ a̠ n a̠ ɾ i a̠
흗	x ɯ t̚
호주	ɸʷ o̞ d͡ʑ u
우화	uː β w a̠
반올림	p a̠ː n o̞ ʎ ʎ i m
육필	j u k̚ pʰ i ɭ
봄	p o̞ m
역사가	j ʌ̹ k s͈ a̠ ɡ a̠
부여하다	p uː j ʌ̹ ɦ a̠ d a̠
뿌옇다	p͈ uː j ʌ̹ tʰ a̠
담벼락	t a̠ m p͈ j ʌ̹ ɾ a̠ k̚
영혼	j ʌ̹ ŋ β o̞ n
텔루륨	tʰ e̞ ɭ ɭ u ɾ j u m
까맣다	k͈ a̠ː m a̠ tʰ a̠
아웃	a̠ u t̚
유탄	j u tʰ a̠ n
예문	j e̞ː m u n
두발	t u b a̠ ɭ
열등	j ʌ̹ ɭ d ɯ ŋ
감사	k a̠ː m sʰ a̠
탁구	tʰ a̠ k̚ k͈ u
혹부리오리	ɸʷ o̞ k̚ p͈ u ɾ i o̞ ɾ i
민속	m i n sʰ o̞ k̚
가공	k a̠ ɡ o̞ ŋ
간첩	k a̠ː ɲ t͡ɕʰ ʌ̹ p̚
케냐	kʰ e̞ ɲ j a̠
변호사	p j ɘː n β o̞ sʰ a̠
치어리더	t͡ɕʰ i ʌ̹ ɾ i d ʌ̹
태도	tʰ ɛː d o̞
보고서	p o̞ː ɡ o̞ sʰ ʌ̹
모터	m o̞ tʰ ʌ̹
주머니칼	t͡ɕ u m ʌ̹ n i kʰ a̠ ɭ
법령	p ʌ̹ m ɲ j ʌ̹ ŋ
머루	m ʌ̹ ɾ u
요충	j o t͡ɕʰ u ŋ
구체적	k u t͡ɕʰ e̞ d͡ʑ ʌ̹ k̚
참회	t͡ɕʰ a̠ m β w e̞
트로이카	tʰ ɯ ɾ o̞ i kʰ a̠
가제따	k a̠ d͡ʑ e̞ t͈ a̠
이별	i b j ʌ̹ ɭ
정상위	t͡ɕ ʌ̹ ŋ sʰ a̠ ŋ ɥ i
국자	k u k̚ t͡ɕ͈ a̠
그림자	k ɯː ɾ i m d͡ʑ a̠
회장	ɸ w e̞ː d͡ʑ a̠ ŋ
포근하다	pʰ o̞ ɡ ɯ n ɦ a̠ d a̠
굽다	k u p̚ t͈ a̠
쳐다보다	t͡ɕʰ ɘː d a̠ b o̞ d a̠
정자	t͡ɕ ʌ̹ ŋ d͡ʑ a̠
참고	t͡ɕʰ a̠ m ɡ o̞
화평	ɸ w a̠ pʰ j ʌ̹ ŋ
전시하다	t͡ɕ ɘː n ɕʰ i ɦ a̠ d a̠
이터븀	i tʰ ʌ̹ b j u m
청첩장	t͡ɕʰ ɘː ŋ t͡ɕʰ ʌ̹ p̚ t͡ɕ͈ a̠ ŋ
벽장	p j ʌ̹ k̚ t͡ɕ͈ a̠ ŋ
속속들이	sʰ o̞ k s͈ o̞ k̚ t͈ ɯ ɾ i
성탄절	sʰ ɘː ŋ tʰ a̠ ɲ d͡ʑ ʌ̹ ɭ
그렇지	k ɯ ɾ ʌ̹ t͡ɕʰ i
이것	i ɡ ʌ̹ t̚
둥글다	t u ŋ ɡ ɯ ɭ d a̠
요금	j oː ɡ ɯ m
파동함수	pʰ a̠ d o̞ ŋ ɦ a̠ m sʰ u
작성하다	t͡ɕ a̠ k s͈ ʌ̹ ŋ ɦ a̠ d a̠
옴쌀	o̞ m s͈ a̠ ɭ
통칭	tʰ o̞ː ŋ t͡ɕʰ i ŋ
성자	sʰ ɘː ŋ d͡ʑ a̠
도저히	t o̞ː d͡ʑ ʌ̹ ʝ i
저절로	t͡ɕ ʌ̹ d͡ʑ ʌ̹ ɭ ɭ o̞
지혜서	t͡ɕ i ʝ j e̞ sʰ ʌ̹
유비무환	j uː b i m u β w a̠ n
돌연	t o̞ ɾ j ʌ̹ n
과떼말라	k w a̠ t͈ e̞ m a̠ ɭ ɭ a̠
쐬다	s͈ w e̞ː d a̠
남서부	n a̠ m sʰ ʌ̹ b u
금속	k ɯ m sʰ o̞ k̚
감사합니다	k a̠ː m sʰ a̠ ɦ a̠ m n i d a̠
스티커	sʰ ɯ tʰ i kʰ ʌ̹
삼위일체	sʰ a̠ m ɥ i i ʎ t͡ɕʰ e̞
한담	h a̠ n d a̠ m
경험	k j ʌ̹ ŋ ɦ ʌ̹ m
튀기다	tʰ ɥ i ɡ i d a̠
누들	n u d ɯ ɭ
원칙	w ʌ̹ ɲ t͡ɕʰ i k̚
외아들	w e̞ a̠ d ɯ ɭ
상담	sʰ a̠ ŋ d a̠ m
우리나라	u ɾ i n a̠ ɾ a̠
용감	j oː ŋ ɡ a̠ m
월세	w ʌ̹ ɭ s͈ e̞
흑두루미	x ɯ k̚ t͈ u ɾ u m i
세가락메추라기	sʰ e̞ː ɡ a̠ ɾ a̠ ŋ m e̞ t͡ɕʰ u ɾ a̠ ɡ i
헬스	h e̞ ɭ sʰ ɯ
여러	j ʌ̹ ɾ ʌ̹
신포	ɕʰ i n pʰ o̞
처	t͡ɕʰ ʌ̹
고독	k o̞ d o̞ k̚
프놈펜	pʰ ɯ n o̞ m pʰ e̞ n
이전	iː d͡ʑ ʌ̹ n
스파게티	sʰ ɯ pʰ a̠ ɡ e̞ tʰ i
벤질기	p e̞ ɲ d͡ʑ i ɭ ɡ i
기독교	k i d o̞ k̚ k͈ j o
양국	j a̠ ŋ ɡ u k̚
오세아니아	o̞ sʰ e̞ a̠ n i a̠
사람	sʰ a̠ː ɾ a̠ m
조산사	t͡ɕ o̞ː sʰ a̠ n sʰ a̠
라침반	ɾ a̠ t͡ɕʰ i m b a̠ n
중요성	t͡ɕ uː ŋ j o sʰ ʌ̹ ŋ
창문	t͡ɕʰ a̠ ŋ m u n
만족하다	m a̠ ɲ d͡ʑ o̞ kʰ a̠ d a̠
농사	n o̞ ŋ sʰ a̠
쉽사리	ʃʰ ɥ iː p s͈ a̠ ɾ i
프탈레인	pʰ ɯ tʰ a̠ ɭ ɭ e̞ i n
성구	sʰ ʌ̹ ŋ k͈ u
미국오리	m i ɡ u ɡ o̞ ɾ i
한양	h a̠ː ɲ j a̠ ŋ
기쁨조	k i p͈ ɯ m d͡ʑ o̞
가름	k a̠ ɾ ɯ m
노어	n o̞ ʌ̹
러시아어	ɾ ʌ̹ ɕʰ i a̠ ʌ̹
국회	k u kʰ w e̞
시나리오	ɕʰ i n a̠ ɾ i o̞
제	t͡ɕ e̞
조사	t͡ɕ o̞ sʰ a̠
여드레	j ʌ̹ d ɯ ɾ e̞
탄자니아	tʰ a̠ ɲ d͡ʑ a̠ n i a̠
관계어	k w a̠ n ɡ j e̞ ʌ̹
뵈다	p w e̞ː d a̠
피스타치오	pʰ i sʰ ɯ tʰ a̠ t͡ɕʰ i o̞
쪽발이	t͡ɕ͈ o̞ k̚ p͈ a̠ ɾ i
검증	k ɘː m d͡ʑ ɯ ŋ
추천	t͡ɕʰ u t͡ɕʰ ʌ̹ n
다	t a̠
참가	t͡ɕʰ a̠ m ɡ a̠
과즙	k w a̠ː d͡ʑ ɯ p̚
예식	j e̞ ɕʰ i k̚
알레고리	a̠ ɭ ɭ e̞ ɡ o̞ ɾ i
팔각	pʰ a̠ ɭ ɡ a̠ k̚
밑	m i t̚
서법	sʰ ʌ̹ b ʌ̹ p̚
바퀴	p a̠ kʰ ɥ i
열화학	j ɘː ɾ β w a̠ ɦ a̠ k̚
구덩이	k u d ʌ̹ ŋ i
총각김치	t͡ɕʰ o̞ ŋ ɡ a̠ k̚ k͈ i m t͡ɕʰ i
넘다	n ɘː m t͈ a̠
넘치다	n ɘː m t͡ɕʰ i d a̠
시인	ɕʰ i i n
선화	sʰ ʌ̹ n β w a̠
인도네시아	i n d o̞ n e̞ ɕʰ i a̠
셀로판	sʰ e̞ ɭ ɭ o̞ pʰ a̠ n
닭갈비	t a̠ k̚ k͈ a̠ ɭ b i
사냥꾼	sʰ a̠ ɲ j a̠ ŋ k͈ u n
바나나	p͈ a̠ n a̠ n a̠
도살장	t o̞ sʰ a̠ ʎ t͡ɕ͈ a̠ ŋ
도난	t o̞ n a̠ n
비골	p iː ɡ o̞ ɭ
누악쇼트	n u a̠ k ɕ͈ o tʰ ɯ
적용하다	t͡ɕ ʌ̹ ɡ j o ŋ ɦ a̠ d a̠
참전	t͡ɕʰ a̠ m d͡ʑ ʌ̹ n
아실기	a̠ ɕʰ i ɭ ɡ i
옥탑	o̞ k̚ tʰ a̠ p̚
워낙	w ʌ̹ n a̠ k̚
암살	a̠ m sʰ a̠ ɭ
엄니	ɘː m n i
입맞추다	i m m a̠ t̚ t͡ɕʰ u d a̠
계량기	k j e̞ ɾ j a̠ ŋ ɡ i
구십	k u ɕʰ i p̚
갈고	k a̠ ɭ ɡ o̞
아유	a̠ j u
마크	m a̠ k x ɯ
다리	t a̠ ɾ i
척추동물	t͡ɕʰ ʌ̹ k̚ t͡ɕʰ u d o̞ ŋ m u ɭ
후보	ɸʷ u b o̞
거주	k ʌ̹ d͡ʑ u
존경하다	t͡ɕ o̞ n ɡ j ʌ̹ ŋ ɦ a̠ d a̠
리그	ɾ i ɡ ɯ
내심	n ɛː ɕʰ i m
머저리	m ʌ̹ d͡ʑ ʌ̹ ɾ i
탈출하다	tʰ a̠ ʎ t͡ɕʰ u ɾ ɦ a̠ d a̠
젊다	t͡ɕ ɘː m t͈ a̠
가정	k a̠ː d͡ʑ ʌ̹ ŋ
군	k u n
헤르츠	h e̞ ɾ ɯ t͡ɕʰ ɯ
저승	t͡ɕ ʌ̹ sʰ ɯ ŋ
들리다	t ɯ ʎ ʎ i d a̠
꿰다	k͈ w e̞ː d a̠
멀쩡하다	m ʌ̹ ʎ t͡ɕ͈ ʌ̹ ŋ ɦ a̠ d a̠
살펴보다	sʰ a̠ ɭ pʰ j ʌ̹ b o̞ d a̠
박테리아	p a̠ k̚ tʰ e̞ ɾ i a̠
모퉁이	m o̞ tʰ u ŋ i
끼다	k͈ i d a̠
영도자	j ʌ̹ ŋ d o̞ d͡ʑ a̠
학습	h a̠ k s͈ ɯ p̚
점포	t͡ɕ ɘː m pʰ o̞
경고하다	k j ɘː ŋ ɡ o̞ ɦ a̠ d a̠
작용하다	t͡ɕ a̠ ɡ j o ŋ ɦ a̠ d a̠
블라우스	p ɯ ɭ ɭ a̠ u sʰ ɯ
야회	j a̠ː β w e̞
장군	t͡ɕ a̠ ŋ ɡ u n
땀	t͈ a̠ m
버찌	p ʌ̹ t͡ɕ͈ i
가자	k a̠ d͡ʑ a̠
사회주의	sʰ a̠ β w e̞ d͡ʑ u ɰ i
연루	j ʌ̹ ɭ ɭ u
오크로시카	o̞ k x ɯ ɾ o̞ ɕʰ i kʰ a̠
춥다	t͡ɕʰ u p̚ t͈ a̠
오히려	o̞ ʝ i ɾ j ʌ̹
우동	u d o̞ ŋ
출혈	t͡ɕʰ u ɾ ʝ j ʌ̹ ɭ
지피다	t͡ɕ i pʰ i d a̠
망아지	m a̠ ŋ a̠ d͡ʑ i
보신탕	p o̞ː ɕʰ i n tʰ a̠ ŋ
광장	k w a̠ː ŋ d͡ʑ a̠ ŋ
인식하다	i n ɕʰ i kʰ a̠ d a̠
설화	sʰ ʌ̹ ɾ β w a̠
마르크스주의	m a̠ ɾ ɯ k x ɯ sʰ ɯ d͡ʑ u ɰ i
우러르다	u ɾ ʌ̹ ɾ ɯ d a̠
나프타	n a̠ pʰ ɯ tʰ a̠
체포	t͡ɕʰ e̞ pʰ o̞
여친	j ʌ̹ t͡ɕʰ i n
토고	tʰ o̞ ɡ o̞
외	w e̞
지속적	t͡ɕ i sʰ o̞ k̚ t͡ɕ͈ ʌ̹ k̚
ㅢ	ɰ i
기억하다	k i ʌ̹ kʰ a̠ d a̠
프런트	pʰ ɯ ɾ ʌ̹ n tʰ ɯ
카바레	kʰ a̠ b a̠ ɾ e̞
친선도시	t͡ɕʰ i n sʰ ʌ̹ n d o̞ ɕʰ i
인명	i n m j ʌ̹ ŋ
벌기다	p ʌ̹ ɭ ɡ i d a̠
메	m e̞
글피	k ɯ ɭ pʰ i
아니야	a̠ n i j a̠
략어	ɾ j a̠ ɡ ʌ̹
가락	k a̠ ɾ a̠ k̚
미치광이	m i t͡ɕʰ i ɡ w a̠ ŋ i
한겨레	h a̠ n ɡ j ʌ̹ ɾ e̞
안목	a̠ n m o̞ k̚
귓결	k ɥ i t̚ k͈ j ʌ̹ ɭ
아련히	a̠ ɾ j ʌ̹ n ʝ i
여당	j ɘː d a̠ ŋ
인티파다	i n tʰ i pʰ a̠ d a̠
역할	j ʌ̹ kʰ a̠ ɭ
포르투갈	pʰ o̞ ɾ ɯ tʰ u ɡ a̠ ɭ
민낯	m i n n a̠ t̚
폭파	pʰ o̞ k̚ pʰ a̠
기아	k i a̠
탈륨	tʰ a̠ ʎ ʎ j u m
마스크	m a̠ sʰ ɯ k x ɯ
프랑스어	pʰ ɯ ɾ a̠ ŋ sʰ ɯ ʌ̹
티라노사우루스	tʰ i ɾ a̠ n o̞ sʰ a̠ u ɾ u sʰ ɯ
부쿠레슈티	p u kʰ u ɾ e̞ ɕʰ u tʰ i
지적되다	t͡ɕ i d͡ʑ ʌ̹ k̚ t͈ w e̞ d a̠
기학	k iː ɦ a̠ k̚
ㅚ	w e̞
설	sʰ ʌ̹ ɭ
부위	p u ɥ i
하물	h a̠ m u ɭ
공통	k o̞ː ŋ tʰ o̞ ŋ
와트	w a̠ tʰ ɯ
라고	ɾ a̠ ɡ o̞
아티초크	a̠ tʰ i t͡ɕʰ o̞ k x ɯ
권고하다	k w ɘː n ɡ o̞ ɦ a̠ d a̠
림	ɾ i m
산호	sʰ a̠ n β o̞
앓이	a̠ ɾ i
조례	t͡ɕ o̞ ɾ j e̞
대검집	t ɛː ɡ ʌ̹ m d͡ʑ i p̚
알렉산드리아	a̠ ɭ ɭ e̞ k s͈ a̠ n d ɯ ɾ i a̠
세로	sʰ e̞ː ɾ o̞
우주인	uː d͡ʑ u i n
소지하다	sʰ o̞ d͡ʑ i ɦ a̠ d a̠
토욕혼	tʰ o̞ j o kʰ o̞ n
판도라	pʰ a̠ n d o̞ ɾ a̠
녹음기	n o̞ ɡ ɯ m ɡ i
사라예보	sʰ a̠ ɾ a̠ j e̞ b o̞
쓰리	s͈ ɯ ɾ i
스웨리예	sʰ ɯ w e̞ ɾ i j e̞
평야	pʰ j ʌ̹ ŋ j a̠
마침	m a̠ t͡ɕʰ i m
사구	sʰ a̠ ɡ u
인문학	i n m u n ɦ a̠ k̚
뒷다리	t ɥ i t̚ t͈ a̠ ɾ i
대장	t ɛː d͡ʑ a̠ ŋ
호프	ɸʷ o̞ pʰ ɯ
밀크	m i ɭ k x ɯ
가하다	k a̠ː ɦ a̠ d a̠
루시	ɾ u ɕʰ i
웬일	w e̞ː n n i ɭ
부탁	p uː tʰ a̠ k̚
소방서	sʰ o̞ b a̠ ŋ sʰ ʌ̹
트롤리버스	tʰ ɯ ɾ o̞ ʎ ʎ i b ʌ̹ sʰ ɯ
파라오	pʰ a̠ ɾ a̠ o̞
상호	sʰ a̠ ŋ β o̞
얼룩	ʌ̹ ɭ ɭ u k̚
쌍시옷	s͈ a̠ ŋ ɕʰ i o̞ t̚
파라솔	pʰ a̠ ɾ a̠ sʰ o̞ ɭ
너희	n ʌ̹ ʝ i
빙	p i ŋ
고집	k o̞ d͡ʑ i p̚
말뚝망둥어	m a̠ ɭ t͈ u ŋ m a̠ ŋ d u ŋ ʌ̹
그르다	k ɯ ɾ ɯ d a̠
숨쉬다	sʰ u m ʃʰ ɥ i d a̠
물질	m u ʎ t͡ɕ͈ i ɭ
간질	k a̠ː ɲ d͡ʑ i ɭ
허락	h ʌ̹ ɾ a̠ k̚
카복실산	kʰ a̠ b o̞ k ɕ͈ i ɭ sʰ a̠ n
녀신	ɲ j ʌ̹ ɕʰ i n
인도차이나	i n d o̞ t͡ɕʰ a̠ i n a̠
포화	pʰ o̞ː β w a̠
평지	pʰ j ʌ̹ ŋ d͡ʑ i
피시	pʰ i ɕ͈ i
겪다	k j ʌ̹ k̚ t͈ a̠
동거	t o̞ ŋ ɡ ʌ̹
극동	k ɯ k̚ t͈ o̞ ŋ
과식	k w a̠ː ɕʰ i k̚
양곤	j a̠ ŋ ɡ o̞ n
싸움터	s͈ a̠ u m tʰ ʌ̹
가다	k a̠ d a̠
알파	a̠ ɭ pʰ a̠
마작	m a̠ː d͡ʑ a̠ k̚
낙엽	n a̠ ɡ j ʌ̹ p̚
더욱	t ʌ̹ u k̚
밤낮	p a̠ m n a̠ t̚
두꺼비	t u k͈ ʌ̹ b i
참을성	t͡ɕʰ a̠ m ɯ ɭ sʰ ʌ̹ ŋ
에미리트	e̞ m i ɾ i tʰ ɯ
몽구스	m o̞ ŋ ɡ u sʰ ɯ
화폐	ɸ w a̠ː pʰ j e̞
후과	ɸʷ u ɡ w a̠
테구시갈파	tʰ e̞ ɡ u ɕʰ i ɡ a̠ ɭ pʰ a̠
언급하다	ʌ̹ n ɡ ɯ pʰ a̠ d a̠
네온	n e̞ o̞ n
소나타	sʰ o̞ n a̠ tʰ a̠
우롱차	u ɾ o̞ ŋ t͡ɕʰ a̠
만성	m a̠ n sʰ ʌ̹ ŋ
경로	k j ʌ̹ ŋ n o̞
해양	h ɛː j a̠ ŋ
뒷면	t ɥ iː n m j ʌ̹ n
똑바로	t͈ o̞ k̚ p͈ a̠ ɾ o̞
원장	w ʌ̹ ɲ d͡ʑ a̠ ŋ
복스럽다	p o̞ k s͈ ɯ ɾ ʌ̹ p̚ t͈ a̠
비잔티온	p i d͡ʑ a̠ n tʰ i o̞ n
그릴	k ɯ ɾ i ɭ
카페테리아	kʰ a̠ pʰ e̞ tʰ e̞ ɾ i a̠
글라스노스트	k ɯ ɭ ɭ a̠ sʰ ɯ n o̞ sʰ ɯ tʰ ɯ
조선	t͡ɕ o̞ sʰ ʌ̹ n
경관	k j ʌ̹ ŋ ɡ w a̠ n
가득	k a̠ d ɯ k̚
머리띠	m ʌ̹ ɾ i t͈ i
필수적	pʰ i ɭ s͈ u d͡ʑ ʌ̹ k̚
나물	n a̠ m u ɭ
골상학	k o̞ ɭ sʰ a̠ ŋ ɦ a̠ k̚
변수	p j ɘː n sʰ u
투르크멘어	tʰ u ɾ ɯ k x ɯ m e̞ n ʌ̹
프로세스	pʰ ɯ ɾ o̞ sʰ e̞ sʰ ɯ
자존심	t͡ɕ a̠ d͡ʑ o̞ n ɕʰ i m
쿠웨이트	kʰ u w e̞ i tʰ ɯ
거두다	k ʌ̹ d u d a̠
회전목마	ɸ w e̞ d͡ʑ ʌ̹ n m o̞ ŋ m a̠
브라우저	p ɯ ɾ a̠ u d͡ʑ ʌ̹
필요하다	pʰ i ɾ j o ɦ a̠ d a̠
콘돔	kʰ o̞ n d o̞ m
여보	j ʌ̹ b o̞
디바이스	t i b a̠ i sʰ ɯ
오십	o̞ː ɕʰ i p̚
ㅣ	i
호사	ɸʷ o̞ sʰ a̠
도료	t o̞ ɾ j o
건축학	k ɘː ɲ t͡ɕʰ u kʰ a̠ k̚
문화	m u n β w a̠
뼉	p͈ j ʌ̹ k̚
말똥가리	m a̠ ɭ t͈ o̞ ŋ ɡ a̠ ɾ i
뼟	p͈ j ʌ̹ t̚
겨자	k j ʌ̹ d͡ʑ a̠
들꿩	t ɯ ɭ k͈ w ʌ̹ ŋ
찌르다	t͡ɕ͈ i ɾ ɯ d a̠
보수	p o̞ː sʰ u
위협	ɥ i ʝ j ʌ̹ p̚
줄망둑	t͡ɕ u ɭ m a̠ ŋ d u k̚
주교관	t͡ɕ u ɡ j o ɡ w a̠ n
탁	tʰ a̠ k̚
텐	tʰ e̞ n
뽕	p͈ o̞ ŋ
상스럽다	sʰ a̠ ŋ sʰ ɯ ɾ ʌ̹ p̚ t͈ a̠
기관	k i ɡ w a̠ n
짐작하다	t͡ɕ i m d͡ʑ a̠ kʰ a̠ d a̠
신라	ɕʰ i ɭ ɭ a̠
도예	t o̞ j e̞
마련되다	m a̠ ɾ j ʌ̹ n d w e̞ d a̠
가물치	k a̠ m u ʎ t͡ɕʰ i
열목어	j ʌ̹ ɭ m o̞ ɡ ʌ̹
초록빛	t͡ɕʰ o̞ ɾ o̞ k̚ p͈ i t̚
수녀	sʰ u ɲ j ʌ̹
최후	t͡ɕʰ w e̞ː β u
미니스커트	m i n i sʰ ɯ kʰ ʌ̹ tʰ ɯ
어디	ʌ̹ d i
돌잡이	t o̞ ʎ d͡ʑ a̠ b i
도도마	t o̞ d o̞ m a̠
골프	k͈ o̞ ɭ pʰ ɯ
끓다	k͈ ɯ ɭ tʰ a̠
가라앉다	k a̠ ɾ a̠ a̠ n t͈ a̠
구속	k u sʰ o̞ k̚
가따까나	k a̠ t͈ a̠ k͈ a̠ n a̠
득녀	t ɯ ŋ ɲ j ʌ̹
아포스트로피	a̠ pʰ o̞ sʰ ɯ tʰ ɯ ɾ o̞ pʰ i
나이로비	n a̠ i ɾ o̞ b i
화병	ɸ w a̠ː p͈ j ʌ̹ ŋ
쓰똘	s͈ ɯ t͈ o̞ ɭ
하마	h a̠ m a̠
송림	sʰ o̞ ŋ n i m
동일	t o̞ ŋ i ɭ
주고받다	t͡ɕ u ɡ o̞ b a̠ t̚ t͈ a̠
인질	i ɲ d͡ʑ i ɭ
보리	p o̞ ɾ i
계산하다	k j e̞ː sʰ a̠ n ɦ a̠ d a̠
시설	ɕʰ iː sʰ ʌ̹ ɭ
성년	sʰ ʌ̹ ŋ ɲ j ʌ̹ n
주장	t͡ɕ u d͡ʑ a̠ ŋ
한족	h a̠ː ɲ d͡ʑ o̞ k̚
야드	j a̠ d ɯ
실로	ɕʰ i ɭ ɭ o̞
무한	m u ɦ a̠ n
횡	ɸ w e̞ ŋ
다발	t a̠ b a̠ ɭ
아르테미스	a̠ ɾ ɯ tʰ e̞ m i sʰ ɯ
갈리	k a̠ ʎ ʎ i
이득	iː d ɯ k̚
중국학	t͡ɕ u ŋ ɡ u kʰ a̠ k̚
유도탄	j u d o̞ tʰ a̠ n
트림	tʰ ɯː ɾ i m
괴한	k w e̞ː ɦ a̠ n
맛보다	m a̠ t̚ p͈ o̞ d a̠
볼트	p o̞ ɭ tʰ ɯ
활성탄	ɸ w a̠ ɭ s͈ ʌ̹ ŋ tʰ a̠ n
상권	sʰ a̠ ŋ k͈ w ʌ̹ n
해금	h ɛː ɡ ɯ m
목록	m o̞ ŋ n o̞ k̚
멧밭쥐	m e̞ t̚ p͈ a̠ t̚ t͡ɕ͈ ɥ i
상하다	sʰ a̠ ŋ ɦ a̠ d a̠
비빔밥	p i b i m p͈ a̠ p̚
오온	o̞ o̞ n
자다	t͡ɕ a̠ d a̠
일각수	i ɭ ɡ a̠ k s͈ u
할퀴다	h a̠ ɭ kʰ ɥ i d a̠
증설하다	t͡ɕ ɯ ŋ sʰ ʌ̹ ɾ ɦ a̠ d a̠
올리다	o̞ ʎ ʎ i d a̠
끼치다	k͈ i t͡ɕʰ i d a̠
완곡어법	w a̠ː n ɡ o̞ ɡ ʌ̹ b ʌ̹ p̚
설문지	sʰ ʌ̹ ɭ m u ɲ d͡ʑ i
세상에	sʰ e̞ː sʰ a̠ ŋ e̞
알다	a̠ː ɭ d a̠
여보세요	j ʌ̹ b o̞ sʰ e̞ j o
광시	k w a̠ ŋ ɕʰ i
구치소	k u t͡ɕʰ i sʰ o̞
익다	i k̚ t͈ a̠
크리켓	k x ɯ ɾ i kʰ e̞ t̚
아니하다	a̠ n i ɦ a̠ d a̠
권력	k w ɘː ʎ ʎ j ʌ̹ k̚
수염	sʰ u j ʌ̹ m
수고	sʰ uː ɡ o̞
처녀성	t͡ɕʰ ʌ̹ ɲ j ʌ̹ sʰ ʌ̹ ŋ
합법	h a̠ p̚ p͈ ʌ̹ p̚
탈출	tʰ a̠ ʎ t͡ɕʰ u ɭ
젊음	t͡ɕ ɘː ɭ m ɯ m
자류석	t͡ɕ a̠ ɾ j u sʰ ʌ̹ k̚
흘러가다	x ɯ ɭ ɭ ʌ̹ ɡ a̠ d a̠
폭탄	pʰ o̞ k̚ tʰ a̠ n
터빈	tʰ ʌ̹ b i n
오렌지	o̞ ɾ e̞ ɲ d͡ʑ i
얘기	j ɛː ɡ i
에잇	e̞ i t̚
강사	k a̠ː ŋ sʰ a̠
고치다	k o̞ t͡ɕʰ i d a̠
호주인	ɸʷ o̞ d͡ʑ u i n
신용	ɕʰ iː ɲ j o ŋ
십자선	ɕʰ i p̚ t͡ɕ͈ a̠ sʰ ʌ̹ n
벌레	p ʌ̹ ɭ ɭ e̞
암흑	a̠ː m ɣ ɯ k̚
연말	j ʌ̹ n m a̠ ɭ
이윽고	i ɯ k̚ k͈ o̞
아픔	a̠ pʰ ɯ m
잔류	t͡ɕ a̠ ʎ ʎ j u
벼락	p j ʌ̹ ɾ a̠ k̚
거리다	k ʌ̹ ɾ i d a̠
웅어	u ŋ ʌ̹
황어	ɸ w a̠ ŋ ʌ̹
싸이다	s͈ a̠ i d a̠
아카데미	a̠ kʰ a̠ d e̞ m i
저희	t͡ɕ ʌ̹ ʝ i
화려하다	ɸ w a̠ ɾ j ʌ̹ ɦ a̠ d a̠
포럼	pʰ o̞ ɾ ʌ̹ m
잠	t͡ɕ a̠ m
두반장	t u b a̠ ɲ d͡ʑ a̠ ŋ
느리다	n ɯ ɾ i d a̠
상환되다	sʰ a̠ ŋ β w a̠ n d w e̞ d a̠
페지	pʰ e̞ d͡ʑ i
콜라보레이션	kʰ o̞ ɭ ɭ a̠ b o̞ ɾ e̞ i ɕʰ ʌ̹ n
청소	t͡ɕʰ ʌ̹ ŋ sʰ o̞
퓨라잔	pʰ j u ɾ a̠ d͡ʑ a̠ n
알바	a̠ ɭ b a̠
고춧가루	k o̞ t͡ɕʰ u t̚ k͈ a̠ ɾ u
적확하다	t͡ɕ ʌ̹ kʰ w a̠ kʰ a̠ d a̠
감금	k a̠ m ɡ ɯ m
어차피	ʌ̹ t͡ɕʰ a̠ pʰ i
교사	k j oː sʰ a̠
염려하다	j ɘː m ɲ j ʌ̹ ɦ a̠ d a̠
허물다	h ʌ̹ m u ɭ d a̠
강	k a̠ ŋ
수류탄	sʰ u ɾ j u tʰ a̠ n
듀오	t j u o̞
삼림	sʰ a̠ m n i m
한쪽	h a̠ ɲ t͡ɕ͈ o̞ k̚
박수하다	p a̠ k s͈ u ɦ a̠ d a̠
피크닉	pʰ i k x ɯ n i k̚
짬	t͡ɕ͈ a̠ m
모터보트	m o̞ tʰ ʌ̹ b o̞ tʰ ɯ
신문	ɕʰ i n m u n
아드님	a̠ d ɯ n i m
남벌	n a̠ː m b ʌ̹ ɭ
가벼워지다	k a̠ b j ʌ̹ w ʌ̹ d͡ʑ i d a̠
계단	k j e̞ d a̠ n
끊이다	k͈ ɯ n i d a̠
습득	sʰ ɯ p̚ t͈ ɯ k̚
흐르바쯔까	x ɯ ɾ ɯ b a̠ t͡ɕ͈ ɯ k͈ a̠
천하	t͡ɕʰ ʌ̹ n ɦ a̠
끄집다	k͈ ɯː d͡ʑ i p̚ t͈ a̠
탐정	tʰ a̠ m d͡ʑ ʌ̹ ŋ
되풀이	t w e̞ pʰ u ɾ i
업진	ʌ̹ p̚ t͡ɕ͈ i n
석류석	sʰ ʌ̹ ŋ ɲ j u sʰ ʌ̹ k̚
속속	sʰ o̞ k s͈ o̞ k̚
학위	h a̠ ɡ ɥ i
극복하다	k ɯ k̚ p͈ o̞ kʰ a̠ d a̠
상원	sʰ a̠ː ŋ w ʌ̹ n
만류	m a̠ ʎ ʎ j u
못지않다	m o̞ː t̚ t͡ɕ͈ i a̠ n tʰ a̠
저편	t͡ɕ ʌ̹ pʰ j ʌ̹ n
해방하다	h ɛː b a̠ ŋ ɦ a̠ d a̠
업무	ʌ̹ m m u
추측하다	t͡ɕʰ u t͡ɕʰ ɯ kʰ a̠ d a̠
커리	kʰ ʌ̹ ɾ i
육자진언	j u k̚ t͡ɕ͈ a̠ d͡ʑ i n ʌ̹ n
머그잔	m ʌ̹ ɡ ɯ d͡ʑ a̠ n
벌	p ʌ̹ ɭ
관사	k w a̠ n sʰ a̠
헛방귀	h ʌ̹ t̚ p͈ a̠ ŋ ɡ ɥ i
독사	t o̞ k s͈ a̠
스마트폰	sʰ ɯ m a̠ tʰ ɯ pʰ o̞ n
다녀가다	t a̠ ɲ j ʌ̹ ɡ a̠ d a̠
송장	sʰ o̞ː ŋ d͡ʑ a̠ ŋ
프리타운	pʰ ɯ ɾ i tʰ a̠ u n
라운지	ɾ a̠ u ɲ d͡ʑ i
요사이	j o sʰ a̠ i
수소탄	sʰ u sʰ o̞ tʰ a̠ n
아르곤	a̠ ɾ ɯ ɡ o̞ n
딜리	t i ʎ ʎ i
테헤란	tʰ e̞ ɦ e̞ ɾ a̠ n
책자	t͡ɕʰ ɛː k̚ t͡ɕ͈ a̠
위주	ɥ i d͡ʑ u
제출	t͡ɕ e̞ t͡ɕʰ u ɭ
광명성절	k w a̠ ŋ m j ʌ̹ ŋ sʰ ʌ̹ ŋ d͡ʑ ʌ̹ ɭ
병합	p j ʌ̹ ŋ ɦ a̠ p̚
하야	h a̠ː j a̠
마사지	m a̠ sʰ a̠ d͡ʑ i
모자이크	m o̞ d͡ʑ a̠ i k x ɯ
북빙양	p u k̚ p͈ i ŋ ɲ j a̠ ŋ
뛰어다니다	t͈ ɥ i ʌ̹ d a̠ n i d a̠
대여섯	t ɛː j ʌ̹ sʰ ʌ̹ t̚
이게	i ɡ e̞
빨강	p͈ a̠ ɭ ɡ a̠ ŋ
걸신	k ʌ̹ ɭ ɕ͈ i n
날두하다	n a̠ ɭ d u ɦ a̠ d a̠
라바트	ɾ a̠ b a̠ tʰ ɯ
입맛	i m m a̠ t̚
양자전기역학	j a̠ ŋ d͡ʑ a̠ d͡ʑ ʌ̹ n ɡ i j ʌ̹ kʰ a̠ k̚
글월	k ɯ ɾ w ʌ̹ ɭ
숙	sʰ u k̚
수서	sʰ u sʰ ʌ̹
아크라	a̠ k x ɯ ɾ a̠
들러리	t ɯ ɭ ɭ ʌ̹ ɾ i
미르	m i ɾ ɯ
값어치	k a̠ b ʌ̹ t͡ɕʰ i
종이	t͡ɕ o̞ ŋ i
불빛	p u ɭ p͈ i t̚
지하실	t͡ɕ i ɦ a̠ ɕʰ i ɭ
어금니	ʌ̹ ɡ ɯ m n i
차라리	t͡ɕʰ a̠ ɾ a̠ ɾ i
또	t͈ o̞
그믐날	k ɯ m ɯ m n a̠ ɭ
노쇠	n o̞ː sʰ w e̞
두건	t u ɡ ʌ̹ n
피부	pʰ i b u
곤충학	k o̞ ɲ t͡ɕʰ u ŋ ɦ a̠ k̚
가죽끈	k a̠ d͡ʑ u k̚ k͈ ɯ n
운수	u n sʰ u
가죽	k a̠ d͡ʑ u k̚
고속	k o̞ sʰ o̞ k̚
네오나치	n e̞ o̞ n a̠ t͡ɕʰ i
마사지하다	m a̠ sʰ a̠ d͡ʑ i ɦ a̠ d a̠
신경학	ɕʰ i n ɡ j ʌ̹ ŋ ɦ a̠ k̚
곤돌라	k o̞ n d o̞ ɭ ɭ a̠
팔리다	pʰ a̠ ʎ ʎ i d a̠
원곡	w ʌ̹ n ɡ o̞ k̚
잠들다	t͡ɕ a̠ m d ɯ ɭ d a̠
발인	p a̠ ɾ i n
빛나다	p i n n a̠ d a̠
슬리퍼	sʰ ɯ ʎ ʎ i pʰ ʌ̹
업그레이드	ʌ̹ p̚ k͈ ɯ ɾ e̞ i d ɯ
마약	m a̠ j a̠ k̚
치우	t͡ɕʰ i u
잠수함	t͡ɕ a̠ m sʰ u ɦ a̠ m
교류	k j o ɾ j u
에스터	e̞ sʰ ɯ tʰ ʌ̹
유혈목이	j u ʝ j ʌ̹ ɭ m o̞ ɡ i
탄화수소	tʰ a̠ː n β w a̠ sʰ u sʰ o̞
학원	h a̠ ɡ w ʌ̹ n
양하	j a̠ ŋ ɦ a̠
간체	k a̠ ɲ t͡ɕʰ e̞
유명하다	j uː m j ʌ̹ ŋ ɦ a̠ d a̠
가령	k a̠ː ɾ j ʌ̹ ŋ
무죄	m u d͡ʑ w e̞
순박	sʰ u n b a̠ k̚
끄다	k͈ ɯ d a̠
미술관	m iː sʰ u ɭ ɡ w a̠ n
두	t uː
음경골	ɯ m ɡ j ʌ̹ ŋ ɡ o̞ ɭ
분광기	p u n ɡ w a̠ ŋ ɡ i
폐어	pʰ j e̞ː ʌ̹
화제	ɸ w a̠ d͡ʑ e̞
친선	t͡ɕʰ i n sʰ ʌ̹ n
엿듣다	j ɘː t̚ t͈ ɯ t̚ t͈ a̠
뼣	p͈ j ʌ̹ t̚
흟	x ɯ ɭ
가요	k a̠ j o
한물	h a̠ n m u ɭ
원작	w ʌ̹ ɲ d͡ʑ a̠ k̚
옥석	o̞ k s͈ ʌ̹ k̚
머리카락	m ʌ̹ ɾ i kʰ a̠ ɾ a̠ k̚
아폴론	a̠ pʰ o̞ ɭ ɭ o̞ n
계시다	k j e̞ː ɕʰ i d a̠
자몽	t͡ɕ a̠ m o̞ ŋ
치	t͡ɕʰ i
타이가	tʰ a̠ i ɡ a̠
던지다	t ʌ̹ ɲ d͡ʑ i d a̠
개인적	k ɛː i ɲ d͡ʑ ʌ̹ k̚
악티늄	a̠ k̚ tʰ i ɲ j u m
그리스도	k ɯ ɾ i sʰ ɯ d o̞
가득가득	k a̠ d ɯ k̚ k͈ a̠ d ɯ k̚
하락하다	h a̠ː ɾ a̠ kʰ a̠ d a̠
요즈음	j o d͡ʑ ɯ ɯ m
청설모	t͡ɕʰ ʌ̹ ŋ sʰ ʌ̹ ɭ m o̞
속눈썹	sʰ o̞ː ŋ n u n s͈ ʌ̹ p̚
길다	k iː ɭ d a̠
갈망	k a̠ ɭ m a̠ ŋ
급격하다	k ɯ p̚ k͈ j ʌ̹ kʰ a̠ d a̠
성실	sʰ ʌ̹ ŋ ɕʰ i ɭ
새다	sʰ ɛː d a̠
수음	sʰ u ɯ m
웃음소리	u sʰ ɯ m s͈ o̞ ɾ i
이점	iː d͡ʑ ʌ̹ m
입법	i p̚ p͈ ʌ̹ p̚
기치	k i t͡ɕʰ i
더듬이	t ʌ̹ d ɯ m i
참말	t͡ɕʰ a̠ m m a̠ ɭ
전환	t͡ɕ ɘː n β w a̠ n
걸인	k ʌ̹ ɾ i n
부조리	p u d͡ʑ o̞ ɾ i
밥	p a̠ p̚
눈웃음	n u n u sʰ ɯ m
쟈바	t͡ɕ a̠ b a̠
교탁	k j oː tʰ a̠ k̚
의욕	ɰ iː j o k̚
여의자	j ʌ̹ ɰ i d͡ʑ a̠
후추	ɸʷ u t͡ɕʰ u
룰렛	ɾ u ɭ ɭ e̞ t̚
숨지다	sʰ uː m d͡ʑ i d a̠
콘도미니엄	kʰ o̞ n d o̞ m i n i ʌ̹ m
서양자두	sʰ ʌ̹ j a̠ ŋ d͡ʑ a̠ d u
게릴라	k e̞ ɾ i ɭ ɭ a̠
쇼	ɕ͈ o
인플레이션	i n pʰ ɯ ɭ ɭ e̞ i ɕʰ ʌ̹ n
체계	t͡ɕʰ e̞ ɡ j e̞
해도	h ɛː d o̞
소방관	sʰ o̞ b a̠ ŋ ɡ w a̠ n
대지	t ɛː d͡ʑ i
날짐승	n a̠ ʎ t͡ɕ͈ i m sʰ ɯ ŋ
부추기다	p uː t͡ɕʰ u ɡ i d a̠
꽁치	k͈ o̞ ŋ t͡ɕʰ i
헷갈리다	h e̞ t̚ k͈ a̠ ʎ ʎ i d a̠
바다비오리	p a̠ d a̠ b i o̞ ɾ i
밉다	m iː p̚ t͈ a̠
대령	t ɛː ɾ j ʌ̹ ŋ
철갑	t͡ɕʰ ʌ̹ ɭ ɡ a̠ p̚
모오케	m o̞ o̞ kʰ e̞
나뭇가지	n a̠ m u t̚ k͈ a̠ d͡ʑ i
돈	t o̞ n
파동	pʰ a̠ d o̞ ŋ
사립	sʰ a̠ ɾ i p̚
후회	ɸʷ uː β w e̞
물론	m u ɭ ɭ o̞ n
번역가	p ʌ̹ ɲ j ʌ̹ k̚ k͈ a̠
기저	k i d͡ʑ ʌ̹
거북	k ʌ̹ b u k̚
졸업	t͡ɕ o̞ ɾ ʌ̹ p̚
전선	t͡ɕ ɘː n sʰ ʌ̹ n
결과	k j ʌ̹ ɭ ɡ w a̠
안쪽	a̠ ɲ t͡ɕ͈ o̞ k̚
하이드록실아민	h a̠ i d ɯ ɾ o̞ k ɕ͈ i ɾ a̠ m i n
뒷모습	t ɥ iː n m o̞ sʰ ɯ p̚
살결물	sʰ a̠ ɭ k͈ j ʌ̹ ɭ m u ɭ
이단	iː d a̠ n
복도	p o̞ k̚ t͈ o̞
우표	u pʰ j o
무인점포	m u i ɲ d͡ʑ ʌ̹ m pʰ o̞
고지	k o̞ d͡ʑ i
워	w ʌ̹
스푸트니크	sʰ ɯ pʰ u tʰ ɯ n i k x ɯ
미라	m i ɾ a̠
비루스	p i ɾ u sʰ ɯ
두께	t u k͈ e̞
벗다	p ʌ̹ t̚ t͈ a̠
이스마엘	i sʰ ɯ m a̠ e̞ ɭ
살림	sʰ a̠ ʎ ʎ i m
기례기	k i ɾ j e̞ ɡ i
균형	k j u n ʝ j ʌ̹ ŋ
리옹	ɾ i o̞ ŋ
다방	t a̠ b a̠ ŋ
지라	t͡ɕ i ɾ a̠
마멀레이드	m a̠ m ʌ̹ ɭ ɭ e̞ i d ɯ
소농	sʰ o̞ː n o̞ ŋ
토마스	tʰ o̞ m a̠ sʰ ɯ
환전	ɸ w a̠ ɲ d͡ʑ ʌ̹ n
천식	t͡ɕʰ ɘː n ɕʰ i k̚
붓다	p uː t̚ t͈ a̠
교양	k j o j a̠ ŋ
공구	k o̞ ŋ ɡ u
처녀막	t͡ɕʰ ɘː ɲ j ʌ̹ m a̠ k̚
상완이두근	sʰ a̠ ŋ w a̠ n i d u ɡ ɯ n
신성	ɕʰ i n sʰ ʌ̹ ŋ
비늘	p i n ɯ ɭ
사진술	sʰ a̠ d͡ʑ i n sʰ u ɭ
수줍다	sʰ u d͡ʑ u p̚ t͈ a̠
제주시	t͡ɕ e̞ː d͡ʑ u ɕʰ i
펙	pʰ e̞ k̚
짜하다	t͡ɕ͈ a̠ː ɦ a̠ d a̠
그리다	k ɯː ɾ i d a̠
고약하다	k o̞ː j a̠ kʰ a̠ d a̠
장승	t͡ɕ a̠ ŋ sʰ ɯ ŋ
고삐	k o̞ p͈ i
큰바다사자	k x ɯ n b a̠ d a̠ sʰ a̠ d͡ʑ a̠
변화	p j ɘː n β w a̠
두근거리다	t u ɡ ɯ n ɡ ʌ̹ ɾ i d a̠
눕다	n uː p̚ t͈ a̠
무례	m u ɾ j e̞
전기종합악기	t͡ɕ ʌ̹ n ɡ i d͡ʑ o̞ ŋ ɦ a̠ b a̠ k̚ k͈ i
데려가다	t e̞ ɾ j ʌ̹ ɡ a̠ d a̠
지남석	t͡ɕ i n a̠ m sʰ ʌ̹ k̚
씁쓸하다	s͈ ɯ p s͈ ɯ ɾ ɦ a̠ d a̠
대충	t ɛː t͡ɕʰ u ŋ
짝	t͡ɕ͈ a̠ k̚
고시	k o̞ː ɕʰ i
데메테르	t e̞ m e̞ tʰ e̞ ɾ ɯ
메기	m e̞ː ɡ i
네덜란드	n e̞ d ʌ̹ ɭ ɭ a̠ n d ɯ
런던	ɾ ʌ̹ n d ʌ̹ n
넵투늄	n e̞ p̚ tʰ u ɲ j u m
헤프다	h e̞ː pʰ ɯ d a̠
카이사르	kʰ a̠ i sʰ a̠ ɾ ɯ
노르다	n o̞ ɾ ɯ d a̠
쌍반점	s͈ a̠ ŋ b a̠ ɲ d͡ʑ ʌ̹ m
기물	k i m u ɭ
반절	p a̠ ɲ d͡ʑ ʌ̹ ɭ
폐회식	pʰ j e̞ː β w e̞ ɕʰ i k̚
홈	ɸʷ o̞ m
성교하다	sʰ ɘː ŋ ɡ j o ɦ a̠ d a̠
똥남아	t͈ o̞ ŋ n a̠ m a̠
유용하다	j uː j o ŋ ɦ a̠ d a̠
없었다	ʌ̹ p s͈ ʌ̹ t̚ t͈ a̠
잡초	t͡ɕ a̠ p̚ t͡ɕʰ o̞
사악	sʰ a̠ a̠ k̚
조선	t͡ɕ o̞ː sʰ ʌ̹ n
결심하다	k j ʌ̹ ɭ ɕ͈ i m ɦ a̠ d a̠
지주	t͡ɕ i d͡ʑ u
갈수록	k a̠ ɭ s͈ u ɾ o̞ k̚
비데오	p i d e̞ o̞
연	j ʌ̹ n
품사	pʰ uː m sʰ a̠
부여자	p uː j ʌ̹ d͡ʑ a̠
잊다	i t̚ t͈ a̠
주방장	t͡ɕ u b a̠ ŋ d͡ʑ a̠ ŋ
탑승	tʰ a̠ p s͈ ɯ ŋ
등등	t ɯː ŋ d ɯ ŋ
풍금	pʰ u ŋ ɡ ɯ m
육서	j u k s͈ ʌ̹
한식집	h a̠ n ɕ͈ i k̚ t͡ɕ͈ i p̚
삽	sʰ a̠ p̚
엿	j ɘː t̚
한계	h a̠ː n ɡ j e̞
화보	ɸ w a̠ː b o̞
스위치	sʰ ɯ ɥ i t͡ɕʰ i
받아쓰기	p a̠ d a̠ s͈ ɯ ɡ i
간악하다	k a̠ n a̠ kʰ a̠ d a̠
타이틀곡	tʰ a̠ i tʰ ɯ ɭ ɡ o̞ k̚
수산	sʰ u sʰ a̠ n
괌	k w a̠ m
배추	p ɛː t͡ɕʰ u
진하다	t͡ɕ i n ɦ a̠ d a̠
횡파	ɸ w e̞ ŋ pʰ a̠
신칸센	ɕʰ i n kʰ a̠ n sʰ e̞ n
대성당	t ɛː sʰ ʌ̹ ŋ d a̠ ŋ
부도	p uː d o̞
걸	k ʌ̹ ɭ
구현	k u ʝ j ʌ̹ n
삐뚤다	p͈ i t͈ u ɭ d a̠
계속하다	k j e̞ː sʰ o̞ kʰ a̠ d a̠
촌스럽다	t͡ɕʰ o̞ː n sʰ ɯ ɾ ʌ̹ p̚ t͈ a̠
쉰	ʃʰ ɥ iː n
뾰족하다	p͈ j o d͡ʑ o̞ kʰ a̠ d a̠
가지다	k a̠ d͡ʑ i d a̠
송	sʰ o̞ ŋ
벨라루스	p e̞ ɭ ɭ a̠ ɾ u sʰ ɯ
차원	t͡ɕʰ a̠ w ʌ̹ n
척하다	t͡ɕʰ ʌ̹ kʰ a̠ d a̠
버스	p͈ ʌ̹ sʰ ɯ
동이	t o̞ ŋ i
뼇	p͈ e̞ t̚
학구	h a̠ k̚ k͈ u
헛	h ʌ̹ t̚
나절	n a̠ d͡ʑ ʌ̹ ɭ
해방	h ɛː b a̠ ŋ
수익	sʰ u i k̚
컴퓨터	kʰ ʌ̹ m pʰ j u tʰ ʌ̹
금성	k ɯ m sʰ ʌ̹ ŋ
임무	iː m m u
아리땁다	a̠ ɾ i t͈ a̠ p̚ t͈ a̠
보드	p o̞ d ɯ
별일	p j ʌ̹ ɾ i ɭ
유목민	j u m o̞ ŋ m i n
버텅	p ʌ̹ tʰ ʌ̹ ŋ
이원	i w ʌ̹ n
마육	m a̠ː j u k̚
셀레늄	sʰ e̞ ɭ ɭ e̞ ɲ j u m
암말	a̠ m m a̠ ɭ
풍습	pʰ u ŋ sʰ ɯ p̚
관광학	k w a̠ n ɡ w a̠ ŋ ɦ a̠ k̚
시옷	ɕʰ i o̞ t̚
뜻밖	t͈ ɯ t̚ p͈ a̠ k̚
마노	m a̠ n o̞
반추	p a̠ ɲ t͡ɕʰ u
사울	sʰ a̠ u ɭ
내놓다	n ɛː n o̞ tʰ a̠
홍어회	ɸʷ o̞ ŋ ʌ̹ β w e̞
의심쩍다	ɰ i ɕʰ i m t͡ɕ͈ ʌ̹ k̚ t͈ a̠
던지럽다	t ɘː ɲ d͡ʑ i ɾ ʌ̹ p̚ t͈ a̠
폴리프로필렌	pʰ o̞ ʎ ʎ i pʰ ɯ ɾ o̞ pʰ i ɭ ɭ e̞ n
파이프	pʰ a̠ i pʰ ɯ
장식하다	t͡ɕ a̠ ŋ ɕʰ i kʰ a̠ d a̠
기계단정	k i ɡ j e̞ d a̠ ɲ d͡ʑ ʌ̹ ŋ
늘다	n ɯ ɭ d a̠
정수리	t͡ɕ ʌ̹ ŋ sʰ u ɾ i
박수	p a̠ k s͈ u
탈영병	tʰ a̠ ɾ j ʌ̹ ŋ b j ʌ̹ ŋ
베오그라드	p e̞ o̞ ɡ ɯ ɾ a̠ d ɯ
보충하다	p o̞ː t͡ɕʰ u ŋ ɦ a̠ d a̠
그곳	k ɯ ɡ o̞ t̚
왼손잡이	w e̞ː n sʰ o̞ ɲ d͡ʑ a̠ b i
담박	t a̠ m b a̠ k̚
적용	t͡ɕ ʌ̹ ɡ j o ŋ
축음기	t͡ɕʰ u ɡ ɯ m ɡ i
기구	k i ɡ u
아스타틴	a̠ sʰ ɯ tʰ a̠ tʰ i n
갑작스럽다	k a̠ p̚ t͡ɕ͈ a̠ k s͈ ɯ ɾ ʌ̹ p̚ t͈ a̠
기울이다	k i u ɾ i d a̠
오딘	o̞ d i n
저주하다	t͡ɕ ɘː d͡ʑ u ɦ a̠ d a̠
옥중	o̞ k̚ t͡ɕ͈ u ŋ
초어	t͡ɕʰ o̞ ʌ̹
감옥	k a̠ m o̞ k̚
감수하다	k a̠ː m sʰ u ɦ a̠ d a̠
다리미판	t a̠ ɾ i m i pʰ a̠ n
의문사	ɰ i m u n sʰ a̠
마이크로프로세서	m a̠ i k x ɯ ɾ o̞ pʰ ɯ ɾ o̞ sʰ e̞ sʰ ʌ̹
앞다리	a̠ p̚ t͈ a̠ ɾ i
모호하다	m o̞ β o̞ ɦ a̠ d a̠
성냥	sʰ ʌ̹ ŋ ɲ j a̠ ŋ
거시기	k ʌ̹ ɕʰ i ɡ i
문진	m u ɲ d͡ʑ i n
길거리	k i ɭ k͈ ʌ̹ ɾ i
부자	p uː d͡ʑ a̠
주유소	t͡ɕ uː j u sʰ o̞
제유법	t͡ɕ e̞ j u b ʌ̹ p̚
들르다	t ɯ ɭ ɭ ɯ d a̠
횡령	ɸ w e̞ ŋ ɲ j ʌ̹ ŋ
회계학	ɸ w e̞ː ɡ j e̞ ɦ a̠ k̚
모스코븀	m o̞ sʰ ɯ kʰ o̞ b j u m
밤	p a̠ː m
지지자	t͡ɕ i d͡ʑ i d͡ʑ a̠
해결되다	h ɛː ɡ j ʌ̹ ɭ d w e̞ d a̠
식	ɕʰ i k̚
뉴런	ɲ j u ɾ ʌ̹ n
한동안	h a̠ n d o̞ ŋ a̠ n
니켈	n i kʰ e̞ ɭ
부에노스아이레스	p u e̞ n o̞ sʰ ɯ a̠ i ɾ e̞ sʰ ɯ
마법사	m a̠ b ʌ̹ p s͈ a̠
쌀밥	s͈ a̠ ɭ b a̠ p̚
촉	t͡ɕʰ o̞ k̚
말리	m a̠ ʎ ʎ i
나리	n a̠ ɾ i
기수사	k i sʰ u sʰ a̠
젖	t͡ɕ ʌ̹ t̚
후예	ɸʷ uː j e̞
픡	pʰ i k̚
목통	m o̞ k̚ tʰ o̞ ŋ
전국적	t͡ɕ ʌ̹ n ɡ u k̚ t͡ɕ͈ ʌ̹ k̚
인식	i n ɕʰ i k̚
마르멜로	m a̠ ɾ ɯ m e̞ ɭ ɭ o̞
마나과	m a̠ n a̠ ɡ w a̠
박사	p a̠ k s͈ a̠
예전	j e̞ː d͡ʑ ʌ̹ n
돌아보다	t o̞ ɾ a̠ b o̞ d a̠
부활	p uː β w a̠ ɭ
테마	tʰ e̞ m a̠
지평선	t͡ɕ i pʰ j ʌ̹ ŋ sʰ ʌ̹ n
드론	t ɯ ɾ o̞ n
주목하다	t͡ɕ u m o̞ kʰ a̠ d a̠
오존	o̞ d͡ʑ o̞ n
콜롬비아	kʰ o̞ ɭ ɭ o̞ m b i a̠
구두	k uː d u
스트로	sʰ ɯ tʰ ɯ ɾ o̞
후보자	ɸʷ u b o̞ d͡ʑ a̠
데리다	t e̞ ɾ i d a̠
톨	tʰ o̞ ɭ
물범	m u ɭ b ʌ̹ m
글루텐	k ɯ ɭ ɭ u tʰ e̞ n
불금	p u ɭ ɡ ɯ m
엮다	j ʌ̹ k̚ t͈ a̠
저수지	t͡ɕ ɘː sʰ u d͡ʑ i
꾸미다	k͈ u m i d a̠
경기도	k j ʌ̹ ŋ ɡ i d o̞
외모	w e̞ m o̞
파마	pʰ a̠ m a̠
뽑다	p͈ o̞ p̚ t͈ a̠
물결길이	m u ɭ ɡ j ʌ̹ ɭ ɡ i ɾ i
천주	t͡ɕʰ ʌ̹ ɲ d͡ʑ u
료금	ɾ j oː ɡ ɯ m
구성하다	k u sʰ ʌ̹ ŋ ɦ a̠ d a̠
어둡다	ʌ̹ d u p̚ t͈ a̠
헐렁하다	h ʌ̹ ɭ ɭ ʌ̹ ŋ ɦ a̠ d a̠
어름치	ʌ̹ ɾ ɯ m t͡ɕʰ i
수령	sʰ u ɾ j ʌ̹ ŋ
주다	t͡ɕ u d a̠
파단	pʰ a̠ː d a̠ n
스프링클러	sʰ ɯ pʰ ɯ ɾ i ŋ k x ɯ ɭ ɭ ʌ̹
틀	tʰ ɯ ɭ
녹말	n o̞ ŋ m a̠ ɭ
라이선스	ɾ a̠ i sʰ ʌ̹ n sʰ ɯ
볼펜	p o̞ ɭ pʰ e̞ n
고투	k o̞ː tʰ u
뛰어들다	t͈ ɥ i ʌ̹ d ɯ ɭ d a̠
유리잔	j u ɾ i d͡ʑ a̠ n
대출	t ɛː t͡ɕʰ u ɭ
기간	k i ɡ a̠ n
곧장	k o̞ t̚ t͡ɕ͈ a̠ ŋ
과테말라	k w a̠ tʰ e̞ m a̠ ɭ ɭ a̠
경상남도	k j ɘː ŋ sʰ a̠ ŋ n a̠ m d o̞
간접화법	k a̠ ɲ d͡ʑ ʌ̹ pʰ w a̠ b ʌ̹ p̚
유니코드	j u n i kʰ o̞ d ɯ
활동	ɸ w a̠ ɭ t͈ o̞ ŋ
로	ɾ o̞
마세루	m a̠ sʰ e̞ ɾ u
시선	ɕʰ iː sʰ ʌ̹ n
싶	ɕʰ i p̚
세르보크로아트어	sʰ e̞ ɾ ɯ b o̞ k x ɯ ɾ o̞ a̠ tʰ ɯ ʌ̹
숙제하다	sʰ u k̚ t͡ɕ͈ e̞ ɦ a̠ d a̠
구급차	k uː ɡ ɯ p̚ t͡ɕʰ a̠
모순	m o̞ sʰ u n
가짜	k a̠ː t͡ɕ͈ a̠
핃	pʰ i t̚
바닷가	p a̠ d a̠ t̚ k͈ a̠
라이벌	ɾ a̠ i b ʌ̹ ɭ
동그라미	t o̞ ŋ ɡ ɯ ɾ a̠ m i
네발가락도롱뇽	n e̞ː b a̠ ɭ k͈ a̠ ɾ a̠ k̚ t͈ o̞ ɾ o̞ ŋ ɲ j o ŋ
계집아이	k j e̞ː d͡ʑ i b a̠ i
연혁	j ɘː n ʝ j ʌ̹ k̚
명명	m j ɘː ŋ m j ʌ̹ ŋ
혹성	ɸʷ o̞ k s͈ ʌ̹ ŋ
방광암	p a̠ ŋ ɡ w a̠ ŋ a̠ m
바치다	p a̠ t͡ɕʰ i d a̠
염주	j ɘː m d͡ʑ u
마련하다	m a̠ ɾ j ʌ̹ n ɦ a̠ d a̠
가시나	k a̠ ɕʰ i n a̠
칭호	t͡ɕʰ i ŋ β o̞
운명	uː n m j ʌ̹ ŋ
라트비아어	ɾ a̠ tʰ ɯ b i a̠ ʌ̹
뚝섬	t͈ u k s͈ ʌ̹ m
멎다	m ʌ̹ t̚ t͈ a̠
경옥	k j ʌ̹ ŋ o̞ k̚
인류학	i ʎ ʎ j u ɦ a̠ k̚
화나다	ɸ w a̠ː n a̠ d a̠
붙이다	p u t͡ɕʰ i d a̠
거울	k ʌ̹ u ɭ
과들루쁘	k w a̠ d ɯ ɭ ɭ u p͈ ɯ
되풀이하다	t w e̞ pʰ u ɾ i ɦ a̠ d a̠
피라진	pʰ i ɾ a̠ d͡ʑ i n
헤스티아	h e̞ sʰ ɯ tʰ i a̠
말고기	m a̠ ɭ ɡ o̞ ɡ i
본토	p o̞ n tʰ o̞
면도	m j ɘː n d o̞
포기	pʰ o̞ː ɡ i
장비	t͡ɕ a̠ ŋ b i
면서	m j ʌ̹ n sʰ ʌ̹
벌금	p ʌ̹ ɭ ɡ ɯ m
금시초문	k ɯ m ɕʰ i t͡ɕʰ o̞ m u n
춤꾼	t͡ɕʰ u m k͈ u n
귀찮다	k ɥ i t͡ɕʰ a̠ n tʰ a̠
리원	ɾ i w ʌ̹ n
이용하다	iː j o ŋ ɦ a̠ d a̠
이슬람국가	i sʰ ɯ ɭ ɭ a̠ m ɡ u k̚ k͈ a̠
뼙	p͈ j ʌ̹ p̚
기라성	k i ɾ a̠ sʰ ʌ̹ ŋ
무속인	m uː sʰ o̞ ɡ i n
글자	k ɯ ʎ t͡ɕ͈ a̠
계시판	k j e̞ː ɕʰ i pʰ a̠ n
앙골라	a̠ ŋ ɡ o̞ ɭ ɭ a̠
엄격	ʌ̹ m k͈ j ʌ̹ k̚
기념관	k i ɲ j ʌ̹ m ɡ w a̠ n
항암제	h a̠ː ŋ a̠ m d͡ʑ e̞
맘마	m a̠ m m a̠
만신	m a̠ː n ɕʰ i n
예루살렘	j e̞ ɾ u sʰ a̠ ɭ ɭ e̞ m
솔깃하다	sʰ o̞ ɭ ɡ i tʰ a̠ d a̠
가로등	k a̠ ɾ o̞ d ɯ ŋ
토요일	tʰ o̞ j o i ɭ
아벨	a̠ b e̞ ɭ
보증	p o̞ d͡ʑ ɯ ŋ
수록	sʰ u ɾ o̞ k̚
사스	sʰ a̠ sʰ ɯ
번역자	p ʌ̹ ɲ j ʌ̹ k̚ t͡ɕ͈ a̠
느끼하다	n ɯ k͈ i ɦ a̠ d a̠
정상	t͡ɕ ʌ̹ ŋ sʰ a̠ ŋ
아시아	a̠ ɕʰ i a̠
거치적거리다	k ʌ̹ t͡ɕʰ i d͡ʑ ʌ̹ k̚ k͈ ʌ̹ ɾ i d a̠
승합차	sʰ ɯ ŋ ɦ a̠ p̚ t͡ɕʰ a̠
미용원	m iː j o ŋ w ʌ̹ n
세르비아어	sʰ e̞ ɾ ɯ b i a̠ ʌ̹
대화	t ɛː β w a̠
하얗다	h a̠ː j a̠ tʰ a̠
목표	m o̞ k̚ pʰ j o
엉덩방아	ɘː ŋ d ʌ̹ ŋ b a̠ ŋ a̠
직감	t͡ɕ i k̚ k͈ a̠ m
일본국	i ɭ b o̞ n ɡ u k̚
퍼즐	pʰ ʌ̹ d͡ʑ ɯ ɭ
커	kʰ ʌ̹
스며들다	sʰ ɯ m j ʌ̹ d ɯ ɭ d a̠
전자	t͡ɕ ɘː ɲ d͡ʑ a̠
유카타	j u kʰ a̠ tʰ a̠
사이보그	s͈ a̠ i b o̞ ɡ ɯ
살갗	sʰ a̠ ɭ ɡ a̠ t̚
불상사	p u ɭ s͈ a̠ ŋ sʰ a̠
삶	sʰ a̠ː m
인터페이스	i n tʰ ʌ̹ pʰ e̞ i sʰ ɯ
야자나무	j a̠ː d͡ʑ a̠ n a̠ m u
견유	k j ʌ̹ ɲ j u
두마	t u m a̠
코브라	kʰ o̞ b ɯ ɾ a̠
뒤쫓다	t ɥ iː t͡ɕ͈ o̞ t̚ t͈ a̠
몰도바	m o̞ ɭ d o̞ b a̠
디자인	t i d͡ʑ a̠ i n
가문	k a̠ m u n
소멸	sʰ o̞ m j ʌ̹ ɭ
설사	sʰ ʌ̹ ɭ s͈ a̠
로봇	ɾ o̞ b o̞ t̚
자꾸	t͡ɕ a̠ k͈ u
음식값	ɯː m ɕʰ i k̚ k͈ a̠ p̚
학습하다	h a̠ k s͈ ɯ pʰ a̠ d a̠
조	t͡ɕ o̞
취급	t͡ɕʰ ɥ i ɡ ɯ p̚
부럼없다	p u ɾ ʌ̹ m ʌ̹ p̚ t͈ a̠
복잡하다	p o̞ k̚ t͡ɕ͈ a̠ pʰ a̠ d a̠
다카르	t a̠ kʰ a̠ ɾ ɯ
바수다	p a̠ sʰ u d a̠
수상하다	sʰ u sʰ a̠ ŋ ɦ a̠ d a̠
글리세롤	k ɯ ʎ ʎ i sʰ e̞ ɾ o̞ ɭ
트롤리	tʰ ɯ ɾ o̞ ʎ ʎ i
그물	k ɯ m u ɭ
성	sʰ ɘː ŋ
반영하다	p a̠ː ɲ j ʌ̹ ŋ ɦ a̠ d a̠
권투	k w ʌ̹ n tʰ u
본사	p o̞ n sʰ a̠
똠얌	t͈ o̞ m j a̠ m
해석자	h ɛː sʰ ʌ̹ k̚ t͡ɕ͈ a̠
웁살라	u p s͈ a̠ ɭ ɭ a̠
사업주	sʰ a̠ ʌ̹ p̚ t͡ɕ͈ u
진실하다	t͡ɕ i n ɕʰ i ɾ ɦ a̠ d a̠
불까다	p u ɭ k͈ a̠ d a̠
단음	t a̠ n ɯ m
슬슬	sʰ ɯ ɭ sʰ ɯ ɭ
탁자	tʰ a̠ k̚ t͡ɕ͈ a̠
논리	n o̞ ʎ ʎ i
가격	k a̠ ɡ j ʌ̹ k̚
줄어들다	t͡ɕ u ɾ ʌ̹ d ɯ ɭ d a̠
시제	ɕʰ i d͡ʑ e̞
심페로폴	ɕʰ i m pʰ e̞ ɾ o̞ pʰ o̞ ɭ
권위	k w ʌ̹ n ɥ i
석류	sʰ ʌ̹ ŋ ɲ j u
창포검	t͡ɕʰ a̠ ŋ pʰ o̞ ɡ ʌ̹ m
넥타이	n e̞ k̚ tʰ a̠ i
성서	sʰ ɘː ŋ sʰ ʌ̹
케이블	kʰ e̞ i b ɯ ɭ
노고지리	n o̞ ɡ o̞ d͡ʑ i ɾ i
뛰어가다	t͈ ɥ i ʌ̹ ɡ a̠ d a̠
조선봉건왕조	t͡ɕ o̞ sʰ ʌ̹ n b o̞ ŋ ɡ ʌ̹ n w a̠ ŋ d͡ʑ o̞
쓸어일어나다	s͈ ɯ ɾ ʌ̹ i ɾ ʌ̹ n a̠ d a̠
시편	ɕʰ i pʰ j ʌ̹ n
먼지	m ʌ̹ ɲ d͡ʑ i
부두	p u d u
움	u m
루사카	ɾ u sʰ a̠ kʰ a̠
착륙	t͡ɕʰ a̠ ŋ ɲ j u k̚
어미	ʌ̹ m i
어원	ɘː w ʌ̹ n
열정	j ʌ̹ ʎ d͡ʑ ʌ̹ ŋ
남아메리카	n a̠ m a̠ m e̞ ɾ i kʰ a̠
플라스크	pʰ ɯ ɭ ɭ a̠ sʰ ɯ k x ɯ
부처	p u t͡ɕʰ ʌ̹
따라서	t͈ a̠ ɾ a̠ sʰ ʌ̹
집토끼	t͡ɕ i p̚ tʰ o̞ k͈ i
맞벌이	m a̠ t̚ p͈ ʌ̹ ɾ i
물공원	m u ɭ ɡ o̞ ŋ w ʌ̹ n
잠자다	t͡ɕ a̠ m d͡ʑ a̠ d a̠
넘기다	n ʌ̹ m ɡ i d a̠
적외선	t͡ɕ ʌ̹ ɡ w e̞ sʰ ʌ̹ n
안후이	a̠ n β u i
마루	m a̠ ɾ u
발표되다	p a̠ ɭ pʰ j o d w e̞ d a̠
여든	j ʌ̹ d ɯ n
불필요하다	p u ɭ pʰ i ɾ j o ɦ a̠ d a̠
깔끔하다	k͈ a̠ ɭ k͈ ɯ m ɦ a̠ d a̠
위안부	ɥ i a̠ n b u
철도역	t͡ɕʰ ʌ̹ ɭ t͈ o̞ j ʌ̹ k̚
놓치다	n o̞ t̚ t͡ɕʰ i d a̠
사전	sʰ a̠ d͡ʑ ʌ̹ n
마스터베이션	m a̠ sʰ ɯ tʰ ʌ̹ b e̞ i ɕʰ ʌ̹ n
편견	pʰ j ʌ̹ n ɡ j ʌ̹ n
외인	w e̞ː i n
땃쥐	t͈ a̠ t̚ t͡ɕ͈ ɥ i
모페드	m o̞ pʰ e̞ d ɯ
벨트	p e̞ ɭ tʰ ɯ
픅	pʰ ɯ k̚
연결되다	j ʌ̹ n ɡ j ʌ̹ ɭ d w e̞ d a̠
인중	i ɲ d͡ʑ u ŋ
삼계탕	sʰ a̠ m ɡ j e̞ tʰ a̠ ŋ
목요일	m o̞ ɡ j o i ɭ
철퇴	t͡ɕʰ ʌ̹ ɭ tʰ w e̞
부아	p u a̠
미국	m i ɡ u k̚
픽	pʰ i k̚
진압하다	t͡ɕ i n a̠ pʰ a̠ d a̠
철자법	t͡ɕʰ ʌ̹ ʎ t͡ɕ͈ a̠ p͈ ʌ̹ p̚
찍다	t͡ɕ͈ i k̚ t͈ a̠
음악회	ɯ m a̠ kʰ w e̞
오빠	o̞ p͈ a̠
이탄	iː tʰ a̠ n
질녀	t͡ɕ i ʎ ʎ j ʌ̹
청소기	t͡ɕʰ ʌ̹ ŋ sʰ o̞ ɡ i
셈	sʰ e̞ː m
홀어미	ɸʷ o̞ ɾ ʌ̹ m i
동사리	t o̞ ŋ sʰ a̠ ɾ i
코나크리	kʰ o̞ n a̠ k x ɯ ɾ i
노력	n o̞ ɾ j ʌ̹ k̚
되다	t w e̞ d a̠
심리	ɕʰ i m n i
청천	t͡ɕʰ ʌ̹ ŋ t͡ɕʰ ʌ̹ n
가사	k a̠ sʰ a̠
어르다	ɘː ɾ ɯ d a̠
위성	ɥ i sʰ ʌ̹ ŋ
칭하이	t͡ɕʰ i ŋ ɦ a̠ i
바위	p a̠ ɥ i
비고	p iː ɡ o̞
운남	u n n a̠ m
사방	sʰ a̠ː b a̠ ŋ
원인	w ʌ̹ n i n
임마누엘	i m m a̠ n u e̞ ɭ
스와질란드	sʰ ɯ w a̠ d͡ʑ i ɭ ɭ a̠ n d ɯ
거룩하다	k ɘː ɾ u kʰ a̠ d a̠
언짢다	ʌ̹ ɲ t͡ɕ͈ a̠ n tʰ a̠
망연하다	m a̠ ŋ j ʌ̹ n ɦ a̠ d a̠
연어	j ʌ̹ n ʌ̹
마켓	m a̠ kʰ e̞ t̚
진보	t͡ɕ iː n b o̞
감람	k a̠ m n a̠ m
경마	k j ɘː ŋ m a̠
높아지다	n o̞ pʰ a̠ d͡ʑ i d a̠
으스스하다	ɯ sʰ ɯ sʰ ɯ ɦ a̠ d a̠
망설이다	m a̠ ŋ sʰ ʌ̹ ɾ i d a̠
살구	sʰ a̠ ɭ ɡ u
입덧	i p̚ t͈ ʌ̹ t̚
표면	pʰ j o m j ʌ̹ n
마닐라	m a̠ n i ɭ ɭ a̠
레알리즘	ɾ e̞ a̠ ʎ ʎ i d͡ʑ ɯ m
칼륨	kʰ a̠ ʎ ʎ j u m
국뽕	k u k̚ p͈ o̞ ŋ
길	k i ɭ
토마토	tʰ o̞ m a̠ tʰ o̞
으스러뜨리다	ɯ sʰ ɯ ɾ ʌ̹ t͈ ɯ ɾ i d a̠
살피다	sʰ a̠ ɭ pʰ i d a̠
젓다	t͡ɕ ɘː t̚ t͈ a̠
그나마	k ɯ n a̠ m a̠
오후	o̞ː β u
방송하다	p a̠ː ŋ sʰ o̞ ŋ ɦ a̠ d a̠
완성	w a̠ n sʰ ʌ̹ ŋ
년금	ɲ j ʌ̹ n ɡ ɯ m
거칠다	k ʌ̹ t͡ɕʰ i ɭ d a̠
반입자	p a̠ː n i p̚ t͡ɕ͈ a̠
이어지다	i ʌ̹ d͡ʑ i d a̠
해석	h ɛː sʰ ʌ̹ k̚
정황	t͡ɕ ʌ̹ ŋ β w a̠ ŋ
편종	pʰ j ʌ̹ ɲ d͡ʑ o̞ ŋ
감당하다	k a̠ː m d a̠ ŋ ɦ a̠ d a̠
비기다	p i ɡ i d a̠
카플	kʰ a̠ pʰ ɯ ɭ
물고기떡	m u ɭ ɡ o̞ ɡ i t͈ ʌ̹ k̚
덧붙다	t ʌ̹ t̚ p͈ u t̚ t͈ a̠
반반	p a̠ː n b a̠ n
기온	k i o̞ n
밤참	p a̠ m t͡ɕʰ a̠ m
야비하다	j a̠ː b i ɦ a̠ d a̠
코헬렛	kʰ o̞ ɦ e̞ ɭ ɭ e̞ t̚
정기	t͡ɕ ɘː ŋ ɡ i
정성	t͡ɕ ʌ̹ ŋ sʰ ʌ̹ ŋ
라이터	ɾ a̠ i tʰ ʌ̹
관리자	k w a̠ ʎ ʎ i d͡ʑ a̠
조카	t͡ɕ o̞ kʰ a̠
자작	t͡ɕ a̠ d͡ʑ a̠ k̚
백사탕	p ɛː k s͈ a̠ tʰ a̠ ŋ
소두	sʰ o̞ d u
양수사	j a̠ ŋ sʰ u sʰ a̠
농	n o̞ ŋ
ㅋㅋㅋ	k x ɯ k x ɯ k x ɯ
고민	k o̞ m i n
주인	t͡ɕ u i n
가라오케	k a̠ ɾ a̠ o̞ kʰ e̞
수필	sʰ u pʰ i ɭ
가마우지	k a̠ m a̠ u d͡ʑ i
황하	ɸ w a̠ ŋ ɦ a̠
도이췰란드	t o̞ i t͡ɕʰ ɥ i ɭ ɭ a̠ n d ɯ
기능	k i n ɯ ŋ
꾸러미	k͈ u ɾ ʌ̹ m i
주바	t͡ɕ u b a̠
방송사고	p a̠ː ŋ sʰ o̞ ŋ sʰ a̠ ɡ o̞
꺾어지다	k͈ ʌ̹ k͈ ʌ̹ d͡ʑ i d a̠
구요	k u j o
쿠션	kʰ u ɕʰ ʌ̹ n
인증	i ɲ d͡ʑ ɯ ŋ
화물	ɸ w a̠ː m u ɭ
도달	t o̞ː d a̠ ɭ
골탄	k o̞ ɭ tʰ a̠ n
글라스	k ɯ ɭ ɭ a̠ sʰ ɯ
가닛	k a̠ n i t̚
라파스	ɾ a̠ pʰ a̠ sʰ ɯ
가위바위보	k a̠ ɥ i b a̠ ɥ i b o̞
지혜	t͡ɕ i ʝ j e̞
게르만	k e̞ ɾ ɯ m a̠ n
맞춤	m a̠ t̚ t͡ɕʰ u m
임신부	iː m ɕʰ i n b u
고아	k o̞ a̠
마이너스	m a̠ i n ʌ̹ sʰ ɯ
물들이다	m u ɭ d ɯ ɾ i d a̠
상표	sʰ a̠ ŋ pʰ j o
나중	n a̠ː d͡ʑ u ŋ
비스켓	p i sʰ ɯ kʰ e̞ t̚
환도	ɸ w a̠ n d o̞
겉핥다	k ʌ̹ tʰ a̠ ɭ t͈ a̠
술어	sʰ u ɾ ʌ̹
독신자	t o̞ k ɕ͈ i ɲ d͡ʑ a̠
출장	t͡ɕʰ u ʎ t͡ɕ͈ a̠ ŋ
분모	p u n m o̞
수저	sʰ u d͡ʑ ʌ̹
투	tʰ u
치읓	t͡ɕʰ i ɯ t̚
반복하다	p a̠ n b o̞ kʰ a̠ d a̠
직업	t͡ɕ i ɡ ʌ̹ p̚
잊혀지다	i t͡ɕʰ ʌ̹ d͡ʑ i d a̠
어려움	ʌ̹ ɾ j ʌ̹ u m
평성	pʰ j ʌ̹ ŋ sʰ ʌ̹ ŋ
비단털등줄쥐	p i d a̠ n tʰ ʌ̹ ɭ d ɯ ŋ d͡ʑ u ʎ d͡ʑ ɥ i
예물	j e̞ m u ɭ
대기	t ɛː ɡ i
인연	i ɲ j ʌ̹ n
신세계	ɕʰ i n sʰ e̞ ɡ j e̞
단물	t a̠ n m u ɭ
보	p o̞
장사	t͡ɕ a̠ ŋ sʰ a̠
분수령	p u n sʰ u ɾ j ʌ̹ ŋ
고리짝	k o̞ ɾ i t͡ɕ͈ a̠ k̚
진료소	t͡ɕ iː ʎ ʎ j o sʰ o̞
브라티슬라바	p ɯ ɾ a̠ tʰ i sʰ ɯ ɭ ɭ a̠ b a̠
적자	t͡ɕ ʌ̹ k̚ t͡ɕ͈ a̠
불란서	p u ɭ ɭ a̠ n sʰ ʌ̹
쇼윈도	ɕʰ o ɥ i n d o̞
놀이공원	n o̞ ɾ i ɡ o̞ ŋ w ʌ̹ n
온도계	o̞ n d o̞ ɡ j e̞
누리집	n u ɾ i d͡ʑ i p̚
부드럽다	p u d ɯ ɾ ʌ̹ p̚ t͈ a̠
설계도	sʰ ʌ̹ ɭ ɡ j e̞ d o̞
미로	m iː ɾ o̞
직발	t͡ɕ i k̚ p͈ a̠ ɭ
식욕	ɕʰ i ɡ j o k̚
멋지다	m ʌ̹ t̚ t͡ɕ͈ i d a̠
이글이글	i ɡ ɯ ɾ i ɡ ɯ ɭ
머슴	m ʌ̹ sʰ ɯ m
홀소리	ɸʷ o̞ ɭ s͈ o̞ ɾ i
꾸리다	k͈ u ɾ i d a̠
작은관코박쥐	t͡ɕ a̠ ɡ ɯ n ɡ w a̠ n kʰ o̞ b a̠ k̚ t͡ɕ͈ ɥ i
저지	t͡ɕ ʌ̹ d͡ʑ i
편자	pʰ j ʌ̹ ɲ d͡ʑ a̠
촉각	t͡ɕʰ o̞ k̚ k͈ a̠ k̚
멍하다	m ɘː ŋ ɦ a̠ d a̠
ㅟ	ɥ i
사나이	sʰ a̠ n a̠ i
군체	k u ɲ t͡ɕʰ e̞
게놈	k e̞ n o̞ m
빠져나가다	p͈ a̠ː d͡ʑ ʌ̹ n a̠ ɡ a̠ d a̠
심혼	ɕʰ i m β o̞ n
충돌	t͡ɕʰ u ŋ d o̞ ɭ
반	p a̠ n
하슘	h a̠ ɕʰ u m
동화	t o̞ː ŋ β w a̠
오사존	o̞ sʰ a̠ d͡ʑ o̞ n
아무런	a̠ː m u ɾ ʌ̹ n
념	ɲ j ʌ̹ m
암실	a̠ː m ɕʰ i ɭ
바보	p a̠ː b o̞
다름슈타튬	t a̠ ɾ ɯ m ɕʰ u tʰ a̠ tʰ j u m
끄르다	k͈ ɯ ɾ ɯ d a̠
지원하다	t͡ɕ i w ʌ̹ n ɦ a̠ d a̠
오블라스티	o̞ b ɯ ɭ ɭ a̠ sʰ ɯ tʰ i
야심	j a̠ː ɕʰ i m
원문	w ʌ̹ n m u n
애	ɛː
금세	k ɯ m sʰ e̞
노려보다	n o̞ ɾ j ʌ̹ b o̞ d a̠
회령	ɸ w e̞ː ɾ j ʌ̹ ŋ
부루퉁이	p u ɾ u tʰ u ŋ i
돌고기	t o̞ ɭ ɡ o̞ ɡ i
봉기	p o̞ ŋ ɡ i
쌍디귿	s͈ a̠ ŋ d i ɡ ɯ t̚
슬로베니아	sʰ ɯ ɭ ɭ o̞ b e̞ n i a̠
토륨	tʰ o̞ ɾ j u m
양우	j a̠ ŋ u
대응하다	t ɛː ɯ ŋ ɦ a̠ d a̠
삵	sʰ a̠ k̚
칸델라	kʰ a̠ n d e̞ ɭ ɭ a̠
계산	k j e̞ː sʰ a̠ n
보스니아	p o̞ sʰ ɯ n i a̠
드러나다	t ɯ ɾ ʌ̹ n a̠ d a̠
소위	sʰ o̞ː ɥ i
소비자	sʰ o̞ b i d͡ʑ a̠
병기고	p j ʌ̹ ŋ ɡ i ɡ o̞
낭비	n a̠ː ŋ b i
펼	pʰ j ʌ̹ ɭ
중립	t͡ɕ u ŋ n i p̚
투표	tʰ u pʰ j o
호리	ɸʷ o̞ ɾ i
실시되다	ɕʰ i ɭ ɕʰ i d w e̞ d a̠
교회	k j oː β w e̞
잘못하다	t͡ɕ a̠ ɭ m o̞ tʰ a̠ d a̠
한글날	h a̠ː n ɡ ɯ ɭ ɭ a̠ ɭ
짭짤하다	t͡ɕ͈ a̠ p̚ t͡ɕ͈ a̠ ɾ ɦ a̠ d a̠
목성	m o̞ k s͈ ʌ̹ ŋ
소년궁전	sʰ o̞ː ɲ j ʌ̹ n ɡ u ŋ d͡ʑ ʌ̹ n
감각	k a̠ː m ɡ a̠ k̚
가깝다	k a̠ k͈ a̠ p̚ t͈ a̠
실망	ɕʰ i ɭ m a̠ ŋ
하라레	h a̠ ɾ a̠ ɾ e̞
심각하다	ɕʰ iː m ɡ a̠ kʰ a̠ d a̠
소꿉동무	sʰ o̞ k͈ u p̚ t͈ o̞ ŋ m u
녹차	n o̞ k̚ t͡ɕʰ a̠
엄친아	ʌ̹ m t͡ɕʰ i n a̠
바라다	p a̠ ɾ a̠ d a̠
손가방	sʰ o̞ n ɡ a̠ b a̠ ŋ
야만인	j a̠ː m a̠ n i n
주식	t͡ɕ u ɕʰ i k̚
침술	t͡ɕʰ i m sʰ u ɭ
샤쯔	ɕʰ a̠ t͡ɕ͈ ɯ
기저귀	k i d͡ʑ ʌ̹ ɡ ɥ i
돌려주다	t o̞ ʎ ʎ j ʌ̹ d͡ʑ u d a̠
늙다리	n ɯ k̚ t͈ a̠ ɾ i
환자	ɸ w a̠ː ɲ d͡ʑ a̠
멀찌감치	m ʌ̹ ʎ t͡ɕ͈ i ɡ a̠ m t͡ɕʰ i
고추	k o̞ t͡ɕʰ u
망시민	m a̠ ŋ ɕʰ i m i n
쿠	kʰ u
자유의지주의	t͡ɕ a̠ j u ɰ i d͡ʑ i d͡ʑ u ɰ i
삼초	sʰ a̠ m t͡ɕʰ o̞
밀통	m i ɭ tʰ o̞ ŋ
카렌더	kʰ a̠ ɾ e̞ n d ʌ̹
소득	sʰ o̞ː d ɯ k̚
칼상어	kʰ a̠ ɭ sʰ a̠ ŋ ʌ̹
지시	t͡ɕ i ɕʰ i
가마	k a̠ː m a̠
모교	m o̞ː ɡ j o
장마	t͡ɕ a̠ ŋ m a̠
흥	x ɯ ŋ
초고속	t͡ɕʰ o̞ ɡ o̞ sʰ o̞ k̚
황로	ɸ w a̠ ŋ n o̞
자판	t͡ɕ a̠ pʰ a̠ n
국면	k u ŋ m j ʌ̹ n
탐	tʰ a̠ m
습기	sʰ ɯ p̚ k͈ i
합치다	h a̠ p̚ t͡ɕʰ i d a̠
기타	k i tʰ a̠
비스무트	p i sʰ ɯ m u tʰ ɯ
반발	p a̠ː n b a̠ ɭ
용지	j o ŋ d͡ʑ i
사격	sʰ a̠ ɡ j ʌ̹ k̚
주스	t͡ɕ u sʰ ɯ
미혼모	m iː β o̞ n m o̞
모임	m o̞ i m
팥	pʰ a̠ t̚
욕실	j o k ɕ͈ i ɭ
간사하다	k a̠ n sʰ a̠ ɦ a̠ d a̠
목청껏	m o̞ k̚ t͡ɕʰ ʌ̹ ŋ k͈ ʌ̹ t̚
펜	pʰ e̞ n
웨이터	w e̞ i tʰ ʌ̹
올여름	o̞ ʎ ʎ j ʌ̹ ɾ ɯ m
사실상	sʰ a̠ː ɕʰ i ɭ s͈ a̠ ŋ
펼치다	pʰ j ʌ̹ ʎ t͡ɕʰ i d a̠
복숭아	p o̞ k s͈ u ŋ a̠
광업	k w a̠ː ŋ ʌ̹ p̚
압또부스	a̠ p̚ t͈ o̞ b u sʰ ɯ
지하철	t͡ɕ i ɦ a̠ t͡ɕʰ ʌ̹ ɭ
꼬마청황	k͈ o̞ m a̠ t͡ɕʰ ʌ̹ ŋ β w a̠ ŋ
해외	h ɛː w e̞
마흔	m a̠ ɣ ɯ n
만화가	m a̠ n β w a̠ ɡ a̠
조작	t͡ɕ o̞ː d͡ʑ a̠ k̚
시각	ɕʰ i ɡ a̠ k̚
과거	k w a̠ ɡ ʌ̹
꽃미남	k͈ o̞ n m i n a̠ m
골	k o̞ ɭ
화이팅	ɸ w a̠ i tʰ i ŋ
관복	k w a̠ n b o̞ k̚
구별	k u b j ʌ̹ ɭ
과두	k w a̠ː d u
반지름	p a̠ː ɲ d͡ʑ i ɾ ɯ m
드럼	t ɯ ɾ ʌ̹ m
부서지다	p u sʰ ʌ̹ d͡ʑ i d a̠
같잖다	k a̠ t̚ t͡ɕ͈ a̠ n tʰ a̠
초보자	t͡ɕʰ o̞ b o̞ d͡ʑ a̠
문과	m u n ɡ w a̠
가마솥	k a̠ m a̠ sʰ o̞ t̚
법안	p ʌ̹ b a̠ n
정조	t͡ɕ ʌ̹ ŋ d͡ʑ o̞
흐지부지	x ɯ d͡ʑ i b u d͡ʑ i
밥솥	p a̠ p s͈ o̞ t̚
적어도	t͡ɕ ɘː ɡ ʌ̹ d o̞
죄다	t͡ɕ w e̞ː d a̠
응답	ɯ ŋ d a̠ p̚
자동차	t͡ɕ a̠ d o̞ ŋ t͡ɕʰ a̠
허파	h ʌ̹ pʰ a̠
끽반하다	k͈ i k̚ p͈ a̠ n ɦ a̠ d a̠
초지	t͡ɕʰ o̞ d͡ʑ i
지도	t͡ɕ i d o̞
미륵보살	m i ɾ ɯ k̚ p͈ o̞ sʰ a̠ ɭ
펠메니	pʰ e̞ ɭ m e̞ n i
한데	h a̠ː n d e̞
앙상블	a̠ ŋ sʰ a̠ ŋ b ɯ ɭ
전력	t͡ɕ ɘː ʎ ʎ j ʌ̹ k̚
청국장	t͡ɕʰ ʌ̹ ŋ ɡ u k̚ t͡ɕ͈ a̠ ŋ
소중하다	sʰ o̞ː d͡ʑ u ŋ ɦ a̠ d a̠
방수	p a̠ ŋ sʰ u
스테파노	sʰ ɯ tʰ e̞ pʰ a̠ n o̞
걸어	k ʌ̹ ɾ ʌ̹
중동	t͡ɕ u ŋ d o̞ ŋ
당뇨병	t a̠ ŋ ɲ j o p͈ j ʌ̹ ŋ
큰기러기	k x ɯ n ɡ i ɾ ʌ̹ ɡ i
설폰	sʰ ʌ̹ ɭ pʰ o̞ n
소수민족	sʰ o̞ sʰ u m i ɲ d͡ʑ o̞ k̚
어븀	ʌ̹ b j u m
음훈	ɯ m β u n
수송	sʰ u sʰ o̞ ŋ
엽록소	j ʌ̹ m n o̞ k s͈ o̞
세입자	sʰ e̞ː i p̚ t͡ɕ͈ a̠
하즈	h a̠ d͡ʑ ɯ
녀성고음	ɲ j ʌ̹ sʰ ʌ̹ ŋ ɡ o̞ ɯ m
실천	ɕʰ i ʎ t͡ɕʰ ʌ̹ n
식기세척기	ɕʰ i k̚ k͈ i sʰ e̞ t͡ɕʰ ʌ̹ k̚ k͈ i
쎈터	s͈ e̞ n tʰ ʌ̹
바다	p a̠ d a̠
무산쇠족제비	m uː sʰ a̠ n sʰ w e̞ d͡ʑ o̞ k̚ t͡ɕ͈ e̞ b i
미어	m i ʌ̹
송이	sʰ o̞ ŋ i
타일	tʰ a̠ i ɭ
빈트후크	p i n tʰ ɯ β u k x ɯ
아휴	a̠ ʝ j u
모자라다	m o̞ː d͡ʑ a̠ ɾ a̠ d a̠
게톱치	k e̞ tʰ o̞ p̚ t͡ɕʰ i
회관	ɸ w e̞ː ɡ w a̠ n
미디어	m i d i ʌ̹
티베트	tʰ i b e̞ tʰ ɯ
출퇴근하다	t͡ɕʰ u ɭ tʰ w e̞ ɡ ɯ n ɦ a̠ d a̠
당신	t a̠ ŋ ɕʰ i n
함경	h a̠ m ɡ j ʌ̹ ŋ
자칫하면	t͡ɕ a̠ t͡ɕʰ i tʰ a̠ m j ʌ̹ n
쇠가마우지	sʰ w e̞ ɡ a̠ m a̠ u d͡ʑ i
찬	t͡ɕʰ a̠ n
타워	tʰ a̠ w ʌ̹
식료품점	ɕʰ i ŋ ɲ j o pʰ u m d͡ʑ ʌ̹ m
배송	p ɛː sʰ o̞ ŋ
농업	n o̞ ŋ ʌ̹ p̚
배반하다	p ɛː b a̠ n ɦ a̠ d a̠
겹놓다	k j ʌ̹ m n o̞ tʰ a̠
근사하다	k ɯː n sʰ a̠ ɦ a̠ d a̠
의지	ɰ i d͡ʑ i
야곱	j a̠ ɡ o̞ p̚
정욕	t͡ɕ ʌ̹ ŋ j o k̚
전하다	t͡ɕ ʌ̹ n ɦ a̠ d a̠
한데	h a̠ n d e̞
페달	pʰ e̞ d a̠ ɭ
좆목	t͡ɕ o̞ n m o̞ k̚
갑	k a̠ p̚
가돌리늄	k a̠ d o̞ ʎ ʎ i ɲ j u m
까자흐스딴	k͈ a̠ d͡ʑ a̠ ɣ ɯ sʰ ɯ t͈ a̠ n
계량경제학	k j e̞ ɾ j a̠ ŋ ɡ j ʌ̹ ŋ d͡ʑ e̞ ɦ a̠ k̚
불리다	p u ʎ ʎ i d a̠
지방족	t͡ɕ i b a̠ ŋ d͡ʑ o̞ k̚
루멘	ɾ u m e̞ n
빨아먹다	p͈ a̠ ɾ a̠ m ʌ̹ k̚ t͈ a̠
방탄	p a̠ ŋ tʰ a̠ n
체인	t͡ɕʰ e̞ i n
엇비슷하다	ʌ̹ t̚ p͈ i sʰ ɯ tʰ a̠ d a̠
퍼지다	pʰ ɘː d͡ʑ i d a̠
니코틴	n i kʰ o̞ tʰ i n
구원	k u w ʌ̹ n
부룬디	p u ɾ u n d i
삼선	sʰ a̠ m sʰ ʌ̹ n
즐겁다	t͡ɕ ɯ ɭ ɡ ʌ̹ p̚ t͈ a̠
용기	j o ŋ ɡ i
아니다	a̠ n i d a̠
늪	n ɯ p̚
위치하다	ɥ i t͡ɕʰ i ɦ a̠ d a̠
방아	p a̠ ŋ a̠
유충	j u t͡ɕʰ u ŋ
위병	ɥ i b j ʌ̹ ŋ
쇼핑하다	ɕʰ o pʰ i ŋ ɦ a̠ d a̠
산파	sʰ a̠ː n pʰ a̠
뼢	p͈ j ʌ̹ p̚
쇠뿌러기	sʰ w e̞ p͈ u ɾ ʌ̹ ɡ i
노사	n o̞ː sʰ a̠
대다수	t ɛː d a̠ sʰ u
황복	ɸ w a̠ ŋ b o̞ k̚
아침놀	a̠ t͡ɕʰ i m n o̞ ɭ
아끼다	a̠ k͈ i d a̠
막	m a̠ k̚
회사원	ɸ w e̞ː sʰ a̠ w ʌ̹ n
제발	t͡ɕ e̞ː b a̠ ɭ
부모	p u m o̞
알케인	a̠ ɭ kʰ e̞ i n
소품	sʰ o̞ː pʰ u m
옛날	j e̞ː n n a̠ ɭ
말	m a̠ː ɭ
통과하다	tʰ o̞ ŋ ɡ w a̠ ɦ a̠ d a̠
벌써	p ʌ̹ ɭ s͈ ʌ̹
기록	k i ɾ o̞ k̚
텔루르	tʰ e̞ ɭ ɭ u ɾ ɯ
소방차	sʰ o̞ b a̠ ŋ t͡ɕʰ a̠
명	m j ʌ̹ ŋ
탄수화물	tʰ a̠ː n sʰ u β w a̠ m u ɭ
귀환	k ɥ iː β w a̠ n
외부	w e̞ː b u
박엽지	p a̠ ɡ j ʌ̹ p̚ t͡ɕ͈ i
르완다	ɾ ɯ w a̠ n d a̠
세포질	sʰ e̞ː pʰ o̞ d͡ʑ i ɭ
사진사	sʰ a̠ d͡ʑ i n sʰ a̠
포도	pʰ o̞ d o̞
하늘	h a̠ n ɯ ɭ
성명	sʰ ɘː ŋ m j ʌ̹ ŋ
부귀영화	p uː ɡ ɥ i j ʌ̹ ŋ β w a̠
필자	pʰ i ʎ t͡ɕ͈ a̠
뛰어나다	t͈ ɥ i ʌ̹ n a̠ d a̠
업체	ʌ̹ p̚ t͡ɕʰ e̞
퍼센트	pʰ ʌ̹ sʰ e̞ n tʰ ɯ
몽	m o̞ ŋ
광음사전	k w a̠ ŋ ɯ m sʰ a̠ d͡ʑ ʌ̹ n
프리지어	pʰ ɯ ɾ i d͡ʑ i ʌ̹
증권	t͡ɕ ɯ ŋ k͈ w ʌ̹ n
신사	ɕʰ iː n sʰ a̠
몽타주	m o̞ ŋ tʰ a̠ d͡ʑ u
다그치다	t a̠ ɡ ɯ t͡ɕʰ i d a̠
가젤	k a̠ d͡ʑ e̞ ɭ
쿨쿨	kʰ u ɭ kʰ u ɭ
연준모치	j ʌ̹ ɲ d͡ʑ u n m o̞ t͡ɕʰ i
애정	ɛː d͡ʑ ʌ̹ ŋ
TMI	tʰ i e̞ m a̠ i
농담하다	n o̞ː ŋ d a̠ m ɦ a̠ d a̠
오덕후	o̞ d ʌ̹ kʰ u
소송	sʰ o̞ sʰ o̞ ŋ
포트모르즈비	pʰ o̞ tʰ ɯ m o̞ ɾ ɯ d͡ʑ ɯ b i
프로세서	pʰ ɯ ɾ o̞ sʰ e̞ sʰ ʌ̹
아나운서	a̠ n a̠ u n sʰ ʌ̹
공손	k o̞ ŋ sʰ o̞ n
활기	ɸ w a̠ ɭ ɡ i
왕조	w a̠ ŋ d͡ʑ o̞
확정하다	ɸ w a̠ k̚ t͡ɕ͈ ʌ̹ ŋ ɦ a̠ d a̠
방화	p a̠ ŋ β w a̠
잔소리	t͡ɕ a̠ n sʰ o̞ ɾ i
투명하다	tʰ u m j ʌ̹ ŋ ɦ a̠ d a̠
네오디뮴	n e̞ o̞ d i m j u m
버거	p ʌ̹ ɡ ʌ̹
민병	m i n b j ʌ̹ ŋ
상상	sʰ a̠ː ŋ sʰ a̠ ŋ
웃기다	u t̚ k͈ i d a̠
NG	e̞ ɲ d͡ʑ i
네피도	n e̞ pʰ i d o̞
최상급	t͡ɕʰ w e̞ː sʰ a̠ ŋ ɡ ɯ p̚
철저하다	t͡ɕʰ ʌ̹ ʎ t͡ɕ͈ ʌ̹ ɦ a̠ d a̠
장면	t͡ɕ a̠ ŋ m j ʌ̹ n
출신	t͡ɕʰ u ɭ ɕ͈ i n
반성	p a̠ n s͈ ʌ̹ ŋ
근무하다	k ɯː n m u ɦ a̠ d a̠
동정	t o̞ ŋ d͡ʑ ʌ̹ ŋ
설교	sʰ ʌ̹ ɭ ɡ j o
지도자	t͡ɕ i d o̞ d͡ʑ a̠
세계	sʰ e̞ː ɡ j e̞
크레디트	k x ɯ ɾ e̞ d i tʰ ɯ
세꼬	sʰ e̞ k͈ o̞
탄환열차	tʰ a̠ː n β w a̠ ɲ j ʌ̹ ʎ t͡ɕʰ a̠
폐	pʰ j e̞ː
이상야릇하다	iː sʰ a̠ ŋ ɲ j a̠ ɾ ɯ tʰ a̠ d a̠
징그럽다	t͡ɕ i ŋ ɡ ɯ ɾ ʌ̹ p̚ t͈ a̠
점심	t͡ɕ ɘː m ɕʰ i m
헤어지다	h e̞ ʌ̹ d͡ʑ i d a̠
부품	p u pʰ u m
유성	j u sʰ ʌ̹ ŋ
목격자	m o̞ k̚ k͈ j ʌ̹ k̚ t͡ɕ͈ a̠
관하다	k w a̠ n ɦ a̠ d a̠
소유	sʰ o̞ː j u
역사	j ʌ̹ k s͈ a̠
슬픔증	sʰ ɯ ɭ pʰ ɯ m d͡ʑ ɯ ŋ
차단	t͡ɕʰ a̠ː d a̠ n
석유	sʰ ʌ̹ ɡ j u
잡년	t͡ɕ a̠ m ɲ j ʌ̹ n
녹이다	n o̞ ɡ i d a̠
자모	t͡ɕ a̠ m o̞
노벨륨	n o̞ b e̞ ʎ ʎ j u m
일광욕	i ɭ ɡ w a̠ ŋ j o k̚
부술기	p u sʰ u ɭ ɡ i
쓰리다	s͈ ɯ ɾ i d a̠
벅차다	p ʌ̹ k̚ t͡ɕʰ a̠ d a̠
아미딘	a̠ m i d i n
깎다	k͈ a̠ k̚ t͈ a̠
청둥오리	t͡ɕʰ ʌ̹ ŋ d u ŋ o̞ ɾ i
화약	ɸ w a̠ː j a̠ k̚
푸다	pʰ u d a̠
펭귄	pʰ e̞ ŋ ɡ ɥ i n
직승기	t͡ɕ i k s͈ ɯ ŋ ɡ i
안녕하세요	a̠ n ɲ j ʌ̹ ŋ ɦ a̠ sʰ e̞ j o
사라지다	sʰ a̠ ɾ a̠ d͡ʑ i d a̠
샤발	ɕʰ a̠ b a̠ ɭ
로메	ɾ o̞ m e̞
쓰러지다	s͈ ɯ ɾ ʌ̹ d͡ʑ i d a̠
서밋	sʰ ʌ̹ m i t̚
피난처	pʰ iː n a̠ ɲ t͡ɕʰ ʌ̹
교체	k j o t͡ɕʰ e̞
이인칭	i i ɲ t͡ɕʰ i ŋ
기부	k i b u
앎	a̠ː m
거짓말하다	k ɘː d͡ʑ i n m a̠ ɾ ɦ a̠ d a̠
트로필륨	tʰ ɯ ɾ o̞ pʰ i ʎ ʎ j u m
받다	p a̠ t̚ t͈ a̠
마땅하다	m a̠ t͈ a̠ ŋ ɦ a̠ d a̠
예	j e̞ː
정도	t͡ɕ ʌ̹ ŋ d o̞
변절자	p j ɘː ɲ d͡ʑ ʌ̹ ʎ d͡ʑ a̠
노크노크	n o̞ k x ɯ n o̞ k x ɯ
유원지	j u w ʌ̹ ɲ d͡ʑ i
씨팔	ɕ͈ i pʰ a̠ ɭ
무슨	m u sʰ ɯ n
전리품	t͡ɕ ɘː ʎ ʎ i pʰ u m
합금	h a̠ p̚ k͈ ɯ m
북마크	p u ŋ m a̠ k x ɯ
분량	p uː ʎ ʎ j a̠ ŋ
등장하다	t ɯ ŋ d͡ʑ a̠ ŋ ɦ a̠ d a̠
자메이카	t͡ɕ a̠ m e̞ i kʰ a̠
수피	sʰ u pʰ i
쿼	kʰ w ʌ̹
로듐	ɾ o̞ d j u m
사닥다리	sʰ a̠ d a̠ k̚ t͈ a̠ ɾ i
연설	j ɘː n sʰ ʌ̹ ɭ
무예	m uː j e̞
가져가다	k a̠ d͡ʑ ʌ̹ ɡ a̠ d a̠
인식론	i n ɕʰ i ŋ n o̞ n
가지가지	k a̠ d͡ʑ i ɡ a̠ d͡ʑ i
궁전	k u ŋ d͡ʑ ʌ̹ n
간사	k a̠ n sʰ a̠
난민	n a̠ n m i n
훌	ɸʷ u ɭ
전반적	t͡ɕ ʌ̹ n b a̠ ɲ d͡ʑ ʌ̹ k̚
몸소	m o̞ m sʰ o̞
유음	j u ɯ m
두근두근	t u ɡ ɯ n d u ɡ ɯ n
음소	ɯ m sʰ o̞
프로펠러	pʰ ɯ ɾ o̞ pʰ e̞ ɭ ɭ ʌ̹
와이셔츠	w a̠ i ɕʰ ʌ̹ t͡ɕʰ ɯ
은인	ɯ n i n
티읕	tʰ i ɯ t̚
립	ɾ i p̚
이슬라마바드	i sʰ ɯ ɭ ɭ a̠ m a̠ b a̠ d ɯ
안정	a̠ ɲ d͡ʑ ʌ̹ ŋ
단감자	t a̠ n ɡ a̠ m d͡ʑ a̠
회교도	ɸ w e̞ ɡ j o d o̞
폴란드어	pʰ o̞ ɭ ɭ a̠ n d ɯ ʌ̹
양성	j a̠ ŋ sʰ ʌ̹ ŋ
손주	sʰ o̞ ɲ d͡ʑ u
곩	k o̞ k̚
센티미터	s͈ e̞ n tʰ i m i tʰ ʌ̹
썰다	s͈ ɘː ɭ d a̠
토끼	tʰ o̞ k͈ i
셈틀	sʰ e̞ m tʰ ɯ ɭ
맨날	m ɛː n n a̠ ɭ
베이컨	p e̞ i kʰ ʌ̹ n
방울	p a̠ ŋ u ɭ
훈장	ɸʷ u ɲ d͡ʑ a̠ ŋ
수없이	sʰ uː ʌ̹ p ɕ͈ i
가오리	k a̠ o̞ ɾ i
북극	p u k̚ k͈ ɯ k̚
꿀밤	k͈ u ɭ b a̠ m
물	m u ɭ
궁둥이	k u ŋ d u ŋ i
욕하다	j o kʰ a̠ d a̠
군데	k u n d e̞
귀엽다	k ɥ iː j ʌ̹ p̚ t͈ a̠
득템	t ɯ k̚ tʰ e̞ m
급료	k ɯ m ɲ j o
쪼다	t͡ɕ͈ o̞ d a̠
너비아니	n ʌ̹ b i a̠ n i
인용	i ɲ j o ŋ
종류	t͡ɕ o̞ː ŋ ɲ j u
됨됨이	t w e̞ m d w e̞ m i
검소하다	k ʌ̹ m sʰ o̞ ɦ a̠ d a̠
이목구비	i m o̞ k̚ k͈ u b i
성과	sʰ ʌ̹ ŋ k͈ w a̠
방사선	p a̠ː ŋ sʰ a̠ sʰ ʌ̹ n
자위	t͡ɕ a̠ ɥ i
허영심	h ʌ̹ j ʌ̹ ŋ ɕʰ i m
안드레아	a̠ n d ɯ ɾ e̞ a̠
합성	h a̠ p s͈ ʌ̹ ŋ
하시다	h a̠ ɕʰ i d a̠
다섯	t a̠ sʰ ʌ̹ t̚
특별히	tʰ ɯ k̚ p͈ j ʌ̹ ɾ ʝ i
한어	h a̠ː n ʌ̹
관용구	k w a̠ ɲ j o ŋ ɡ u
홍합	ɸʷ o̞ ŋ ɦ a̠ p̚
까벨	k͈ a̠ b e̞ ɭ
채식주의자	t͡ɕʰ ɛː ɕʰ i k̚ t͡ɕ͈ u ɰ i d͡ʑ a̠
퓝	pʰ ɥ i p̚
공부자	k o̞ː ŋ b u d͡ʑ a̠
사형	sʰ a̠ː ʝ j ʌ̹ ŋ
알판	a̠ ɭ pʰ a̠ n
고기겹빵	k o̞ ɡ i ɡ j ʌ̹ p̚ p͈ a̠ ŋ
머핀	m ʌ̹ pʰ i n
비구름	p i ɡ u ɾ ɯ m
유로비트	j u ɾ o̞ b i tʰ ɯ
전라도	t͡ɕ ʌ̹ ɭ ɭ a̠ d o̞
이끌다	i k͈ ɯ ɭ d a̠
주두	t͡ɕ u d u
펵	pʰ j ʌ̹ k̚
물어떼다	m u ɾ ʌ̹ t͈ e̞ d a̠
달걀	t a̠ ɭ ɡ j a̠ ɭ
푸젠	pʰ u d͡ʑ e̞ n
호루라기	ɸʷ o̞ ɾ u ɾ a̠ ɡ i
성	s͈ ʌ̹ ŋ
감	k a̠ m
본문	p o̞ n m u n
사탕수수	sʰ a̠ tʰ a̠ ŋ sʰ u sʰ u
볼링	p o̞ ʎ ʎ i ŋ
약주	j a̠ k̚ t͡ɕ͈ u
조지아	t͡ɕ o̞ d͡ʑ i a̠
송과선	sʰ o̞ ŋ ɡ w a̠ sʰ ʌ̹ n
큰가시고기	k x ɯ n ɡ a̠ ɕʰ i ɡ o̞ ɡ i
보건	p o̞ ɡ ʌ̹ n
여가	j ʌ̹ ɡ a̠
부족하다	p u d͡ʑ o̞ kʰ a̠ d a̠
수고하다	sʰ uː ɡ o̞ ɦ a̠ d a̠
륵	ɾ ɯ k̚
모욕하다	m o̞ː j o kʰ a̠ d a̠
익룡	i ŋ ɲ j o ŋ
습하다	sʰ ɯ pʰ a̠ d a̠
너그럽다	n ʌ̹ ɡ ɯ ɾ ʌ̹ p̚ t͈ a̠
시작	ɕʰ i d͡ʑ a̠ k̚
차이나타운	t͡ɕʰ a̠ i n a̠ tʰ a̠ u n
벨리즈	p e̞ ʎ ʎ i d͡ʑ ɯ
수표	sʰ u pʰ j o
헤이그	h e̞ i ɡ ɯ
염세주의	j ɘː m sʰ e̞ d͡ʑ u ɰ i
자음	t͡ɕ a̠ ɯ m
간장	k a̠ː ɲ d͡ʑ a̠ ŋ
지금	t͡ɕ i ɡ ɯ m
앞	a̠ p̚
정상회담	t͡ɕ ʌ̹ ŋ sʰ a̠ ŋ β w e̞ d a̠ m
결정	k j ʌ̹ ʎ t͡ɕ͈ ʌ̹ ŋ
파고다	pʰ a̠ ɡ o̞ d a̠
두어서넛	t u ʌ̹ sʰ ʌ̹ n ʌ̹ t̚
갑분싸	k a̠ p̚ p͈ u n s͈ a̠
과정	k w a̠ː d͡ʑ ʌ̹ ŋ
선전	sʰ ʌ̹ ɲ d͡ʑ ʌ̹ n
공장	k o̞ ŋ d͡ʑ a̠ ŋ
척	t͡ɕʰ ʌ̹ k̚
발	p a̠ ɭ
수장룡	sʰ u d͡ʑ a̠ ŋ ɲ j o ŋ
정신분열병	t͡ɕ ʌ̹ ŋ ɕʰ i n p u ɲ j ʌ̹ ɭ b j ʌ̹ ŋ
앞서다	a̠ p s͈ ʌ̹ d a̠
운영하다	uː ɲ j ʌ̹ ŋ ɦ a̠ d a̠
마술사	m a̠ sʰ u ɭ s͈ a̠
불가피하다	p u ɭ ɡ a̠ pʰ i ɦ a̠ d a̠
민중	m i ɲ d͡ʑ u ŋ
점프	t͡ɕ ʌ̹ m pʰ ɯ
잡지	t͡ɕ a̠ p̚ t͡ɕ͈ i
후지	ɸʷ u d͡ʑ i
빗자루	p i t̚ t͡ɕ͈ a̠ ɾ u
독특하다	t o̞ k̚ tʰ ɯ kʰ a̠ d a̠
스타벅스	sʰ ɯ tʰ a̠ b ʌ̹ k s͈ ɯ
단념하다	t a̠ː n ɲ j ʌ̹ m ɦ a̠ d a̠
뉴델리	ɲ j u d e̞ ʎ ʎ i
청소년	t͡ɕʰ ʌ̹ ŋ sʰ o̞ ɲ j ʌ̹ n
장인어른	t͡ɕ a̠ː ŋ i n ʌ̹ ɾ ɯ n
띠앗	t͈ i a̠ t̚
빈곤	p i n ɡ o̞ n
흔히	x ɯ n ʝ i
위기	ɥ i ɡ i
실체	ɕʰ i ʎ t͡ɕʰ e̞
능력	n ɯ ŋ ɲ j ʌ̹ k̚
서투르다	sʰ ɘː tʰ u ɾ ɯ d a̠
아무것	a̠ː m u ɡ ʌ̹ t̚
훌륭하다	ɸʷ u ʎ ʎ j u ŋ ɦ a̠ d a̠
찜질방	t͡ɕ͈ i m d͡ʑ i ɭ b a̠ ŋ
홍	ɸʷ o̞ ŋ
가시다	k a̠ ɕʰ i d a̠
떨리다	t͈ ʌ̹ ʎ ʎ i d a̠
남의자	n a̠ m ɰ i d͡ʑ a̠
실습	ɕʰ i ɭ s͈ ɯ p̚
집오리	t͡ɕ i b o̞ ɾ i
듯	t ɯ t̚
금강모치	k ɯ m ɡ a̠ ŋ m o̞ t͡ɕʰ i
무리	m u ɾ i
작가	t͡ɕ a̠ k̚ k͈ a̠
빚다	p i t̚ t͈ a̠
특정	tʰ ɯ k̚ t͡ɕ͈ ʌ̹ ŋ
고을	k o̞ ɯ ɭ
방광	p a̠ ŋ ɡ w a̠ ŋ
까마귓과	k͈ a̠ m a̠ ɡ ɥ i t̚ k͈ w a̠
결합하다	k j ʌ̹ ɾ ɦ a̠ pʰ a̠ d a̠
ᆫ데	n d e̞
쌀쌀히	s͈ a̠ ɭ s͈ a̠ ɾ ʝ i
타	tʰ a̠
난초	n a̠ ɲ t͡ɕʰ o̞
연합	j ʌ̹ n ɦ a̠ p̚
셔터	ɕʰ ʌ̹ tʰ ʌ̹
업종	ʌ̹ p̚ t͡ɕ͈ o̞ ŋ
천당	t͡ɕʰ ʌ̹ n d a̠ ŋ
뒤섞다	t ɥ i sʰ ʌ̹ k̚ t͈ a̠
루블	ɾ u b ɯ ɭ
줄다	t͡ɕ uː ɭ d a̠
럼	ɾ ʌ̹ m
비빔	p i b i m
불라	p u ɭ ɭ a̠
무사	m u sʰ a̠
세륨	sʰ e̞ ɾ j u m
요람	j o ɾ a̠ m
고집하다	k o̞ d͡ʑ i pʰ a̠ d a̠
잠기다	t͡ɕ a̠ m ɡ i d a̠
사슬	sʰ a̠ sʰ ɯ ɭ
하이힐	h a̠ i ʝ i ɭ
출산	t͡ɕʰ u ɭ s͈ a̠ n
오믈렛	o̞ m ɯ ɭ ɭ e̞ t̚
롤러코스터	ɾ o̞ ɭ ɭ ʌ̹ kʰ o̞ sʰ ɯ tʰ ʌ̹
제한하다	t͡ɕ e̞ː ɦ a̠ n ɦ a̠ d a̠
몽둥이	m o̞ ŋ d u ŋ i
토록	tʰ o̞ ɾ o̞ k̚
상투메	sʰ a̠ ŋ tʰ u m e̞
식당	ɕʰ i k̚ t͈ a̠ ŋ
증	t͡ɕ ɯ ŋ
얼음과자	ʌ̹ ɾ ɯ m ɡ w a̠ d͡ʑ a̠
수성	sʰ u sʰ ʌ̹ ŋ
서랍	sʰ ʌ̹ ɾ a̠ p̚
등걸	t ɯ ŋ ɡ ʌ̹ ɭ
너트	n ʌ̹ tʰ ɯ
두리안	t u ɾ i a̠ n
천리마	t͡ɕʰ ʌ̹ ʎ ʎ i m a̠
변하다	p j ɘː n ɦ a̠ d a̠
조금	t͡ɕ o̞ ɡ ɯ m
붉은부리흰죽지	p u ɭ ɡ ɯ n b u ɾ i ʝ i ɲ d͡ʑ u k̚ t͡ɕ͈ i
용언	j oː ŋ ʌ̹ n
외복사근	w e̞ b o̞ k s͈ a̠ ɡ ɯ n
산업	sʰ a̠ː n ʌ̹ p̚
사뿐사뿐	sʰ a̠ p͈ u n sʰ a̠ p͈ u n
통발	tʰ o̞ ŋ b a̠ ɭ
저장	t͡ɕ ʌ̹ d͡ʑ a̠ ŋ
활시위	ɸ w a̠ ɭ ɕ͈ i ɥ i
오등	o̞ː d ɯ ŋ
한약	h a̠ ɲ j a̠ k̚
부분	p u b u n
놀라다	n o̞ː ɭ ɭ a̠ d a̠
사이트	sʰ a̠ i tʰ ɯ
넓히다	n ʌ̹ ɭ pʰ i d a̠
얹다	ʌ̹ n t͈ a̠
제사	t͡ɕ e̞ː sʰ a̠
민국	m i n ɡ u k̚
동방	t o̞ ŋ b a̠ ŋ
트렁크	tʰ ɯ ɾ ʌ̹ ŋ k x ɯ
인하다	i n ɦ a̠ d a̠
역	j ʌ̹ k̚
굴다	k u ɭ d a̠
슈퍼스타	ɕʰ u pʰ ʌ̹ sʰ ɯ tʰ a̠
운동량	uː n d o̞ ŋ ɲ j a̠ ŋ
결론	k j ʌ̹ ɭ ɭ o̞ n
일자	i ʎ t͡ɕ͈ a̠
우비다	u b i d a̠
까막눈	k͈ a̠ m a̠ ŋ n u n
배신하다	p ɛː ɕʰ i n ɦ a̠ d a̠
영사	j ʌ̹ ŋ sʰ a̠
경련	k j ʌ̹ ŋ ɲ j ʌ̹ n
사르르	sʰ a̠ ɾ ɯ ɾ ɯ
오케이	o̞ kʰ e̞ i
정변	t͡ɕ ʌ̹ ŋ b j ʌ̹ n
구류	k u ɾ j u
습관	sʰ ɯ p̚ k͈ w a̠ n
테러범	tʰ e̞ ɾ ʌ̹ b ʌ̹ m
건강히	k ɘː n ɡ a̠ ŋ ʝ i
마을	m a̠ ɯ ɭ
오뎅	o̞ d e̞ ŋ
탈조선	tʰ a̠ ʎ d͡ʑ o̞ sʰ ʌ̹ n
악성	a̠ k s͈ ʌ̹ ŋ
꽃병	k͈ o̞ t̚ p͈ j ʌ̹ ŋ
사우나	sʰ a̠ u n a̠
톈	tʰ j e̞ n
불쌍놈	p uː ɭ s͈ a̠ ŋ n o̞ m
솔	sʰ o̞ ɭ
여인	j ʌ̹ i n
야식	j a̠ː ɕʰ i k̚
교활하다	k j o β w a̠ ɾ ɦ a̠ d a̠
친정	t͡ɕʰ i ɲ d͡ʑ ʌ̹ ŋ
적극적	t͡ɕ ʌ̹ k̚ k͈ ɯ k̚ t͡ɕ͈ ʌ̹ k̚
셈판	sʰ e̞ː m pʰ a̠ n
데려오다	t e̞ ɾ j ʌ̹ o̞ d a̠
육지	j u k̚ t͡ɕ͈ i
량반	ɾ j a̠ ŋ b a̠ n
알리바바	a̠ ʎ ʎ i b a̠ b a̠
오라버님	o̞ ɾ a̠ b ʌ̹ n i m
고라니	k o̞ ɾ a̠ n i
애국자	ɛː ɡ u k̚ t͡ɕ͈ a̠
본질	p o̞ ɲ d͡ʑ i ɭ
텔펜	tʰ e̞ ɭ pʰ e̞ n
억류	ʌ̹ ŋ ɲ j u
질투	t͡ɕ i ɭ tʰ u
체육관	t͡ɕʰ e̞ j u k̚ k͈ w a̠ n
착하다	t͡ɕʰ a̠ kʰ a̠ d a̠
정치적	t͡ɕ ʌ̹ ŋ t͡ɕʰ i d͡ʑ ʌ̹ k̚
끊다	k͈ ɯ n tʰ a̠
에	e̞
척수	t͡ɕʰ ʌ̹ k s͈ u
인도	i n d o̞
검술	k ɘː m sʰ u ɭ
졸다	t͡ɕ o̞ː ɭ d a̠
떼	t͈ e̞
이스라엘	i sʰ ɯ ɾ a̠ e̞ ɭ
더	t ʌ̹
삼한	sʰ a̠ m ɦ a̠ n
옷	o̞ t̚
예술가	j e̞ː sʰ u ɭ ɡ a̠
일반적	i ɭ b a̠ ɲ d͡ʑ ʌ̹ k̚
민화	m i n β w a̠
왼쪽	w e̞ː ɲ t͡ɕ͈ o̞ k̚
상업	sʰ a̠ ŋ ʌ̹ p̚
상당하다	sʰ a̠ ŋ d a̠ ŋ ɦ a̠ d a̠
스케이트보드	sʰ ɯ kʰ e̞ i tʰ ɯ b o̞ d ɯ
부줌부라	p u d͡ʑ u m b u ɾ a̠
알려지다	a̠ ʎ ʎ j ʌ̹ d͡ʑ i d a̠
청진기	t͡ɕʰ ʌ̹ ŋ d͡ʑ i n ɡ i
범죄자	p ɘː m d͡ʑ w e̞ d͡ʑ a̠
논의	n o̞ n ɰ i
씹	ɕ͈ i p̚
방송	p a̠ː ŋ sʰ o̞ ŋ
노른자위	n o̞ ɾ ɯ ɲ d͡ʑ a̠ ɥ i
집어넣다	t͡ɕ i b ʌ̹ n ʌ̹ tʰ a̠
마우자	m a̠ u d͡ʑ a̠
동일하다	t o̞ ŋ i ɾ ɦ a̠ d a̠
콜라보	kʰ o̞ ɭ ɭ a̠ b o̞
라임	ɾ a̠ i m
바냐	p a̠ ɲ j a̠
접종하다	t͡ɕ ʌ̹ p̚ t͡ɕ͈ o̞ ŋ ɦ a̠ d a̠
부딪치다	p u d i t̚ t͡ɕʰ i d a̠
아브라함	a̠ b ɯ ɾ a̠ ɦ a̠ m
용감하다	j oː ŋ ɡ a̠ m ɦ a̠ d a̠
화장실	ɸ w a̠ d͡ʑ a̠ ŋ ɕʰ i ɭ
단추	t a̠ ɲ t͡ɕʰ u
신시아	ɕʰ i n ɕʰ i a̠
건너편	k ɘː n n ʌ̹ pʰ j ʌ̹ n
괭이	k w ɛː ŋ i
사향고양이	sʰ a̠ ʝ j a̠ ŋ ɡ o̞ j a̠ ŋ i
소용돌이	sʰ o̞ j o ŋ d o̞ ɾ i
ㅈㅅ	t͡ɕ w e̞ sʰ o̞ ŋ
마누라	m a̠ n u ɾ a̠
총각	t͡ɕʰ o̞ː ŋ ɡ a̠ k̚
의제	ɰ i d͡ʑ e̞
짱꼴라	t͡ɕ͈ a̠ ŋ k͈ o̞ ɭ ɭ a̠
잠깐	t͡ɕ a̠ m k͈ a̠ n
털어놓다	tʰ ʌ̹ ɾ ʌ̹ n o̞ tʰ a̠
웹	w e̞ p̚
토스터	tʰ o̞ sʰ ɯ tʰ ʌ̹
밝쥐	p a̠ k̚ t͡ɕ͈ ɥ i
계속되다	k j e̞ː sʰ o̞ k̚ t͈ w e̞ d a̠
청하다	t͡ɕʰ ʌ̹ ŋ ɦ a̠ d a̠
카나	kʰ a̠ n a̠
품질	pʰ uː m d͡ʑ i ɭ
흙	x ɯ k̚
숙답	sʰ u k̚ t͈ a̠ p̚
가지	k a̠ d͡ʑ i
이곳	i ɡ o̞ t̚
체적	t͡ɕʰ e̞ d͡ʑ ʌ̹ k̚
감기다	k a̠ m ɡ i d a̠
유두	j u d u
카보베르데	kʰ a̠ b o̞ b e̞ ɾ ɯ d e̞
점주	t͡ɕ ʌ̹ m d͡ʑ u
신기루	ɕʰ iː n ɡ i ɾ u
죄수	t͡ɕ w e̞ sʰ u
잠그다	t͡ɕ a̠ m ɡ ɯ d a̠
능격	n ɯ ŋ ɡ j ʌ̹ k̚
미녀	m iː ɲ j ʌ̹
스펀지	sʰ ɯ pʰ ʌ̹ ɲ d͡ʑ i
범인	p ɘː m i n
마리	m a̠ ɾ i
혼란	ɸʷ o̞ː ɭ ɭ a̠ n
방공	p a̠ ŋ ɡ o̞ ŋ
나폴리	n a̠ pʰ o̞ ʎ ʎ i
속옷	sʰ o̞ː ɡ o̞ t̚
화분	ɸ w a̠ b u n
수호	sʰ u β o̞
덮밥	t ʌ̹ p̚ p͈ a̠ p̚
인터뷰	i n tʰ ʌ̹ b j u
고모부	k o̞ m o̞ b u
넋	n ʌ̹ k̚
제공	t͡ɕ e̞ ɡ o̞ ŋ
사천	sʰ a̠ t͡ɕʰ ʌ̹ n
전골	t͡ɕ ɘː n ɡ o̞ ɭ
여진	j ʌ̹ d͡ʑ i n
공산당	k o̞ ŋ sʰ a̠ n d a̠ ŋ
동물학	t o̞ ŋ m u ɾ ɦ a̠ k̚
그림엽서	k ɯː ɾ i m j ʌ̹ p s͈ ʌ̹
텅스텐	tʰ ʌ̹ ŋ sʰ ɯ tʰ e̞ n
왕	w a̠ ŋ
전치사	t͡ɕ ʌ̹ ɲ t͡ɕʰ i sʰ a̠
꼬리치레도롱뇽	k͈ o̞ ɾ i t͡ɕʰ i ɾ e̞ d o̞ ɾ o̞ ŋ ɲ j o ŋ
수리하다	sʰ u ɾ i ɦ a̠ d a̠
이분	i b u n
광	k w a̠ ŋ
드르렁드르렁	t ɯ ɾ ɯ ɾ ʌ̹ ŋ d ɯ ɾ ɯ ɾ ʌ̹ ŋ
도달하다	t o̞ː d a̠ ɾ ɦ a̠ d a̠
서서히	sʰ ɘː sʰ ʌ̹ ʝ i
독극물	t o̞ k̚ k͈ ɯ ŋ m u ɭ
이유	iː j u
유출	j u t͡ɕʰ u ɭ
동안	t o̞ ŋ a̠ n
식다	ɕʰ i k̚ t͈ a̠
거미	k ʌ̹ m i
신놀린	ɕʰ i n n o̞ ʎ ʎ i n
진짜	t͡ɕ i ɲ t͡ɕ͈ a̠
자기	t͡ɕ a̠ ɡ i
오리나무	o̞ ɾ i n a̠ m u
쿠데타	kʰ u d e̞ tʰ a̠
품삯	pʰ u m s͈ a̠ k̚
더듬이다리	t ʌ̹ d ɯ m i d a̠ ɾ i
여섯	j ʌ̹ sʰ ʌ̹ t̚
기기	k i ɡ i
서표	sʰ ʌ̹ pʰ j o
괴뢰	k w e̞ː ɾ w e̞
가락지	k a̠ ɾ a̠ k̚ t͡ɕ͈ i
군관	k u n ɡ w a̠ n
인	i n
놀이기구	n o̞ ɾ i ɡ i ɡ u
남장	n a̠ m d͡ʑ a̠ ŋ
압박	a̠ p̚ p͈ a̠ k̚
감소	k a̠ː m sʰ o̞
자료	t͡ɕ a̠ ɾ j o
서로	sʰ ʌ̹ ɾ o̞
아홉	a̠ β o̞ p̚
여관	j ʌ̹ ɡ w a̠ n
간단하다	k a̠ n t͈ a̠ n ɦ a̠ d a̠
동지	t o̞ ŋ d͡ʑ i
폍	pʰ j ʌ̹ t̚
단고기	t a̠ n ɡ o̞ ɡ i
곱다랗다	k o̞ː p̚ t͈ a̠ ɾ a̠ tʰ a̠
녕	ɲ j ʌ̹ ŋ
꼬리지느러미	k͈ o̞ ɾ i d͡ʑ i n ɯ ɾ ʌ̹ m i
의식하다	ɰ iː ɕʰ i kʰ a̠ d a̠
카르볼린	kʰ a̠ ɾ ɯ b o̞ ʎ ʎ i n
녁	ɲ j ʌ̹ k̚
서식지	sʰ ʌ̹ ɕʰ i k̚ t͡ɕ͈ i
엘살바도르	e̞ ɭ sʰ a̠ ɭ b a̠ d o̞ ɾ ɯ
노르웨이	n o̞ ɾ ɯ w e̞ i
연속극	j ʌ̹ n sʰ o̞ k̚ k͈ ɯ k̚
훨씬	ɸ w ʌ̹ ɭ ɕ͈ i n
시작되다	ɕʰ iː d͡ʑ a̠ k̚ t͈ w e̞ d a̠
자녀	t͡ɕ a̠ ɲ j ʌ̹
메히꼬	m e̞ ʝ i k͈ o̞
물시계	m u ɭ ɕ͈ i ɡ j e̞
말씀	m a̠ː ɭ s͈ ɯ m
드라마	t ɯ ɾ a̠ m a̠
기모노	k i m o̞ n o̞
파자마	pʰ a̠ d͡ʑ a̠ m a̠
꼴사납다	k͈ o̞ ɭ sʰ a̠ n a̠ p̚ t͈ a̠
인치	i ɲ t͡ɕʰ i
자정	t͡ɕ a̠ d͡ʑ ʌ̹ ŋ
납자루	n a̠ p̚ t͡ɕ͈ a̠ ɾ u
꺽정이	k͈ ʌ̹ k̚ t͡ɕ͈ ʌ̹ ŋ i
바다말	p a̠ d a̠ m a̠ ɭ
사회학	sʰ a̠ β w e̞ ɦ a̠ k̚
판단	pʰ a̠ n d a̠ n
산소	sʰ a̠ n sʰ o̞
어파	ɘː pʰ a̠
아주머니	a̠ d͡ʑ u m ʌ̹ n i
펫	pʰ e̞ t̚
모세혈관	m o̞ sʰ e̞ ʝ j ʌ̹ ɭ ɡ w a̠ n
허리띠	h ʌ̹ ɾ i t͈ i
거르다	k ʌ̹ ɾ ɯ d a̠
이도	i d o̞
밥집	p a̠ p̚ t͡ɕ͈ i p̚
방석집	p a̠ ŋ sʰ ʌ̹ k̚ t͡ɕ͈ i p̚
결과적	k j ʌ̹ ɭ ɡ w a̠ d͡ʑ ʌ̹ k̚
용이하다	j o ŋ i ɦ a̠ d a̠
이야기	i j a̠ ɡ i
심리학	ɕʰ i m n i ɦ a̠ k̚
주말	t͡ɕ u m a̠ ɭ
뻐꾸기	p͈ ʌ̹ k͈ u ɡ i
무탈	m u tʰ a̠ ɭ
발	p a̠ː ɭ
낙제	n a̠ k̚ t͡ɕ͈ e̞
누군가	n u ɡ u n ɡ a̠
공연	k o̞ ŋ j ʌ̹ n
영양제	j ʌ̹ ŋ j a̠ ŋ d͡ʑ e̞
부	p uː
촉수	t͡ɕʰ o̞ k s͈ u
세	sʰ e̞ː
악한	a̠ kʰ a̠ n
가미카제	k a̠ m i kʰ a̠ d͡ʑ e̞
스틱	sʰ ɯ tʰ i k̚
보고하다	p o̞ː ɡ o̞ ɦ a̠ d a̠
경찰관	k j ɘː ŋ t͡ɕʰ a̠ ɭ ɡ w a̠ n
꼴	k͈ o̞ ɭ
회합	ɸ w e̞ː ɦ a̠ p̚
낙하산	n a̠ kʰ a̠ sʰ a̠ n
어뢰	ʌ̹ ɾ w e̞
엉망	ʌ̹ ŋ m a̠ ŋ
전술	t͡ɕ ɘː n sʰ u ɭ
크림	k x ɯ ɾ i m
찧다	t͡ɕ͈ i tʰ a̠
선거하다	sʰ ɘː n ɡ ʌ̹ ɦ a̠ d a̠
산스크리트어	sʰ a̠ n sʰ ɯ k x ɯ ɾ i tʰ ɯ ʌ̹
반립자	p a̠ ʎ ʎ i p̚ t͡ɕ͈ a̠
회의하다	ɸ w e̞ ɰ i ɦ a̠ d a̠
육분의	j u k̚ p͈ u n ɰ i
수준	sʰ u d͡ʑ u n
가능하다	k a̠ː n ɯ ŋ ɦ a̠ d a̠
겨를	k j ʌ̹ ɾ ɯ ɭ
사진빨	sʰ a̠ d͡ʑ i n p͈ a̠ ɭ
잉어	iː ŋ ʌ̹
봉사	p o̞ː ŋ sʰ a̠
동거인	t o̞ ŋ ɡ ʌ̹ i n
친절하다	t͡ɕʰ i ɲ d͡ʑ ʌ̹ ɾ ɦ a̠ d a̠
센트	sʰ e̞ n tʰ ɯ
더빙	t ʌ̹ b i ŋ
건너다	k ɘː n n ʌ̹ d a̠
영본	j ʌ̹ ŋ b o̞ n
살금살금	sʰ a̠ ɭ ɡ ɯ m sʰ a̠ ɭ ɡ ɯ m
서강	sʰ ʌ̹ ɡ a̠ ŋ
수소	sʰ u sʰ o̞
소	sʰ o̞
프랑슘	pʰ ɯ ɾ a̠ ŋ ɕʰ u m
불교	p u ɭ ɡ j o
연방	j ʌ̹ n b a̠ ŋ
배심원	p ɛː ɕʰ i m w ʌ̹ n
달러	t a̠ ɭ ɭ ʌ̹
화지	ɸ w a̠ d͡ʑ i
청각	t͡ɕʰ ʌ̹ ŋ ɡ a̠ k̚
갈아입다	k a̠ ɾ a̠ i p̚ t͈ a̠
설날	sʰ ɘː ɭ ɭ a̠ ɭ
안녕하다	a̠ n ɲ j ʌ̹ ŋ ɦ a̠ d a̠
자지	t͡ɕ a̠ː d͡ʑ i
원족	w ʌ̹ ɲ d͡ʑ o̞ k̚
애무하다	ɛː m u ɦ a̠ d a̠
춤추다	t͡ɕʰ u m t͡ɕʰ u d a̠
얶	ʌ̹ k̚
바이블	p a̠ i b ɯ ɭ
중반	t͡ɕ u ŋ b a̠ n
원자력	w ʌ̹ ɲ d͡ʑ a̠ ɾ j ʌ̹ k̚
두려워하다	t u ɾ j ʌ̹ w ʌ̹ ɦ a̠ d a̠
특별	tʰ ɯ k̚ p͈ j ʌ̹ ɭ
방앗간	p a̠ ŋ a̠ t̚ k͈ a̠ n
한가위	h a̠ n ɡ a̠ ɥ i
계사	k j e̞ː sʰ a̠
방편	p a̠ ŋ pʰ j ʌ̹ n
주교	t͡ɕ u ɡ j o
따름	t͈ a̠ ɾ ɯ m
지하드	t͡ɕ i ɦ a̠ d ɯ
열심히	j ʌ̹ ɭ ɕ͈ i m ʝ i
반동분자	p a̠ː n d o̞ ŋ b u ɲ d͡ʑ a̠
충전기	t͡ɕʰ u ŋ d͡ʑ ʌ̹ n ɡ i
트럼프	tʰ ɯ ɾ ʌ̹ m pʰ ɯ
전학	t͡ɕ ɘː n ɦ a̠ k̚
로동자구	ɾ o̞ d o̞ ŋ d͡ʑ a̠ ɡ u
계급	k j e̞ ɡ ɯ p̚
흔적	x ɯ ɲ d͡ʑ ʌ̹ k̚
회견	ɸ w e̞ː ɡ j ʌ̹ n
피스톨	pʰ i sʰ ɯ tʰ o̞ ɭ
도리	t o̞ː ɾ i
블루진	p ɯ ɭ ɭ u d͡ʑ i n
상완삼두근	sʰ a̠ ŋ w a̠ n sʰ a̠ m d u ɡ ɯ n
한국말	h a̠ː n ɡ u ŋ m a̠ ɭ
찌다	t͡ɕ͈ i d a̠
통계	tʰ o̞ː ŋ ɡ j e̞
유모	j u m o̞
일반	i ɭ b a̠ n
종	t͡ɕ o̞ ŋ
반죽	p a̠ ɲ d͡ʑ u k̚
여건	j ɘː ɡ ʌ̹ n
대두어	t ɛː d u ʌ̹
어찌	ʌ̹ t͡ɕ͈ i
칠	t͡ɕʰ i ɭ
솔	sʰ o̞ː ɭ
오류	o̞ː ɾ j u
국적	k u k̚ t͡ɕ͈ ʌ̹ k̚
우물	u m u ɭ
대리점	t ɛː ɾ i d͡ʑ ʌ̹ m
펳	pʰ e̞ t̚
탐험	tʰ a̠ m ɦ ʌ̹ m
조사하다	t͡ɕ o̞ sʰ a̠ ɦ a̠ d a̠
각막	k a̠ ŋ m a̠ k̚
지지	t͡ɕ i d͡ʑ i
광서	k w a̠ ŋ sʰ ʌ̹
터널	tʰ ʌ̹ n ʌ̹ ɭ
줄기	t͡ɕ u ɭ ɡ i
쑥	s͈ u k̚
전상장골극	t͡ɕ ʌ̹ n sʰ a̠ ŋ d͡ʑ a̠ ŋ ɡ o̞ ɭ ɡ ɯ k̚
빗장뼈	p i t̚ t͡ɕ͈ a̠ ŋ p͈ j ʌ̹
환경오염	ɸ w a̠ n ɡ j ʌ̹ ŋ o̞ j ʌ̹ m
제주땃쥐	t͡ɕ e̞ d͡ʑ u t͈ a̠ t̚ t͡ɕ͈ ɥ i
귀국	k ɥ iː ɡ u k̚
사상	sʰ a̠ː sʰ a̠ ŋ
분리주의	p u ʎ ʎ i d͡ʑ u ɰ i
나치	n a̠ t͡ɕʰ i
타이	tʰ a̠ i
참마자	t͡ɕʰ a̠ m m a̠ d͡ʑ a̠
스럽다	sʰ ɯ ɾ ʌ̹ p̚ t͈ a̠
울란바토르	u ɭ ɭ a̠ n b a̠ tʰ o̞ ɾ ɯ
후작	ɸʷ u d͡ʑ a̠ k̚
어드벤처	ʌ̹ d ɯ b e̞ ɲ t͡ɕʰ ʌ̹
안전하다	a̠ ɲ d͡ʑ ʌ̹ n ɦ a̠ d a̠
큰	k x ɯ n
멍멍	m ʌ̹ ŋ m ʌ̹ ŋ
활동하다	ɸ w a̠ ɭ t͈ o̞ ŋ ɦ a̠ d a̠
인민	i n m i n
출원자	t͡ɕʰ u ɾ w ʌ̹ ɲ d͡ʑ a̠
창세기	t͡ɕʰ a̠ ŋ sʰ e̞ ɡ i
유머	j u m ʌ̹
큰집박쥐	k x ɯ ɲ d͡ʑ i p̚ p͈ a̠ k̚ t͡ɕ͈ ɥ i
비난하다	p iː n a̠ n ɦ a̠ d a̠
추리닝	t͡ɕʰ u ɾ i n i ŋ
온돌	o̞ n d o̞ ɭ
조만간	t͡ɕ o̞ː m a̠ n ɡ a̠ n
고급	k o̞ ɡ ɯ p̚
할로윈	h a̠ ɭ ɭ o̞ ɥ i n
성취	sʰ ʌ̹ ŋ t͡ɕʰ ɥ i
공로	k o̞ ŋ n o̞
아서	a̠ sʰ ʌ̹
포로	pʰ o̞ː ɾ o̞
밀	m iː ɭ
리비도	ɾ i b i d o̞
비슷하다	p i sʰ ɯ tʰ a̠ d a̠
그치다	k ɯ t͡ɕʰ i d a̠
꺽저구	k͈ ʌ̹ k̚ t͡ɕ͈ ʌ̹ ɡ u
장교	t͡ɕ a̠ː ŋ ɡ j o
을게	ɯ ɭ k͈ e̞
민수기	m i n sʰ u ɡ i
떫디떫다	t͈ ɘː ɭ t͈ i t͈ ʌ̹ ɭ t͈ a̠
나루	n a̠ ɾ u
대학수학능력시험	t ɛː ɦ a̠ k s͈ u ɦ a̠ ŋ n ɯ ŋ ɲ j ʌ̹ k ɕ͈ i ɦ ʌ̹ m
탕	tʰ a̠ː ŋ
학술	h a̠ k s͈ u ɭ
저기	t͡ɕ ʌ̹ ɡ i
지역	t͡ɕ i j ʌ̹ k̚
남용	n a̠ː m j o ŋ
답정너	t a̠ p̚ t͡ɕ͈ ʌ̹ ŋ n ʌ̹
의원	ɰ i w ʌ̹ n
떼아트르	t͈ e̞ a̠ tʰ ɯ ɾ ɯ
방지	p a̠ ŋ d͡ʑ i
목사	m o̞ k s͈ a̠
예비	j e̞ b i
분명하다	p u n m j ʌ̹ ŋ ɦ a̠ d a̠
문방	m u n b a̠ ŋ
수간	sʰ u ɡ a̠ n
신체	ɕʰ i ɲ t͡ɕʰ e̞
뜯다	t͈ ɯ t̚ t͈ a̠
올리브	o̞ ʎ ʎ i b ɯ
폴란드	pʰ o̞ ɭ ɭ a̠ n d ɯ
켕기다	kʰ e̞ ŋ ɡ i d a̠
짱뚱어	t͡ɕ͈ a̠ ŋ t͈ u ŋ ʌ̹
믿다	m i t̚ t͈ a̠
문화원	m uː n β w a̠ w ʌ̹ n
녀성중음	ɲ j ʌ̹ sʰ ʌ̹ ŋ d͡ʑ u ŋ ɯ m
간지	k a̠ ɲ d͡ʑ i
단발	t a̠ː n b a̠ ɭ
공습	k o̞ː ŋ sʰ ɯ p̚
매음굴	m ɛː ɯ m ɡ u ɭ
참여	t͡ɕʰ a̠ m j ʌ̹
그리	k ɯ ɾ i
커플	kʰ ʌ̹ pʰ ɯ ɭ
광년	k w a̠ ŋ ɲ j ʌ̹ n
포트	pʰ o̞ tʰ ɯ
속이다	sʰ o̞ ɡ i d a̠
싸다	s͈ a̠ d a̠
연흔	j ʌ̹ n ɣ ɯ n
들숨	t ɯ ɭ sʰ u m
모형	m o̞ ʝ j ʌ̹ ŋ
작작	t͡ɕ a̠ k̚ t͡ɕ͈ a̠ k̚
애칭	ɛː t͡ɕʰ i ŋ
예정	j e̞ː d͡ʑ ʌ̹ ŋ
날고기	n a̠ ɭ ɡ o̞ ɡ i
체스	t͡ɕʰ e̞ sʰ ɯ
물망초	m u ɭ m a̠ ŋ t͡ɕʰ o̞
제단	t͡ɕ e̞ː d a̠ n
모레	m o̞ː ɾ e̞
가가우스어	k a̠ ɡ a̠ u sʰ ɯ ʌ̹
가숭어	k a̠ː sʰ u ŋ ʌ̹
물러나다	m u ɭ ɭ ʌ̹ n a̠ d a̠
우레	uː ɾ e̞
코멘트	kʰ o̞ m e̞ n tʰ ɯ
대전	t ɛː d͡ʑ ʌ̹ n
타타르어	tʰ a̠ tʰ a̠ ɾ ɯ ʌ̹
따사롭다	t͈ a̠ sʰ a̠ ɾ o̞ p̚ t͈ a̠
찡그리다	t͡ɕ͈ i ŋ ɡ ɯ ɾ i d a̠
레코드	ɾ e̞ kʰ o̞ d ɯ
망명	m a̠ ŋ m j ʌ̹ ŋ
가곡	k a̠ ɡ o̞ k̚
중부	t͡ɕ u ŋ b u
빈자	p i ɲ d͡ʑ a̠
와봐	w a̠ː b w a̠
아무리	a̠ː m u ɾ i
절차	t͡ɕ ʌ̹ ʎ t͡ɕʰ a̠
늦추다	n ɯ t̚ t͡ɕʰ u d a̠
장가	t͡ɕ a̠ː ŋ ɡ a̠
계	k j e̞
아씨	a̠ː ɕ͈ i
잔혹	t͡ɕ a̠ n β o̞ k̚
실	ɕʰ i ɭ
거세다	k ʌ̹ sʰ e̞ d a̠
노동	n o̞ d o̞ ŋ
카타르	kʰ a̠ tʰ a̠ ɾ ɯ
미국인	m i ɡ u ɡ i n
취하다	t͡ɕʰ ɥ iː ɦ a̠ d a̠
아무렇다	a̠ː m u ɾ ʌ̹ tʰ a̠
낡다	n a̠ k̚ t͈ a̠
아그라	a̠ ɡ ɯ ɾ a̠
피리다진	pʰ i ɾ i d a̠ d͡ʑ i n
빙빙	p i ŋ b i ŋ
음문	ɯ m m u n
차장	t͡ɕʰ a̠ d͡ʑ a̠ ŋ
온갖	o̞ n ɡ a̠ t̚
양상	j a̠ ŋ sʰ a̠ ŋ
대천사	t ɛː t͡ɕʰ ʌ̹ n sʰ a̠
프테린	pʰ ɯ tʰ e̞ ɾ i n
야훼	j a̠ β w e̞
여성스럽다	j ʌ̹ sʰ ʌ̹ ŋ sʰ ɯ ɾ ʌ̹ p̚ t͈ a̠
음료	ɯː m ɲ j o
파스닙	pʰ a̠ sʰ ɯ n i p̚
불거지다	p u ɭ ɡ ʌ̹ d͡ʑ i d a̠
수면	sʰ u m j ʌ̹ n
기만하다	k i m a̠ n ɦ a̠ d a̠
불치병	p u ʎ t͡ɕʰ i p͈ j ʌ̹ ŋ
ㄴㄴ	n o̞ n o̞
퇴위	tʰ w e̞ ɥ i
봇짐	p o̞ t̚ t͡ɕ͈ i m
구르다	k uː ɾ ɯ d a̠
하이픈	h a̠ i pʰ ɯ n
주의	t͡ɕ u ɰ i
노동법	n o̞ d o̞ ŋ p͈ ʌ̹ p̚
벗	p ɘː t̚
실리다	ɕʰ i ʎ ʎ i d a̠
응접	ɯ ŋ d͡ʑ ʌ̹ p̚
기계	k i ɡ j e̞
야자유	j a̠ː d͡ʑ a̠ j u
글리세린	k ɯ ʎ ʎ i sʰ e̞ ɾ i n
목면	m o̞ ŋ m j ʌ̹ n
하천	h a̠ t͡ɕʰ ʌ̹ n
게이샤	k e̞ i ɕʰ a̠
옻	o̞ t̚
안마당	a̠ n m a̠ d a̠ ŋ
퍅	pʰ j a̠ k̚
사물	sʰ a̠ː m u ɭ
고릴라	k o̞ ɾ i ɭ ɭ a̠
갈음하다	k a̠ ɾ ɯ m ɦ a̠ d a̠
빠리	p͈ a̠ ɾ i
열역학	j ʌ̹ ʎ ʎ j ʌ̹ kʰ a̠ k̚
마	m a̠
십이	ɕʰ i b i
아무르강	a̠ m u ɾ ɯ ɡ a̠ ŋ
아이슬란드	a̠ i sʰ ɯ ɭ ɭ a̠ n d ɯ
오븐	o̞ b ɯ n
물리화학	m uː ʎ ʎ i β w a̠ ɦ a̠ k̚
삼십육계	sʰ a̠ m ɕʰ i b j u k̚ k͈ j e̞
룩셈부르크	ɾ u k s͈ e̞ m b u ɾ ɯ k x ɯ
줴치다	t͡ɕ w e̞ː t͡ɕʰ i d a̠
부여	p u j ʌ̹
미학	m iː ɦ a̠ k̚
꽃말	k͈ o̞ n m a̠ ɭ
부젓가락	p u d͡ʑ ʌ̹ t̚ k͈ a̠ ɾ a̠ k̚
뱅어	p ɛː ŋ ʌ̹
항의	h a̠ː ŋ ɰ i
리히텐슈타인	ɾ i ʝ i tʰ e̞ n ɕʰ u tʰ a̠ i n
중앙아메리카	t͡ɕ u ŋ a̠ ŋ a̠ m e̞ ɾ i kʰ a̠
덜	t ɘː ɭ
화살	ɸ w a̠ sʰ a̠ ɭ
틀다	tʰ ɯ ɭ d a̠
반딧불이	p a̠ n d i t̚ p͈ u ɾ i
정답다	t͡ɕ ʌ̹ ŋ d a̠ p̚ t͈ a̠
홀뮴	ɸʷ o̞ ɭ m j u m
목젖	m o̞ k̚ t͡ɕ͈ ʌ̹ t̚
통솔자	tʰ o̞ ŋ sʰ o̞ ʎ d͡ʑ a̠
표현하다	pʰ j o ʝ j ʌ̹ n ɦ a̠ d a̠
지방	t͡ɕ i b a̠ ŋ
비추다	p i t͡ɕʰ u d a̠
부터	p u tʰ ʌ̹
거야	k ɘː j a̠
외숙모	w e̞ sʰ u ŋ m o̞
빙어	p i ŋ ʌ̹
유전학	j u d͡ʑ ʌ̹ n ɦ a̠ k̚
아지	a̠ d͡ʑ i
견본	k j ɘː n b o̞ n
물고기알	m u ɭ ɡ o̞ ɡ i a̠ ɭ
불륜	p u ʎ ʎ j u n
가르침	k a̠ ɾ ɯ t͡ɕʰ i m
플라스틱	pʰ ɯ ɭ ɭ a̠ sʰ ɯ tʰ i k̚
폐하	pʰ j e̞ː ɦ a̠
크루아상	k x ɯ ɾ u a̠ sʰ a̠ ŋ
시물	ɕʰ i m u ɭ
구절	k u d͡ʑ ʌ̹ ɭ
립스틱	ɾ i p s͈ ɯ tʰ i k̚
서남	sʰ ʌ̹ n a̠ m
판자	pʰ a̠ ɲ d͡ʑ a̠
체험	t͡ɕʰ e̞ ɦ ʌ̹ m
횡단보도	ɸ w e̞ ŋ d a̠ n b o̞ d o̞
탈락	tʰ a̠ ɭ ɭ a̠ k̚
끽	k͈ i k̚
말하다	m a̠ː ɾ ɦ a̠ d a̠
묵납자루	m u ŋ n a̠ p̚ t͡ɕ͈ a̠ ɾ u
전문	t͡ɕ ʌ̹ n m u n
게시판	k e̞ː ɕʰ i pʰ a̠ n
후계자	ɸʷ u ɡ j e̞ d͡ʑ a̠
공중전화	k o̞ ŋ d͡ʑ u ŋ d͡ʑ ʌ̹ n β w a̠
소방수	sʰ o̞ b a̠ ŋ sʰ u
강화도	k a̠ ŋ β w a̠ d o̞
신기	ɕʰ i n ɡ i
서과	sʰ ʌ̹ ɡ w a̠
링	ɾ i ŋ
요건	j o k͈ ʌ̹ n
심심하다	ɕʰ i m ɕʰ i m ɦ a̠ d a̠
하노이	h a̠ n o̞ i
지르코늄	t͡ɕ i ɾ ɯ kʰ o̞ ɲ j u m
졸업하다	t͡ɕ o̞ ɾ ʌ̹ pʰ a̠ d a̠
불	p uː ɭ
좌우	t͡ɕ w a̠ː u
핍박	pʰ i p̚ p͈ a̠ k̚
충수	t͡ɕʰ u ŋ sʰ u
음향양자	ɯ m ʝ j a̠ ŋ j a̠ ŋ d͡ʑ a̠
꾸바	k͈ u b a̠
게이기	k e̞ i ɡ i
초롱초롱	t͡ɕʰ o̞ ɾ o̞ ŋ t͡ɕʰ o̞ ɾ o̞ ŋ
관계자	k w a̠ n ɡ j e̞ d͡ʑ a̠
단물약	t a̠ n m u ɾ j a̠ k̚
고고학	k o̞ ɡ o̞ ɦ a̠ k̚
약점	j a̠ k̚ t͡ɕ͈ ʌ̹ m
방송간섭	p a̠ː ŋ sʰ o̞ ŋ ɡ a̠ n sʰ ʌ̹ p̚
뺄셈	p͈ ɛː ɭ sʰ e̞ m
우려	u ɾ j ʌ̹
하퇴삼두근	h a̠ tʰ w e̞ sʰ a̠ m d u ɡ ɯ n
계간	k j e̞ ɡ a̠ n
제도	t͡ɕ e̞ d o̞
빨리	p͈ a̠ ʎ ʎ i
결혼식	k j ʌ̹ ɾ β o̞ n ɕʰ i k̚
비번	p i b ʌ̹ n
초콜렛	t͡ɕʰ o̞ kʰ o̞ ɭ ɭ e̞ t̚
헤이룽장	h e̞ i ɾ u ŋ d͡ʑ a̠ ŋ
집들	t͡ɕ i p̚ t͈ ɯ ɭ
투자	tʰ u d͡ʑ a̠
자살하다	t͡ɕ a̠ sʰ a̠ ɾ ɦ a̠ d a̠
거북이	k ʌ̹ b u ɡ i
무화과	m u β w a̠ ɡ w a̠
유감	j u ɡ a̠ m
경고	k j ɘː ŋ ɡ o̞
모전	m o̞ d͡ʑ ʌ̹ n
해왕성	h ɛː w a̠ ŋ sʰ ʌ̹ ŋ
병들다	p j ɘː ŋ d ɯ ɭ d a̠
제탄	t͡ɕ e̞ː tʰ a̠ n
운동복	uː n d o̞ ŋ b o̞ k̚
머물다	m ʌ̹ m u ɭ d a̠
가늠하다	k a̠ n ɯ m ɦ a̠ d a̠
부끄럽다	p u k͈ ɯ ɾ ʌ̹ p̚ t͈ a̠
연료	j ʌ̹ ʎ ʎ j o
도메인	t o̞ m e̞ i n
성감	sʰ ɘː ŋ ɡ a̠ m
공기방석	k o̞ ŋ ɡ i b a̠ ŋ sʰ ʌ̹ k̚
아쉬움	a̠ ʃʰ ɥ i u m
소형	sʰ o̞ ʝ j ʌ̹ ŋ
도금	t o̞ː ɡ ɯ m
라디오	ɾ a̠ d i o̞
됨됨	t w e̞ m d w e̞ m
숙박	sʰ u k̚ p͈ a̠ k̚
지만	t͡ɕ i m a̠ n
조국	t͡ɕ o̞ ɡ u k̚
로므니아	ɾ o̞ m ɯ n i a̠
사정	sʰ a̠ː d͡ʑ ʌ̹ ŋ
중요시하다	t͡ɕ u ŋ j o ɕʰ i ɦ a̠ d a̠
카이로	kʰ a̠ i ɾ o̞
지나치다	t͡ɕ i n a̠ t͡ɕʰ i d a̠
지정되다	t͡ɕ i d͡ʑ ʌ̹ ŋ d w e̞ d a̠
빙수	p i ŋ sʰ u
들것	t ɯ ɭ ɡ ʌ̹ t̚
높이다	n o̞ pʰ i d a̠
ㅡ	ɯ
유제품	j u d͡ʑ e̞ pʰ u m
조금씩	t͡ɕ o̞ ɡ ɯ m ɕ͈ i k̚
초등학교	t͡ɕʰ o̞ d ɯ ŋ ɦ a̠ k̚ k͈ j o
양초	j a̠ ŋ t͡ɕʰ o̞
약물	j a̠ ŋ m u ɭ
뺏다	p͈ ɛː t̚ t͈ a̠
이외	iː w e̞
열없다	j ɘː ɾ ʌ̹ p̚ t͈ a̠
분명	p u n m j ʌ̹ ŋ
젖통	t͡ɕ ʌ̹ t̚ tʰ o̞ ŋ
회사	ɸ w e̞ː sʰ a̠
노인	n o̞ː i n
신선하다	ɕʰ i n sʰ ʌ̹ n ɦ a̠ d a̠
어라	ʌ̹ ɾ a̠
기발	k i b a̠ ɭ
입술연지	i p s͈ u ʎ ʎ j ʌ̹ ɲ d͡ʑ i
신임	ɕʰ iː n i m
솜	sʰ o̞ m
심방	ɕʰ i m b a̠ ŋ
세례	sʰ e̞ː ɾ j e̞
물음표	m u ɾ ɯ m pʰ j o
솔까말	sʰ o̞ ɭ k͈ a̠ m a̠ ɭ
군소리	k uː n sʰ o̞ ɾ i
변환	p j ɘː n β w a̠ n
나비	n a̠ b i
광고	k w a̠ː ŋ ɡ o̞
대기하다	t ɛː ɡ i ɦ a̠ d a̠
계곡	k j e̞ ɡ o̞ k̚
얼어붙다	ʌ̹ ɾ ʌ̹ b u t̚ t͈ a̠
멜론	m e̞ ɭ ɭ o̞ n
텔레비전	tʰ e̞ ɭ ɭ e̞ b i d͡ʑ ʌ̹ n
미술	m iː sʰ u ɭ
이성	iː sʰ ʌ̹ ŋ
코트	kʰ o̞ tʰ ɯ
포스터	pʰ o̞ sʰ ɯ tʰ ʌ̹
충청남도	t͡ɕʰ u ŋ t͡ɕʰ ʌ̹ ŋ n a̠ m d o̞
시장	ɕʰ i d͡ʑ a̠ ŋ
차용어	t͡ɕʰ a̠ː j o ŋ ʌ̹
피읖	pʰ i ɯ p̚
서명	sʰ ɘː m j ʌ̹ ŋ
꾀병	k͈ w e̞ b j ʌ̹ ŋ
입력기	i m ɲ j ʌ̹ k̚ k͈ i
증기선	t͡ɕ ɯ ŋ ɡ i sʰ ʌ̹ n
모양	m o̞ j a̠ ŋ
디지털	t i d͡ʑ i tʰ ʌ̹ ɭ
얕보다	j a̠ t̚ p͈ o̞ d a̠
지하	t͡ɕ i ɦ a̠
깃털	k i t̚ tʰ ʌ̹ ɭ
문학	m u n ɦ a̠ k̚
닭발	t a̠ k̚ p͈ a̠ ɭ
가창	k a̠ t͡ɕʰ a̠ ŋ
하나	h a̠ n a̠
닌자	n i ɲ d͡ʑ a̠
우산	uː sʰ a̠ n
건의	k ɘː n ɰ i
휘파람	h ɥ i pʰ a̠ ɾ a̠ m
필름	pʰ i ɭ ɭ ɯ m
언제나	ɘː ɲ d͡ʑ e̞ n a̠
전망	t͡ɕ ɘː n m a̠ ŋ
경사	k j ɘː ŋ sʰ a̠
벨로루시	p e̞ ɭ ɭ o̞ ɾ u ɕʰ i
다짐	t a̠ d͡ʑ i m
딸딸이	t͈ a̠ ɭ t͈ a̠ ɾ i
양귀비	j a̠ ŋ ɡ ɥ i b i
악	a̠ k̚
시가전차	ɕʰ i ɡ a̠ d͡ʑ ʌ̹ ɲ t͡ɕʰ a̠
상상력	sʰ a̠ː ŋ sʰ a̠ ŋ ɲ j ʌ̹ k̚
소속	sʰ o̞ː sʰ o̞ k̚
끼우다	k͈ i u d a̠
성구	sʰ ʌ̹ ŋ ɡ u
코소보	kʰ o̞ sʰ o̞ b o̞
차례	t͡ɕʰ a̠ ɾ j e̞
아디스아바바	a̠ d i sʰ ɯ a̠ b a̠ b a̠
여자	j ʌ̹ d͡ʑ a̠
얕다	j a̠ t̚ t͈ a̠
닭쌈	t a̠ k s͈ a̠ m
썬글라스	s͈ ʌ̹ n ɡ ɯ ɭ ɭ a̠ sʰ ɯ
인수	i n sʰ u
셔벗	ɕʰ ʌ̹ b ʌ̹ t̚
멘붕	m e̞ n b u ŋ
눈길	n u n k͈ i ɭ
교황	k j oː β w a̠ ŋ
서커스	sʰ ʌ̹ kʰ ʌ̹ sʰ ɯ
스튜	sʰ ɯ tʰ j u
동료	t o̞ ŋ ɲ j o
사건	sʰ a̠ː k͈ ʌ̹ n
근사하다	k ɯ n sʰ a̠ ɦ a̠ d a̠
몇	m j ʌ̹ t̚
설치	sʰ ʌ̹ ʎ t͡ɕʰ i
몸빛깔	m o̞ m p͈ i t̚ k͈ a̠ ɭ
가구	k a̠ ɡ u
질문	t͡ɕ i ɭ m u n
처남	t͡ɕʰ ʌ̹ n a̠ m
케첩	kʰ e̞ t͡ɕʰ ʌ̹ p̚
보장하다	p o̞ː d͡ʑ a̠ ŋ ɦ a̠ d a̠
사이폰	s͈ a̠ i pʰ o̞ n
봐	p w a̠
경주	k j ɘː ŋ d͡ʑ u
보츠와나	p o̞ t͡ɕʰ ɯ w a̠ n a̠
파출소	pʰ a̠ t͡ɕʰ u ɭ sʰ o̞
폭정	pʰ o̞ k̚ t͡ɕ͈ ʌ̹ ŋ
세탁	sʰ e̞ː tʰ a̠ k̚
목욕	m o̞ ɡ j o k̚
초승달	t͡ɕʰ o̞ sʰ ɯ ŋ t͈ a̠ ɭ
오름	o̞ ɾ ɯ m
뇨소	ɲ j o sʰ o̞
멕시코	m e̞ k ɕ͈ i kʰ o̞
나빠지다	n a̠ p͈ a̠ d͡ʑ i d a̠
라서	ɾ a̠ sʰ ʌ̹
권고	k w ɘː n ɡ o̞
칼리파	kʰ a̠ ʎ ʎ i pʰ a̠
피리미딘	pʰ i ɾ i m i d i n
그루터기	k ɯ ɾ u tʰ ʌ̹ ɡ i
소멸하다	sʰ o̞ m j ʌ̹ ɾ ɦ a̠ d a̠
물론입니다	m u ɭ ɭ o̞ n i m n i d a̠
룡	ɾ j o ŋ
층	t͡ɕʰ ɯ ŋ
렴	ɾ j ʌ̹ m
표절	pʰ j o d͡ʑ ʌ̹ ɭ
탈영자	tʰ a̠ ɾ j ʌ̹ ŋ d͡ʑ a̠
하강	h a̠ː ɡ a̠ ŋ
빼놓다	p͈ ɛː n o̞ tʰ a̠
관련되다	k w a̠ ʎ ʎ j ʌ̹ n d w e̞ d a̠
일자리	iː ʎ t͡ɕ͈ a̠ ɾ i
레바논	ɾ e̞ b a̠ n o̞ n
감돌고기	k a̠ m d o̞ ɭ ɡ o̞ ɡ i
빵	p͈ a̠ ŋ
공동체	k o̞ː ŋ d o̞ ŋ t͡ɕʰ e̞
평소	pʰ j ʌ̹ ŋ sʰ o̞
떡볶이	t͈ ʌ̹ k̚ p͈ o̞ k͈ i
격려	k j ʌ̹ ŋ ɲ j ʌ̹
삐침별	p͈ i t͡ɕʰ i m b j ʌ̹ ɭ
우크라이나어	u k x ɯ ɾ a̠ i n a̠ ʌ̹
비파	p i pʰ a̠
갈등	k a̠ ɭ t͈ ɯ ŋ
그만두다	k ɯ m a̠ n d u d a̠
함부르크	h a̠ m b u ɾ ɯ k x ɯ
테네신	tʰ e̞ n e̞ ɕʰ i n
핍	pʰ i p̚
거문고	k ʌ̹ m u n ɡ o̞
정유	t͡ɕ ʌ̹ ŋ j u
언론	ʌ̹ ɭ ɭ o̞ n
수다	sʰ uː d a̠
검질기다	k ɘː m d͡ʑ i ɭ ɡ i d a̠
대역죄	t ɛː j ʌ̹ k̚ t͡ɕ͈ w e̞
무기	m uː ɡ i
벌꿀	p ɘː ɭ k͈ u ɭ
사이클링	sʰ a̠ i k x ɯ ʎ ʎ i ŋ
과목	k w a̠ m o̞ k̚
하프	h a̠ pʰ ɯ
목발	m o̞ k̚ p͈ a̠ ɭ
망령	m a̠ ŋ ɲ j ʌ̹ ŋ
자르다	t͡ɕ a̠ ɾ ɯ d a̠
녀성저음	ɲ j ʌ̹ sʰ ʌ̹ ŋ d͡ʑ ʌ̹ ɯ m
오치레기	o̞ t͡ɕʰ i ɾ e̞ ɡ i
상당히	sʰ a̠ ŋ d a̠ ŋ ʝ i
거짓	k ɘː d͡ʑ i t̚
펩티드	pʰ e̞ p̚ tʰ i d ɯ
감염증	k a̠ m j ʌ̹ m t͡ɕ͈ ɯ ŋ
숨다	sʰ uː m t͈ a̠
큰물	k x ɯ n m u ɭ
영어	j ʌ̹ ŋ ʌ̹
익	i k̚
놓이다	n o̞ i d a̠
증가	t͡ɕ ɯ ŋ ɡ a̠
이산화탄소	iː sʰ a̠ n β w a̠ tʰ a̠ n sʰ o̞
클로버	k x ɯ ɭ ɭ o̞ b ʌ̹
집중	t͡ɕ i p̚ t͡ɕ͈ u ŋ
엳아홉	j ʌ̹ d a̠ β o̞ p̚
바자르	p a̠ d͡ʑ a̠ ɾ ɯ
시험	ɕʰ i ɦ ʌ̹ m
어묵	ʌ̹ m u k̚
묵가	m uː k̚ k͈ a̠
통념	tʰ o̞ ŋ ɲ j ʌ̹ m
오리너구리	o̞ː ɾ i n ʌ̹ ɡ u ɾ i
룘	ɾ j o ɭ
쓸다	s͈ ɯ ɭ d a̠
채소밭	t͡ɕʰ ɛː sʰ o̞ b a̠ t̚
유독	j uː d o̞ k̚
참다	t͡ɕʰ a̠ː m t͈ a̠
쌈장	s͈ a̠ m d͡ʑ a̠ ŋ
덥다	t ɘː p̚ t͈ a̠
근본	k ɯ n b o̞ n
열다	j ɘː ɭ d a̠
움직이다	u m d͡ʑ i ɡ i d a̠
박스	p a̠ k s͈ ɯ
다양하다	t a̠ j a̠ ŋ ɦ a̠ d a̠
미스터리	m i sʰ ɯ tʰ ʌ̹ ɾ i
비듬	p i d ɯ m
연습곡	j ɘː n sʰ ɯ p̚ k͈ o̞ k̚
살다	sʰ a̠ː ɭ d a̠
겸	k j ʌ̹ m
목마르다	m o̞ ŋ m a̠ ɾ ɯ d a̠
비디오	p i d i o̞
접하다	t͡ɕ ʌ̹ pʰ a̠ d a̠
경보기	k j ɘː ŋ b o̞ ɡ i
흡수지	x ɯ p s͈ u d͡ʑ i
음계	ɯ m ɡ j e̞
턱수염	tʰ ʌ̹ k s͈ u j ʌ̹ m
그다지	k ɯ d a̠ d͡ʑ i
무서움	m u sʰ ʌ̹ u m
섬망	sʰ ʌ̹ m m a̠ ŋ
각	k a̠ k̚
모세관	m o̞ sʰ e̞ ɡ w a̠ n
앉은자리	a̠ ɲ d͡ʑ ɯ ɲ d͡ʑ a̠ ɾ i
러시아말	ɾ ʌ̹ ɕʰ i a̠ m a̠ ɭ
자유적	t͡ɕ a̠ j u d͡ʑ ʌ̹ k̚
박차	p a̠ k̚ t͡ɕʰ a̠
토바고	tʰ o̞ b a̠ ɡ o̞
스테이크	sʰ ɯ tʰ e̞ i k x ɯ
브루나이	p ɯ ɾ u n a̠ i
접수처	t͡ɕ ʌ̹ p s͈ u t͡ɕʰ ʌ̹
정말로	t͡ɕ ɘː ŋ m a̠ ɭ ɭ o̞
화사	ɸ w a̠ sʰ a̠
업	ʌ̹ p̚
거듭씨	k ʌ̹ d ɯ p ɕ͈ i
집쥐	t͡ɕ i p̚ t͡ɕ͈ ɥ i
날아가다	n a̠ ɾ a̠ ɡ a̠ d a̠
오스트리아	o̞ sʰ ɯ tʰ ɯ ɾ i a̠
지류	t͡ɕ i ɾ j u
자업자득	t͡ɕ a̠ ʌ̹ p̚ t͡ɕ͈ a̠ d ɯ k̚
깜짝	k͈ a̠ m t͡ɕ͈ a̠ k̚
편찮다	pʰ j ʌ̹ ɲ t͡ɕʰ a̠ n tʰ a̠
사회	sʰ a̠ β w e̞
모반	m o̞ b a̠ n
두르다	t u ɾ ɯ d a̠
사치품	sʰ a̠ t͡ɕʰ i pʰ u m
월병	w ʌ̹ ɭ b j ʌ̹ ŋ
마이트너륨	m a̠ i tʰ ɯ n ʌ̹ ɾ j u m
크다	k x ɯ d a̠
블로그	p ɯ ɭ ɭ o̞ ɡ ɯ
하이에나	h a̠ i e̞ n a̠
찬가	t͡ɕʰ a̠ː n k͈ a̠
훈련	ɸʷ uː ʎ ʎ j ʌ̹ n
요법	j o b ʌ̹ p̚
버무리다	p ʌ̹ m u ɾ i d a̠
축척	t͡ɕʰ u k̚ t͡ɕʰ ʌ̹ k̚
범어	p ɘː m ʌ̹
조교	t͡ɕ o̞ ɡ j o
로그	ɾ o̞ ɡ ɯ
갈증	k a̠ ʎ t͡ɕ͈ ɯ ŋ
우체통	u t͡ɕʰ e̞ tʰ o̞ ŋ
떨치다	t͈ ʌ̹ ʎ t͡ɕʰ i d a̠
첼로	t͡ɕʰ e̞ ɭ ɭ o̞
주체	t͡ɕ u t͡ɕʰ e̞
루페	ɾ u pʰ e̞
제안	t͡ɕ e̞ a̠ n
임시	i m ɕʰ i
장정	t͡ɕ a̠ ŋ d͡ʑ ʌ̹ ŋ
던	t ʌ̹ n
납치	n a̠ p̚ t͡ɕʰ i
소화전	sʰ o̞ β w a̠ d͡ʑ ʌ̹ n
도리	t o̞ ɾ i
물고기	m u ɭ k͈ o̞ ɡ i
역량	j ʌ̹ ŋ ɲ j a̠ ŋ
공산주의자	k o̞ː ŋ sʰ a̠ ɲ d͡ʑ u ɰ i d͡ʑ a̠
줄공치	t͡ɕ u ɭ ɡ o̞ ŋ t͡ɕʰ i
닫다	t a̠ t̚ t͈ a̠
전갈	t͡ɕ ʌ̹ n ɡ a̠ ɭ
감추다	k a̠ m t͡ɕʰ u d a̠
방어	p a̠ ŋ ʌ̹
숯	sʰ u t̚
명관	m j ʌ̹ ŋ ɡ w a̠ n
초고추장	t͡ɕʰ o̞ ɡ o̞ t͡ɕʰ u d͡ʑ a̠ ŋ
큰줄납자루	k x ɯ ɲ d͡ʑ u ɭ ɭ a̠ p̚ t͡ɕ͈ a̠ ɾ u
팥빙수	pʰ a̠ t̚ p͈ i ŋ sʰ u
곡조	k o̞ k̚ t͡ɕ͈ o̞
문헌	m u n ɦ ʌ̹ n
확보	ɸ w a̠ k̚ p͈ o̞
이론	iː ɾ o̞ n
지옥철	t͡ɕ i o̞ k̚ t͡ɕʰ ʌ̹ ɭ
교만	k j o m a̠ n
범위	p ɘː m ɥ i
지네	t͡ɕ i n e̞
통일	tʰ o̞ː ŋ i ɭ
목란	m o̞ ŋ n a̠ n
언론학	ʌ̹ ɭ ɭ o̞ n ɦ a̠ k̚
청가시고기	t͡ɕʰ ʌ̹ ŋ ɡ a̠ ɕʰ i ɡ o̞ ɡ i
팔팔하다	pʰ a̠ ɭ pʰ a̠ ɾ ɦ a̠ d a̠
체조	t͡ɕʰ e̞ d͡ʑ o̞
티라나	tʰ i ɾ a̠ n a̠
십이월	ɕʰ i b i w ʌ̹ ɭ
틀림없이	tʰ ɯ ʎ ʎ i m ʌ̹ p ɕ͈ i
하북	h a̠ b u k̚
료	ɾ j o
갈망하다	k a̠ ɭ m a̠ ŋ ɦ a̠ d a̠
온전하다	o̞ː ɲ d͡ʑ ʌ̹ n ɦ a̠ d a̠
전화	t͡ɕ ɘː n β w a̠
다가가다	t a̠ ɡ a̠ ɡ a̠ d a̠
라돈	ɾ a̠ d o̞ n
대작자	t ɛː d͡ʑ a̠ k̚ t͡ɕ͈ a̠
발바닥	p a̠ ɭ p͈ a̠ d a̠ k̚
티셔츠	tʰ i ɕʰ ʌ̹ t͡ɕʰ ɯ
바삭과자	p a̠ sʰ a̠ k̚ k͈ w a̠ d͡ʑ a̠
코피	kʰ o̞ pʰ i
수박	sʰ uː b a̠ k̚
일종	i ʎ t͡ɕ͈ o̞ ŋ
웹툰	w e̞ p̚ tʰ u n
미싱	m i ɕʰ i ŋ
작품	t͡ɕ a̠ k̚ pʰ u m
신호등	ɕʰ iː n β o̞ d ɯ ŋ
오미자	o̞ː m i d͡ʑ a̠
이르다	i ɾ ɯ d a̠
양심	j a̠ ŋ ɕʰ i m
인형극	i n ʝ j ʌ̹ ŋ ɡ ɯ k̚
오음	o̞ː ɯ m
굽히다	k u pʰ i d a̠
주일	t͡ɕ u i ɭ
팔뚝	pʰ a̠ ɭ t͈ u k̚
각도	k a̠ k̚ t͈ o̞
스펙트럼	sʰ ɯ pʰ e̞ k̚ tʰ ɯ ɾ ʌ̹ m
공언하다	k o̞ ŋ ʌ̹ n ɦ a̠ d a̠
성장	sʰ ʌ̹ ŋ d͡ʑ a̠ ŋ
전통적	t͡ɕ ʌ̹ n tʰ o̞ ŋ d͡ʑ ʌ̹ k̚
전체적	t͡ɕ ʌ̹ ɲ t͡ɕʰ e̞ d͡ʑ ʌ̹ k̚
글쓴이	k ɯ ɭ s͈ ɯ n i
주로	t͡ɕ u ɾ o̞
아무튼	a̠ː m u tʰ ɯ n
질환	t͡ɕ i ɾ β w a̠ n
극단주의	k ɯ k̚ t͈ a̠ ɲ d͡ʑ u ɰ i
일본학	i ɭ b o̞ n ɦ a̠ k̚
개가하다	k ɛː ɡ a̠ ɦ a̠ d a̠
저지하다	t͡ɕ ʌ̹ d͡ʑ i ɦ a̠ d a̠
승계	sʰ ɯ ŋ ɡ j e̞
유조차	j u d͡ʑ o̞ t͡ɕʰ a̠
성공	sʰ ʌ̹ ŋ ɡ o̞ ŋ
후춧가루	ɸʷ u t͡ɕʰ u t̚ k͈ a̠ ɾ u
헬조선	h e̞ ʎ d͡ʑ o̞ sʰ ʌ̹ n
돋다	t o̞ t̚ t͈ a̠
싣다	ɕʰ i t̚ t͈ a̠
털	tʰ ʌ̹ ɭ
함흥	h a̠ m ɣ ɯ ŋ
일주일	i ʎ t͡ɕ͈ u i ɭ
건강	k ɘː n ɡ a̠ ŋ
증정	t͡ɕ ɯ ŋ d͡ʑ ʌ̹ ŋ
용비어천가	j o ŋ b i ʌ̹ t͡ɕʰ ʌ̹ n ɡ a̠
뒷마당	t ɥ iː n m a̠ d a̠ ŋ
돕다	t o̞ː p̚ t͈ a̠
할머니	h a̠ ɭ m ʌ̹ n i
숱	sʰ u t̚
허용	h ʌ̹ j o ŋ
내다	n ɛː d a̠
모르핀	m o̞ ɾ ɯ pʰ i n
부다페스트	p u d a̠ pʰ e̞ sʰ ɯ tʰ ɯ
만	m a̠ n
홍송어	ɸʷ o̞ ŋ sʰ o̞ ŋ ʌ̹
치타	t͡ɕʰ i tʰ a̠
엉큼하다	ʌ̹ ŋ k x ɯ m ɦ a̠ d a̠
조류학	t͡ɕ o̞ ɾ j u ɦ a̠ k̚
덴마크	t e̞ n m a̠ k x ɯ
크바스	k x ɯ b a̠ sʰ ɯ
코펜하겐	kʰ o̞ pʰ e̞ n ɦ a̠ ɡ e̞ n
평상	pʰ j ʌ̹ ŋ sʰ a̠ ŋ
주먹	t͡ɕ u m ʌ̹ k̚
개자식	k ɛː d͡ʑ a̠ ɕʰ i k̚
미각	m i ɡ a̠ k̚
숭경하다	sʰ u ŋ ɡ j ʌ̹ ŋ ɦ a̠ d a̠
망가니즈	m a̠ ŋ ɡ a̠ n i d͡ʑ ɯ
트롤	tʰ ɯ ɾ o̞ ɭ
작년	t͡ɕ a̠ ŋ ɲ j ʌ̹ n
실고기	ɕʰ iː ɭ ɡ o̞ ɡ i
위원	ɥ i w ʌ̹ n
완벽	w a̠ n b j ʌ̹ k̚
이삼	iː sʰ a̠ m
독어	t o̞ ɡ ʌ̹
보험	p o̞ː ɦ ʌ̹ m
떠오르다	t͈ ʌ̹ o̞ ɾ ɯ d a̠
심부름하다	ɕʰ i m b u ɾ ɯ m ɦ a̠ d a̠
검은머리흰죽지	k ʌ̹ m ɯ n m ʌ̹ ɾ i ʝ i ɲ d͡ʑ u k̚ t͡ɕ͈ i
씻은듯이	ɕ͈ i sʰ ɯ n d ɯ ɕʰ i
분광	p u n ɡ w a̠ ŋ
편경	pʰ j ʌ̹ n ɡ j ʌ̹ ŋ
막바지	m a̠ k̚ p͈ a̠ d͡ʑ i
케이크	kʰ e̞ i k x ɯ
원숭이	w ɘː n sʰ u ŋ i
여름	j ʌ̹ ɾ ɯ m
영양탕	j ʌ̹ ŋ j a̠ ŋ tʰ a̠ ŋ
화장품	ɸ w a̠ d͡ʑ a̠ ŋ pʰ u m
쪽	t͡ɕ͈ o̞ k̚
까치복	k͈ a̠ː t͡ɕʰ i b o̞ k̚
식성	ɕʰ i k s͈ ʌ̹ ŋ
지휘자	t͡ɕ i ɦ ɥ i d͡ʑ a̠
놀이터	n o̞ ɾ i tʰ ʌ̹
들어옮기다	t ɯ ɾ ʌ̹ o̞ m ɡ i d a̠
닥치다	t a̠ k̚ t͡ɕʰ i d a̠
고등학교	k o̞ d ɯ ŋ ɦ a̠ k̚ k͈ j o
살아오다	sʰ a̠ ɾ a̠ o̞ d a̠
마귀	m a̠ ɡ ɥ i
굴뚝	k uː ɭ t͈ u k̚
궁핍	k u ŋ pʰ i p̚
십삼	ɕʰ i p s͈ a̠ m
딱딱하다	t͈ a̠ k̚ t͈ a̠ kʰ a̠ d a̠
영리하다	j ɘː ŋ n i ɦ a̠ d a̠
동력	t o̞ː ŋ ɲ j ʌ̹ k̚
넉	n ɘː k̚
락타	ɾ a̠ k̚ tʰ a̠
똥	t͈ o̞ ŋ
령사	ɾ j ʌ̹ ŋ sʰ a̠
틀림없다	tʰ ɯ ʎ ʎ i m ʌ̹ p̚ t͈ a̠
군복	k u n b o̞ k̚
공갈하다	k o̞ː ŋ ɡ a̠ ɾ ɦ a̠ d a̠
화	ɸ w a̠ː
근로자	k ɯ ɭ ɭ o̞ d͡ʑ a̠
하부	h a̠ː b u
선실	sʰ ʌ̹ n ɕʰ i ɭ
초특급	t͡ɕʰ o̞ tʰ ɯ k̚ k͈ ɯ p̚
기억	k i ʌ̹ k̚
아제티딘	a̠ d͡ʑ e̞ tʰ i d i n
소말리아	s͈ o̞ m a̠ ʎ ʎ i a̠
혼돈하다	ɸʷ o̞ n d o̞ n ɦ a̠ d a̠
회복하다	ɸ w e̞ b o̞ kʰ a̠ d a̠
다만	t a̠ː m a̠ n
유괴	j u ɡ w e̞
업동이	ʌ̹ p̚ t͈ o̞ ŋ i
라면	ɾ a̠ m j ʌ̹ n
타조	tʰ a̠ː d͡ʑ o̞
항원	h a̠ ŋ w ʌ̹ n
마련	m a̠ ɾ j ʌ̹ n
지랄하다	t͡ɕ i ɾ a̠ ɾ ɦ a̠ d a̠
침략자	t͡ɕʰ iː m ɲ j a̠ k̚ t͡ɕ͈ a̠
발톱	p a̠ ɭ tʰ o̞ p̚
사다리	sʰ a̠ d a̠ ɾ i
각하	k a̠ kʰ a̠
롯	ɾ o̞ t̚
파파야	pʰ a̠ pʰ a̠ j a̠
존중	t͡ɕ o̞ ɲ d͡ʑ u ŋ
환절기	ɸ w a̠ː ɲ d͡ʑ ʌ̹ ɭ ɡ i
구축함	k u t͡ɕʰ u kʰ a̠ m
지난번	t͡ɕ i n a̠ n b ʌ̹ n
투숙	tʰ u sʰ u k̚
벨	p e̞ ɭ
요청하다	j o t͡ɕʰ ʌ̹ ŋ ɦ a̠ d a̠
입구	i p̚ k͈ u
시리즈	ɕʰ i ɾ i d͡ʑ ɯ
왕수	w a̠ ŋ sʰ u
무언가	m u ʌ̹ n ɡ a̠
부부	p u b u
노르웨이어	n o̞ ɾ ɯ w e̞ i ʌ̹
오줌	o̞ d͡ʑ u m
프로그람	pʰ ɯ ɾ o̞ ɡ ɯ ɾ a̠ m
여우비	j ʌ̹ u b i
전통	t͡ɕ ʌ̹ n tʰ o̞ ŋ
빠져나오다	p͈ a̠ː d͡ʑ ʌ̹ n a̠ o̞ d a̠
반지	p a̠ ɲ d͡ʑ i
까닭	k͈ a̠ d a̠ k̚
난	n a̠ n
수리	sʰ u ɾ i
두드러지다	t u d ɯ ɾ ʌ̹ d͡ʑ i d a̠
쐐기	s͈ w ɛː ɡ i
미합중국	m i ɦ a̠ p̚ t͡ɕ͈ u ŋ ɡ u k̚
지하누비	t͡ɕ i ɦ a̠ n u b i
똑똑하다	t͈ o̞ k̚ t͈ o̞ kʰ a̠ d a̠
인자	i ɲ d͡ʑ a̠
파리	pʰ a̠ ɾ i
벤토	p e̞ n tʰ o̞
하품하다	h a̠ pʰ u m ɦ a̠ d a̠
플러그인	pʰ ɯ ɭ ɭ ʌ̹ ɡ ɯ i n
추출물	t͡ɕʰ u t͡ɕʰ u ɭ m u ɭ
복제	p o̞ k̚ t͡ɕ͈ e̞
복사하다	p o̞ k s͈ a̠ ɦ a̠ d a̠
검은담비	k ʌ̹ m ɯ n d a̠ m b i
랭장고	ɾ ɛː ŋ d͡ʑ a̠ ŋ ɡ o̞
점수	t͡ɕ ʌ̹ m s͈ u
헬스클럽	h e̞ ɭ sʰ ɯ k x ɯ ɭ ɭ ʌ̹ p̚
부탄	p u tʰ a̠ n
젊은이	t͡ɕ ʌ̹ ɭ m ɯ n i
산술	sʰ a̠ː n sʰ u ɭ
의사	ɰ i sʰ a̠
불법	p u ɭ b ʌ̹ p̚
자카르타	t͡ɕ a̠ kʰ a̠ ɾ ɯ tʰ a̠
거위	k ʌ̹ ɥ i
노보시비르스크	n o̞ b o̞ ɕʰ i b i ɾ ɯ sʰ ɯ k x ɯ
시청자	ɕʰ iː t͡ɕʰ ʌ̹ ŋ d͡ʑ a̠
피라냐	pʰ i ɾ a̠ ɲ j a̠
상록수	sʰ a̠ ŋ n o̞ k s͈ u
삼월	sʰ a̠ m w ʌ̹ ɭ
다차	t a̠ t͡ɕʰ a̠
조용히	t͡ɕ o̞ j o ŋ ʝ i
적반하장	t͡ɕ ʌ̹ k̚ p͈ a̠ n ɦ a̠ d͡ʑ a̠ ŋ
이다	i d a̠
란타넘	ɾ a̠ n tʰ a̠ n ʌ̹ m
고르다	k o̞ ɾ ɯ d a̠
학번	h a̠ k̚ p͈ ʌ̹ n
오르다	o̞ ɾ ɯ d a̠
용병	j o ŋ b j ʌ̹ ŋ
발목	p a̠ ɭ m o̞ k̚
서넛	sʰ ʌ̹ n ʌ̹ t̚
짱	t͡ɕ͈ a̠ ŋ
탈	tʰ a̠ ɭ
품절	pʰ uː m d͡ʑ ʌ̹ ɭ
숨기다	sʰ u m ɡ i d a̠
군단	k u n d a̠ n
사향쥐	sʰ a̠ ʝ j a̠ ŋ d͡ʑ ɥ i
가야	k a̠ j a̠
옥고	o̞ k̚ k͈ o̞
선거통	sʰ ʌ̹ n ɡ ʌ̹ tʰ o̞ ŋ
에티켓	e̞ tʰ i kʰ e̞ t̚
파일	pʰ a̠ i ɭ
카라칼	kʰ a̠ ɾ a̠ kʰ a̠ ɭ
버들붕어	p ʌ̹ d ɯ ɭ b u ŋ ʌ̹
오른쪽	o̞ ɾ ɯ ɲ t͡ɕ͈ o̞ k̚
사철	sʰ a̠ t͡ɕʰ ʌ̹ ɭ
외면하다	w e̞ː m j ʌ̹ n ɦ a̠ d a̠
가락점	k a̠ ɾ a̠ k̚ t͡ɕ͈ ʌ̹ m
이야기하다	i j a̠ ɡ i ɦ a̠ d a̠
떠들다	t͈ ɘː d ɯ ɭ d a̠
먀	m j a̠
제법	t͡ɕ e̞ b ʌ̹ p̚
별빛	p j ɘː ɭ p͈ i t̚
피망	pʰ i m a̠ ŋ
말갛다	m a̠ː ɭ ɡ a̠ tʰ a̠
누구	n u ɡ u
깡통	k͈ a̠ ŋ tʰ o̞ ŋ
더불어	t ʌ̹ b u ɾ ʌ̹
아보카도	a̠ b o̞ kʰ a̠ d o̞
사진	sʰ a̠ d͡ʑ i n
반사	p a̠ː n sʰ a̠
모국	m o̞ː ɡ u k̚
서원	sʰ ʌ̹ w ʌ̹ n
활자	ɸ w a̠ ʎ t͡ɕ͈ a̠
마우스	m a̠ u sʰ ɯ
풋	pʰ u t̚
제명	t͡ɕ e̞ m j ʌ̹ ŋ
벽	p j ʌ̹ k̚
가장	k a̠ː d͡ʑ a̠ ŋ
합쇼체	h a̠ p ɕ͈ o t͡ɕʰ e̞
봉사기	p o̞ ŋ sʰ a̠ ɡ i
엘니뇨	e̞ ʎ ʎ i ɲ j o
걸쭉하다	k ʌ̹ ʎ t͡ɕ͈ u kʰ a̠ d a̠
해발	h ɛː b a̠ ɭ
침실	t͡ɕʰ iː m ɕʰ i ɭ
안녕히	a̠ n ɲ j ʌ̹ ŋ ʝ i
쥐	t͡ɕ ɥ i
데이터베이스	t e̞ i tʰ ʌ̹ b e̞ i sʰ ɯ
교토	k j o tʰ o̞
가까이하다	k a̠ k͈ a̠ i ɦ a̠ d a̠
성하	sʰ ɘː ŋ ɦ a̠
칼슘	kʰ a̠ ɭ ɕʰ u m
그루지야어	k ɯ ɾ u d͡ʑ i j a̠ ʌ̹
젖먹이	t͡ɕ ʌ̹ n m ʌ̹ ɡ i
죽부인	t͡ɕ u k̚ p͈ u i n
펠라티오	pʰ e̞ ɭ ɭ a̠ tʰ i o̞
트림하다	tʰ ɯː ɾ i m ɦ a̠ d a̠
메모	m e̞ m o̞
베이루트	p e̞ i ɾ u tʰ ɯ
국경	k u k̚ k͈ j ʌ̹ ŋ
비교적	p iː ɡ j o d͡ʑ ʌ̹ k̚
삐침	p͈ i t͡ɕʰ i m
쓰다	s͈ ɯ d a̠
요소	j o sʰ o̞
살짝	sʰ a̠ ʎ t͡ɕ͈ a̠ k̚
오징어	o̞ d͡ʑ i ŋ ʌ̹
엄마	ʌ̹ m m a̠
텔레비	tʰ e̞ ɭ ɭ e̞ b i
크세논	k x ɯ sʰ e̞ n o̞ n
방	p a̠ ŋ
초유	t͡ɕʰ o̞ j u
섯	sʰ ʌ̹ t̚
영양	j ʌ̹ ŋ j a̠ ŋ
양서류	j a̠ː ŋ sʰ ʌ̹ ɾ j u
즉	t͡ɕ ɯ k̚
조교	t͡ɕ o̞ː ɡ j o
몰타어	m o̞ ɭ tʰ a̠ ʌ̹
지점	t͡ɕ i d͡ʑ ʌ̹ m
물가	m u ɭ k͈ a̠
사시미	sʰ a̠ ɕʰ i m i
부러움	p u ɾ ʌ̹ u m
응	ɯ ŋ
뿔논병아리	p͈ u ɭ ɭ o̞ n b j ʌ̹ ŋ a̠ ɾ i
뿜다	p͈ uː m t͈ a̠
많은	m a̠ː n ɯ n
몬테비데오	m o̞ n tʰ e̞ b i d e̞ o̞
민간	m i n ɡ a̠ n
일등	i ɭ t͈ ɯ ŋ
이용	iː j o ŋ
다신론	t a̠ ɕʰ i n n o̞ n
기꺼이	k i k͈ ʌ̹ i
검사	k ɘː m sʰ a̠
영묘	j ʌ̹ ŋ m j o
파라마리보	pʰ a̠ ɾ a̠ m a̠ ɾ i b o̞
발달	p a̠ ɭ t͈ a̠ ɭ
여장	j ʌ̹ d͡ʑ a̠ ŋ
신부	ɕʰ i n b u
불완전하다	p u ɾ w a̠ ɲ d͡ʑ ʌ̹ n ɦ a̠ d a̠
심지	ɕʰ i m d͡ʑ i
가스레인지	k a̠ sʰ ɯ ɾ e̞ i ɲ d͡ʑ i
바이트	p a̠ i tʰ ɯ
무너지다	m u n ʌ̹ d͡ʑ i d a̠
남근	n a̠ m ɡ ɯ n
바람	p a̠ ɾ a̠ m
가없이	k a̠ː ʌ̹ p ɕ͈ i
날아오르다	n a̠ ɾ a̠ o̞ ɾ ɯ d a̠
모습	m o̞ sʰ ɯ p̚
검독수리	k ʌ̹ m d o̞ k s͈ u ɾ i
윈도우	ɥ i n d o̞ u
전하	t͡ɕ ʌ̹ n ɦ a̠
강력	k a̠ ŋ ɲ j ʌ̹ k̚
그럼	k ɯ ɾ ʌ̹ m
통가리	tʰ o̞ ŋ ɡ a̠ ɾ i
점줄망둑	t͡ɕ ʌ̹ m d͡ʑ u ɭ m a̠ ŋ d u k̚
일찍	i ʎ t͡ɕ͈ i k̚
가리다	k a̠ ɾ i d a̠
트다	tʰ ɯ d a̠
추진	t͡ɕʰ u d͡ʑ i n
당장	t a̠ ŋ d͡ʑ a̠ ŋ
포플러	pʰ o̞ pʰ ɯ ɭ ɭ ʌ̹
교원	k j o w ʌ̹ n
홀소리어울림	ɸʷ o̞ ɭ s͈ o̞ ɾ i ʌ̹ u ʎ ʎ i m
착석하다	t͡ɕʰ a̠ k s͈ ʌ̹ kʰ a̠ d a̠
나름	n a̠ ɾ ɯ m
학설	h a̠ k s͈ ʌ̹ ɭ
우리	u ɾ i
외화	w e̞ː β w a̠
볼모	p o̞ ɭ m o̞
행복	h ɛː ŋ b o̞ k̚
등나무	t ɯ ŋ n a̠ m u
수치	sʰ u t͡ɕʰ i
코로나비루스	kʰ o̞ ɾ o̞ n a̠ b i ɾ u sʰ ɯ
한림원	h a̠ ʎ ʎ i m w ʌ̹ n
분야	p u ɲ j a̠
먄마	m j a̠ n m a̠
엽서	j ʌ̹ p s͈ ʌ̹
쉬리	ʃʰ ɥ iː ɾ i
애국심	ɛː ɡ u k ɕ͈ i m
미유기	m i j u ɡ i
미워하다	m i w ʌ̹ ɦ a̠ d a̠
캄팔라	kʰ a̠ m pʰ a̠ ɭ ɭ a̠
소치	sʰ o̞ː t͡ɕʰ i
벤졸	p e̞ ɲ d͡ʑ o̞ ɭ
오드투왈렛	o̞ d ɯ tʰ u w a̠ ɭ ɭ e̞ t̚
발가락	p a̠ ɭ k͈ a̠ ɾ a̠ k̚
맞은편	m a̠ d͡ʑ ɯ n pʰ j ʌ̹ n
번	p ʌ̹ n
시골	ɕʰ i ɡ o̞ ɭ
소포	sʰ o̞ː pʰ o̞
친일파	t͡ɕʰ i n i ɭ pʰ a̠
발간되다	p a̠ ɭ ɡ a̠ n d w e̞ d a̠
불가리아	p u ɭ ɡ a̠ ɾ i a̠
우마	u m a̠
해초	h ɛː t͡ɕʰ o̞
가스파초	k a̠ sʰ ɯ pʰ a̠ t͡ɕʰ o̞
마르스	m a̠ ɾ ɯ sʰ ɯ
노끈	n o̞ k͈ ɯ n
부엌	p u ʌ̹ k̚
수사학	sʰ u sʰ a̠ ɦ a̠ k̚
목적지	m o̞ k̚ t͡ɕ͈ ʌ̹ k̚ t͡ɕ͈ i
푸주한	pʰ u d͡ʑ u ɦ a̠ n
억울하다	ʌ̹ ɡ u ɾ ɦ a̠ d a̠
젓가락	t͡ɕ ʌ̹ t̚ k͈ a̠ ɾ a̠ k̚
임실납자루	i m ɕʰ i ɭ ɭ a̠ p̚ t͡ɕ͈ a̠ ɾ u
카라반	kʰ a̠ ɾ a̠ b a̠ n
들이다	t ɯ ɾ i d a̠
끝	k͈ ɯ t̚
여러분	j ʌ̹ ɾ ʌ̹ b u n
등신	t ɯː ŋ ɕʰ i n
얼버무리다	ʌ̹ ɭ b ʌ̹ m u ɾ i d a̠
이야깃거리	i j a̠ ɡ i t̚ k͈ ʌ̹ ɾ i
신념	ɕʰ iː n ɲ j ʌ̹ m
주차	t͡ɕ uː t͡ɕʰ a̠
설정	sʰ ʌ̹ ʎ t͡ɕ͈ ʌ̹ ŋ
외교	w e̞ː ɡ j o
산호세	sʰ a̠ n β o̞ sʰ e̞
증인	t͡ɕ ɯ ŋ i n
회화	ɸ w e̞ː β w a̠
놈	n o̞ m
립자	ɾ i p̚ t͡ɕ͈ a̠
미음	m i ɯ m
한여름	h a̠ n ɲ j ʌ̹ ɾ ɯ m
노인의학	n o̞ː i n ɰ i ɦ a̠ k̚
모자	m o̞ d͡ʑ a̠
서클	s͈ ʌ̹ k x ɯ ɭ
신자	ɕʰ iː ɲ d͡ʑ a̠
멀미	m ʌ̹ ɭ m i
뜨거워지다	t͈ ɯ ɡ ʌ̹ w ʌ̹ d͡ʑ i d a̠
팔레스타인	pʰ a̠ ɭ ɭ e̞ sʰ ɯ tʰ a̠ i n
척량	t͡ɕʰ ʌ̹ ŋ ɲ j a̠ ŋ
녕하	ɲ j ʌ̹ ŋ ɦ a̠
보도	p o̞ː d o̞
빈칸	p iː n kʰ a̠ n
금일	k ɯ m i ɭ
나미비아	n a̠ m i b i a̠
바이러스	p a̠ i ɾ ʌ̹ sʰ ɯ
경비원	k j ɘː ŋ b i w ʌ̹ n
조상	t͡ɕ o̞ sʰ a̠ ŋ
잃어버리다	i ɾ ʌ̹ b ʌ̹ ɾ i d a̠
엎지르다	ʌ̹ p̚ t͡ɕ͈ i ɾ ɯ d a̠
통계학	tʰ o̞ː ŋ ɡ j e̞ ɦ a̠ k̚
방글라데시	p a̠ ŋ ɡ ɯ ɭ ɭ a̠ d e̞ ɕʰ i
머리글	m ʌ̹ ɾ i ɡ ɯ ɭ
용의자	j o ŋ ɰ i d͡ʑ a̠
기중기	k i d͡ʑ u ŋ ɡ i
저널리스트	t͡ɕ ʌ̹ n ʌ̹ ʎ ʎ i sʰ ɯ tʰ ɯ
속세	sʰ o̞ k s͈ e̞
명의	m j ʌ̹ ŋ ɰ i
날리다	n a̠ ʎ ʎ i d a̠
안습	a̠ n sʰ ɯ p̚
변변하다	p j ʌ̹ n b j ʌ̹ n ɦ a̠ d a̠
입빠이	i p̚ p͈ a̠ i
어엿하다	ʌ̹ j ʌ̹ tʰ a̠ d a̠
이기다	i ɡ i d a̠
독신	t o̞ k ɕ͈ i n
알칼리	a̠ ɭ kʰ a̠ ʎ ʎ i
부하	p u ɦ a̠
엄습하다	ʌ̹ m sʰ ɯ pʰ a̠ d a̠
기업	k i ʌ̹ p̚
연락	j ʌ̹ ɭ ɭ a̠ k̚
벌거벗다	p ʌ̹ ɭ ɡ ʌ̹ b ʌ̹ t̚ t͈ a̠
갑판	k a̠ p̚ pʰ a̠ n
회답	ɸ w e̞ d a̠ p̚
공격	k o̞ː ŋ ɡ j ʌ̹ k̚
갈리시아	k a̠ ʎ ʎ i ɕʰ i a̠
고통스럽다	k o̞ tʰ o̞ ŋ sʰ ɯ ɾ ʌ̹ p̚ t͈ a̠
칠레	t͡ɕʰ i ɭ ɭ e̞
팁	tʰ i p̚
경죄	k j ʌ̹ ŋ d͡ʑ w e̞
타월	tʰ a̠ w ʌ̹ ɭ
극작가	k ɯ k̚ t͡ɕ͈ a̠ k̚ k͈ a̠
빙하	p i ŋ ɦ a̠
카옌	kʰ a̠ j e̞ n
기업가	k i ʌ̹ p̚ k͈ a̠
목다리	m o̞ k̚ t͈ a̠ ɾ i
암살자	a̠ː m sʰ a̠ ʎ t͡ɕ͈ a̠
콜호스	kʰ o̞ ɾ β o̞ sʰ ɯ
추구	t͡ɕʰ u ɡ u
간추리다	k a̠ ɲ t͡ɕʰ u ɾ i d a̠
스모	s͈ ɯ m o̞
제일	t͡ɕ e̞ː i ɭ
부정적분	p u d͡ʑ ʌ̹ ŋ d͡ʑ ʌ̹ k̚ p͈ u n
설프히드릴기	sʰ ʌ̹ ɭ pʰ ɯ ʝ i d ɯ ɾ i ɭ ɡ i
가람	k a̠ ɾ a̠ m
나프탈렌	n a̠ pʰ ɯ tʰ a̠ ɭ ɭ e̞ n
고집불통	k o̞ d͡ʑ i p̚ p͈ u ɭ tʰ o̞ ŋ
을까	ɯ ɭ k͈ a̠
리투아니아	ɾ i tʰ u a̠ n i a̠
바르다	p a̠ ɾ ɯ d a̠
돌마자	t o̞ ɭ m a̠ d͡ʑ a̠
기관총	k i ɡ w a̠ ɲ t͡ɕʰ o̞ ŋ
아기	a̠ ɡ i
팜유	pʰ a̠ m j u
토론	tʰ o̞ː ɾ o̞ n
고구려	k o̞ ɡ u ɾ j ʌ̹
제유	t͡ɕ e̞ j u
부치다	p u t͡ɕʰ i d a̠
날마다	n a̠ ɭ m a̠ d a̠
지름길	t͡ɕ i ɾ ɯ m ɡ i ɭ
미나리	m i n a̠ ɾ i
스카프	sʰ ɯ kʰ a̠ pʰ ɯ
미용사	m iː j o ŋ sʰ a̠
굵다랗다	k uː k̚ t͈ a̠ ɾ a̠ tʰ a̠
쌍비읍	s͈ a̠ ŋ b i ɯ p̚
화음	ɸ w a̠ ɯ m
물에네르기	m u ɾ e̞ n e̞ ɾ ɯ ɡ i
매점	m ɛː d͡ʑ ʌ̹ m
알리다	a̠ ʎ ʎ i d a̠
공공	k o̞ ŋ ɡ o̞ ŋ
손톱	sʰ o̞ n tʰ o̞ p̚
훈독	ɸʷ uː n d o̞ k̚
따지다	t͈ a̠ d͡ʑ i d a̠
흥미	x ɯː ŋ m i
문서	m u n sʰ ʌ̹
납지리	n a̠ p̚ t͡ɕ͈ i ɾ i
중성	t͡ɕ u ŋ sʰ ʌ̹ ŋ
인텔리겐치아	i n tʰ e̞ ʎ ʎ i ɡ e̞ ɲ t͡ɕʰ i a̠
갈다	k a̠ː ɭ d a̠
오사까	o̞ sʰ a̠ k͈ a̠
북반구	p uː k̚ p͈ a̠ n ɡ u
이쁘다	i p͈ ɯ d a̠
수도사	sʰ u d o̞ sʰ a̠
유민	j u m i n
애쓰다	ɛː s͈ ɯ d a̠
미안하다	m i a̠ n ɦ a̠ d a̠
오다	o̞ d a̠
트레이너	tʰ ɯ ɾ e̞ i n ʌ̹
루비듐	ɾ u b i d j u m
치한	t͡ɕʰ i ɦ a̠ n
신학	ɕʰ i n ɦ a̠ k̚
가리비	k a̠ ɾ i b i
독립	t o̞ ŋ n i p̚
귓불	k ɥ i t̚ p͈ u ɭ
가엾다	k a̠ː j ʌ̹ p̚ t͈ a̠
몰카	m o̞ ɭ kʰ a̠
자궁	t͡ɕ a̠ ɡ u ŋ
민들레	m i n d ɯ ɭ ɭ e̞
그분	k ɯ b u n
간섭	k a̠ n sʰ ʌ̹ p̚
뉵	ɲ j u k̚
개지랄	k ɛː d͡ʑ i ɾ a̠ ɭ
밟다	p a̠ː p̚ t͈ a̠
가볍다	k a̠ b j ʌ̹ p̚ t͈ a̠
욕	j o k̚
등산	t ɯ ŋ sʰ a̠ n
온도	o̞ n d o̞
황옥	ɸ w a̠ ŋ o̞ k̚
순결	sʰ u n ɡ j ʌ̹ ɭ
평면	pʰ j ʌ̹ ŋ m j ʌ̹ n
남녀	n a̠ m ɲ j ʌ̹
보급	p o̞ː ɡ ɯ p̚
파운데이션	pʰ a̠ u n d e̞ i ɕʰ ʌ̹ n
베누스	p e̞ n u sʰ ɯ
잡히다	t͡ɕ a̠ pʰ i d a̠
구별되다	k u b j ʌ̹ ɭ d w e̞ d a̠
부동산	p u d o̞ ŋ sʰ a̠ n
찔리다	t͡ɕ͈ i ʎ ʎ i d a̠
이기적	iː ɡ i d͡ʑ ʌ̹ k̚
륙십	ɾ j u k ɕ͈ i p̚
멘델레븀	m e̞ n d e̞ ɭ ɭ e̞ b j u m
레이스	ɾ e̞ i sʰ ɯ
농노	n o̞ ŋ n o̞
연변	j ʌ̹ n b j ʌ̹ n
폄	pʰ j ʌ̹ m
장모	t͡ɕ a̠ː ŋ m o̞
유엔	j u e̞ n
민주	m i ɲ d͡ʑ u
칠하다	t͡ɕʰ i ɾ ɦ a̠ d a̠
소유하다	sʰ o̞ː j u ɦ a̠ d a̠
멋있다	m ʌ̹ ɕʰ i t̚ t͈ a̠
외투	w e̞ː tʰ u
이며	i m j ʌ̹
동명사	t o̞ː ŋ m j ʌ̹ ŋ sʰ a̠
소년	sʰ o̞ː ɲ j ʌ̹ n
법정	p ʌ̹ p̚ t͡ɕ͈ ʌ̹ ŋ
선교	sʰ ʌ̹ n ɡ j o
비싸다	p i s͈ a̠ d a̠
남아프리카공화국	n a̠ m a̠ pʰ ɯ ɾ i kʰ a̠ ɡ o̞ ŋ β w a̠ ɡ u k̚
팔다	pʰ a̠ ɭ d a̠
뿌리혹	p͈ u ɾ i β o̞ k̚
아르메니아어	a̠ ɾ ɯ m e̞ n i a̠ ʌ̹
사과	sʰ a̠ ɡ w a̠
존맛	t͡ɕ o̞ n m a̠ t̚
무늬	m u n i
누설	n uː sʰ ʌ̹ ɭ
불만족	p u ɭ m a̠ ɲ d͡ʑ o̞ k̚
드렁허리	t ɯ ɾ ʌ̹ ŋ ɦ ʌ̹ ɾ i
맛	m a̠ t̚
영업	j ʌ̹ ŋ ʌ̹ p̚
평가하다	pʰ j ɘː ŋ k͈ a̠ ɦ a̠ d a̠
진심	t͡ɕ i n ɕʰ i m
졸업식	t͡ɕ o̞ ɾ ʌ̹ p ɕ͈ i k̚
명곡	m j ʌ̹ ŋ ɡ o̞ k̚
굽이굽이	k u b i ɡ u b i
안드로이드	a̠ n d ɯ ɾ o̞ i d ɯ
다윗	t a̠ ɥ i t̚
일어서다	i ɾ ʌ̹ sʰ ʌ̹ d a̠
연가	j ɘː n ɡ a̠
중경	t͡ɕ u ŋ ɡ j ʌ̹ ŋ
사원	sʰ a̠ w ʌ̹ n
초호	t͡ɕʰ o̞ β o̞
북경	p u k̚ k͈ j ʌ̹ ŋ
자랑스럽다	t͡ɕ a̠ ɾ a̠ ŋ sʰ ɯ ɾ ʌ̹ p̚ t͈ a̠
벚	p ʌ̹ t̚
인간	i n ɡ a̠ n
털발말똥가리	tʰ ʌ̹ ɭ b a̠ ɭ m a̠ ɭ t͈ o̞ ŋ ɡ a̠ ɾ i
선술집	sʰ ʌ̹ n sʰ u ʎ d͡ʑ i p̚
지시봉	t͡ɕ i ɕʰ i b o̞ ŋ
기념일	k i ɲ j ʌ̹ m i ɭ
도박	t o̞ b a̠ k̚
울음소리	u ɾ ɯ m s͈ o̞ ɾ i
여왕	j ʌ̹ w a̠ ŋ
보온병	p o̞ː o̞ n b j ʌ̹ ŋ
아자	a̠ d͡ʑ a̠
호흡하다	ɸʷ o̞ ɣ ɯ pʰ a̠ d a̠
무익하다	m u i kʰ a̠ d a̠
버마	p ʌ̹ m a̠
비난	p iː n a̠ n
옆얼굴	j ʌ̹ b ʌ̹ ɭ ɡ u ɭ
정치학	t͡ɕ ʌ̹ ŋ t͡ɕʰ i ɦ a̠ k̚
판	pʰ a̠ n
탁치	tʰ a̠ k̚ t͡ɕʰ i
등롱	t ɯ ŋ n o̞ ŋ
귀뿔논병아리	k ɥ i p͈ u ɭ ɭ o̞ n b j ʌ̹ ŋ a̠ ɾ i
하드웨어	h a̠ d ɯ w e̞ ʌ̹
차츰	t͡ɕʰ a̠ t͡ɕʰ ɯ m
결점	k j ʌ̹ ʎ t͡ɕ͈ ʌ̹ m
모로니	m o̞ ɾ o̞ n i
피하다	pʰ iː ɦ a̠ d a̠
신앙	ɕʰ iː n a̠ ŋ
가공품	k a̠ ɡ o̞ ŋ pʰ u m
출근	t͡ɕʰ u ɭ ɡ ɯ n
사직	sʰ a̠ d͡ʑ i k̚
계수	k j e̞ː sʰ u
단수	t a̠ n sʰ u
나머지	n a̠ m ʌ̹ d͡ʑ i
우아하다	u a̠ ɦ a̠ d a̠
차이	t͡ɕʰ a̠ i
아스하바트	a̠ sʰ ɯ ɦ a̠ b a̠ tʰ ɯ
트롱프뢰유	tʰ ɯ ɾ o̞ ŋ pʰ ɯ ɾ w e̞ j u
소원	sʰ o̞ː w ʌ̹ n
그토록	k ɯ tʰ o̞ ɾ o̞ k̚
한둘	h a̠ n d u ɭ
예취기	j e̞ t͡ɕʰ ɥ i ɡ i
규률	k j u ɾ j u ɭ
담다	t a̠ː m t͈ a̠
디스켓	t i sʰ ɯ kʰ e̞ t̚
비유	p i j u
박쥐	p a̠ k̚ t͡ɕ͈ ɥ i
루시퍼	ɾ u ɕʰ i pʰ ʌ̹
취리히	t͡ɕʰ ɥ i ɾ i ʝ i
순천	sʰ uː ɲ t͡ɕʰ ʌ̹ n
물리치다	m u ʎ ʎ i t͡ɕʰ i d a̠
점검	t͡ɕ ʌ̹ m ɡ ʌ̹ m
물두꺼비	m u ɭ d u k͈ ʌ̹ b i
매춘부	m ɛː t͡ɕʰ u n b u
카드뮴	kʰ a̠ d ɯ m j u m
홍역	ɸʷ o̞ ŋ j ʌ̹ k̚
베다	p e̞ː d a̠
서명하다	sʰ ɘː m j ʌ̹ ŋ ɦ a̠ d a̠
계층	k j e̞ t͡ɕʰ ɯ ŋ
영향	j ɘː ŋ ʝ j a̠ ŋ
보고	p o̞ː ɡ o̞
체중	t͡ɕʰ e̞ d͡ʑ u ŋ
딱	t͈ a̠ k̚
베달	p e̞ d a̠ ɭ
십팔	ɕʰ i p̚ pʰ a̠ ɭ
적당히	t͡ɕ ʌ̹ k̚ t͈ a̠ ŋ ʝ i
불철주야	p u ʎ t͡ɕʰ ʌ̹ ʎ d͡ʑ u j a̠
미남	m iː n a̠ m
숙어	sʰ u ɡ ʌ̹
메달	m e̞ d a̠ ɭ
시력	ɕʰ iː ɾ j ʌ̹ k̚
난로	n a̠ː ɭ ɭ o̞
비뚤다	p i t͈ u ɭ d a̠
속하다	sʰ o̞ kʰ a̠ d a̠
스치다	sʰ ɯ t͡ɕʰ i d a̠
작성	t͡ɕ a̠ k s͈ ʌ̹ ŋ
지치다	t͡ɕ iː t͡ɕʰ i d a̠
가스	k͈ a̠ sʰ ɯ
과물	k w a̠ m u ɭ
계란	k j e̞ ɾ a̠ n
정답	t͡ɕ ɘː ŋ d a̠ p̚
련방	ɾ j ʌ̹ n b a̠ ŋ
후각	ɸʷ u ɡ a̠ k̚
장	t͡ɕ a̠ ŋ
동포	t o̞ ŋ pʰ o̞
이승	i sʰ ɯ ŋ
민물가마우지	m i n m u ɭ ɡ a̠ m a̠ u d͡ʑ i
죄인	t͡ɕ w e̞ː i n
구식	k uː ɕʰ i k̚
등받이	t ɯ ŋ b a̠ d i
금하다	k ɯː m ɦ a̠ d a̠
파괴되다	pʰ a̠ː ɡ w e̞ d w e̞ d a̠
주방	t͡ɕ u b a̠ ŋ
수식어	sʰ u ɕʰ i ɡ ʌ̹
아마추어	a̠ m a̠ t͡ɕʰ u ʌ̹
축사	t͡ɕʰ u k s͈ a̠
승용차	sʰ ɯ ŋ j o ŋ t͡ɕʰ a̠
중도	t͡ɕ u ŋ d o̞
활용하다	ɸ w a̠ ɾ j o ŋ ɦ a̠ d a̠
다이어트	t a̠ i ʌ̹ tʰ ɯ
타자기	tʰ a̠ d͡ʑ a̠ ɡ i
지겹다	t͡ɕ i ɡ j ʌ̹ p̚ t͈ a̠
툰드라	tʰ u n d ɯ ɾ a̠
타이완	tʰ a̠ i w a̠ n
후두	ɸʷ u d u
여울	j ʌ̹ u ɭ
답	t a̠ p̚
부정	p u d͡ʑ ʌ̹ ŋ
고장	k o̞ː d͡ʑ a̠ ŋ
여기	j ʌ̹ ɡ i
느낌표	n ɯ k͈ i m pʰ j o
의인화	ɰ i i n β w a̠
밝을녘	p a̠ ɭ ɡ ɯ ʎ ʎ j ʌ̹ k̚
환멸	ɸ w a̠ː n m j ʌ̹ ɭ
발정	p a̠ ʎ t͡ɕ͈ ʌ̹ ŋ
몽따쥬	m o̞ ŋ t͈ a̠ d͡ʑ u
바스스카프	p a̠ sʰ ɯ sʰ ɯ kʰ a̠ pʰ ɯ
달리다	t a̠ ʎ ʎ i d a̠
구글	k u ɡ ɯ ɭ
크레용	k x ɯ ɾ e̞ j o ŋ
무용	m u j o ŋ
물러서다	m u ɭ ɭ ʌ̹ sʰ ʌ̹ d a̠
합기도	h a̠ p̚ k͈ i d o̞
불다	p uː ɭ d a̠
토론토	tʰ o̞ ɾ o̞ n tʰ o̞
요망	j o m a̠ ŋ
부전령	p u d͡ʑ ʌ̹ ʎ ʎ j ʌ̹ ŋ
그려지다	k ɯ ɾ j ʌ̹ d͡ʑ i d a̠
암탉	a̠ m tʰ a̠ k̚
약	j a̠ k̚
근본적	k ɯ n b o̞ ɲ d͡ʑ ʌ̹ k̚
겹다	k j ɘː p̚ t͈ a̠
잘못	t͡ɕ a̠ ɭ m o̞ t̚
필요	pʰ i ɾ j o
연구실	j ʌ̹ n ɡ u ɕʰ i ɭ
유혹	j u β o̞ k̚
능률	n ɯ ŋ ɲ j u ɭ
선반	sʰ ʌ̹ n b a̠ n
낙	n a̠ k̚
후반	ɸʷ uː b a̠ n
경찰견	k j ɘː ŋ t͡ɕʰ a̠ ɭ ɡ j ʌ̹ n
비	p i
근로	k ɯː ɭ ɭ o̞
무용	m uː j o ŋ
모토	m o̞ tʰ o̞
반짝	p a̠ ɲ t͡ɕ͈ a̠ k̚
리셉션	ɾ i s͈ e̞ p ɕ͈ ʌ̹ n
봉지	p o̞ ŋ d͡ʑ i
피곤하다	pʰ i ɡ o̞ n ɦ a̠ d a̠
하긴	h a̠ ɡ i n
골무	k o̞ ɭ m u
대합실	t ɛː ɦ a̠ p ɕ͈ i ɭ
멧박쥐	m e̞ t̚ p͈ a̠ k̚ t͡ɕ͈ ɥ i
부	p u
왁찐	w a̠ k̚ t͡ɕ͈ i n
아련	a̠ ɾ j ʌ̹ n
후드	ɸʷ u d ɯ
축일	t͡ɕʰ u ɡ i ɭ
에스체트	e̞ sʰ ɯ t͡ɕʰ e̞ tʰ ɯ
편암	pʰ j ʌ̹ n a̠ m
별표	p j ɘː ɭ pʰ j o
그레이프프루트	k͈ ɯ ɾ e̞ i pʰ ɯ pʰ ɯ ɾ u tʰ ɯ
서진	sʰ ʌ̹ d͡ʑ i n
갈문망둑	k a̠ ɭ m u n m a̠ ŋ d u k̚
치아	t͡ɕʰ i a̠
잔텐	t͡ɕ a̠ n tʰ e̞ n
반줄	p a̠ ɲ d͡ʑ u ɭ
케피르	kʰ e̞ pʰ i ɾ ɯ
벗기다	p ʌ̹ t̚ k͈ i d a̠
교수	k j oː sʰ u
멋	m ʌ̹ t̚
공화국	k o̞ː ŋ β w a̠ ɡ u k̚
우울	u u ɭ
집회	t͡ɕ i pʰ w e̞
간곡하다	k a̠ː n ɡ o̞ kʰ a̠ d a̠
상견례	sʰ a̠ ŋ ɡ j ʌ̹ ʎ ʎ j e̞
나이오븀	n a̠ i o̞ b j u m
손전화	sʰ o̞ ɲ d͡ʑ ʌ̹ n β w a̠
규율	k j u j u ɭ
룩	ɾ u k̚
사리	sʰ a̠ ɾ i
지역사회	t͡ɕ i j ʌ̹ k s͈ a̠ β w e̞
다락방	t a̠ ɾ a̠ k̚ p͈ a̠ ŋ
프랑	pʰ ɯ ɾ a̠ ŋ
불치다	p u ʎ t͡ɕʰ i d a̠
랍비	ɾ a̠ p̚ p͈ i
고작	k o̞ d͡ʑ a̠ k̚
도시	t o̞ ɕʰ i
유의어	j uː ɰ i ʌ̹
싶다	ɕʰ i p̚ t͈ a̠
지진학	t͡ɕ i d͡ʑ i n ɦ a̠ k̚
비평	p iː pʰ j ʌ̹ ŋ
내부	n ɛː b u
부릅뜨다	p u ɾ ɯ p̚ t͈ ɯ d a̠
불장난	p u ʎ d͡ʑ a̠ ŋ n a̠ n
포르투갈어	pʰ o̞ ɾ ɯ tʰ u ɡ a̠ ɾ ʌ̹
치명적	t͡ɕʰ i m j ʌ̹ ŋ d͡ʑ ʌ̹ k̚
빠이빠이	p͈ a̠ i p͈ a̠ i
퓒	pʰ ɥ i n
양즈	j a̠ ŋ d͡ʑ ɯ
기니피그	k i n i pʰ i ɡ ɯ
입력	i m ɲ j ʌ̹ k̚
무릎	m u ɾ ɯ p̚
스타일	sʰ ɯ tʰ a̠ i ɭ
조선글	t͡ɕ o̞ sʰ ʌ̹ n ɡ ɯ ɭ
샤타	ɕʰ a̠ tʰ a̠
전사	t͡ɕ ɘː n sʰ a̠
기록하다	k i ɾ o̞ kʰ a̠ d a̠
쾰른	kʰ w e̞ ɭ ɭ ɯ n
걸치다	k ɘː ʎ t͡ɕʰ i d a̠
낱낱이	n a̠ː n n a̠ t͡ɕʰ i
야간	j a̠ː ɡ a̠ n
브리핑	p ɯ ɾ i pʰ i ŋ
싸인펜	s͈ a̠ i n pʰ e̞ n
감방	k a̠ m b a̠ ŋ
화폐학	ɸ w a̠ pʰ j e̞ ɦ a̠ k̚
원	w ʌ̹ n
포경	pʰ o̞ː ɡ j ʌ̹ ŋ
대통령	t ɛː tʰ o̞ ŋ ɲ j ʌ̹ ŋ
얻	ʌ̹ t̚
장군석	t͡ɕ a̠ ŋ ɡ u n sʰ ʌ̹ k̚
오소리	o̞ sʰ o̞ ɾ i
각선미	k a̠ː k s͈ ʌ̹ n m i
부수다	p u sʰ u d a̠
포르핀	pʰ o̞ ɾ ɯ pʰ i n
축제일	t͡ɕʰ u k̚ t͡ɕ͈ e̞ i ɭ
합격	h a̠ p̚ k͈ j ʌ̹ k̚
베테랑	p e̞ tʰ e̞ ɾ a̠ ŋ
튀김	tʰ ɥ i ɡ i m
서쪽	sʰ ʌ̹ t͡ɕ͈ o̞ k̚
순두부	sʰ u n d u b u
노워스티	n o̞ w ʌ̹ sʰ ɯ tʰ i
기울다	k i u ɭ d a̠
입향순속	i pʰ j a̠ ŋ sʰ u n sʰ o̞ k̚
음력	ɯ m ɲ j ʌ̹ k̚
아뢰다	a̠ ɾ w e̞ d a̠
보드카	p o̞ d ɯ kʰ a̠
해협	h ɛː ʝ j ʌ̹ p̚
이러하다	i ɾ ʌ̹ ɦ a̠ d a̠
조합	t͡ɕ o̞ ɦ a̠ p̚
방구	p a̠ ŋ ɡ u
숭고	sʰ u ŋ ɡ o̞
기한	k i ɦ a̠ n
비단털들쥐	p i d a̠ n tʰ ʌ̹ ɭ d ɯ ʎ d͡ʑ ɥ i
급습	k ɯ p s͈ ɯ p̚
널리	n ʌ̹ ʎ ʎ i
두만가시고기	t u m a̠ n ɡ a̠ ɕʰ i ɡ o̞ ɡ i
지뢰	t͡ɕ i ɾ w e̞
득남	t ɯ ŋ n a̠ m
가벌	k a̠ b ʌ̹ ɭ
사역원	sʰ a̠ j ʌ̹ ɡ w ʌ̹ n
국토	k u k̚ tʰ o̞
조직	t͡ɕ o̞ d͡ʑ i k̚
연상	j ʌ̹ n sʰ a̠ ŋ
있어	i s͈ ʌ̹
마파두부	m a̠ pʰ a̠ d u b u
가보로네	k a̠ b o̞ ɾ o̞ n e̞
꼼치	k͈ o̞ m t͡ɕʰ i
깊이	k i pʰ i
무수	m u sʰ u
까자	k͈ a̠ː d͡ʑ a̠
정월	t͡ɕ ʌ̹ ŋ w ʌ̹ ɭ
후난	ɸʷ u n a̠ n
두상	t u sʰ a̠ ŋ
병신	p j ʌ̹ ŋ ɕʰ i n
끈적끈적하다	k͈ ɯ ɲ d͡ʑ ʌ̹ k̚ k͈ ɯ ɲ d͡ʑ ʌ̹ kʰ a̠ d a̠
강수	k a̠ː ŋ sʰ u
굶다	k uː m t͈ a̠
중소기업	t͡ɕ u ŋ sʰ o̞ ɡ i ʌ̹ p̚
걸작	k ʌ̹ ʎ t͡ɕ͈ a̠ k̚
북방토끼	p u k̚ p͈ a̠ ŋ tʰ o̞ k͈ i
정리	t͡ɕ ʌ̹ ŋ n i
슈퍼	ɕʰ u pʰ ʌ̹
허혼	h ʌ̹ β o̞ n
여단	j ɘː d a̠ n
중고기	t͡ɕ uː ŋ ɡ o̞ ɡ i
기침	k i t͡ɕʰ i m
가져오다	k a̠ d͡ʑ ʌ̹ o̞ d a̠
찬장	t͡ɕʰ a̠ː ɲ d͡ʑ a̠ ŋ
정오	t͡ɕ ɘː ŋ o̞
아몬드	a̠ m o̞ n d ɯ
종파	t͡ɕ o̞ ŋ pʰ a̠
유전자	j u d͡ʑ ʌ̹ ɲ d͡ʑ a̠
어휘	ɘː ɦ ɥ i
비데오필림	p i d e̞ o̞ pʰ i ʎ ʎ i m
느냐	n ɯ ɲ j a̠
아멘	a̠ m e̞ n
석의	sʰ ʌ̹ ɡ ɰ i
이라크어	i ɾ a̠ k x ɯ ʌ̹
명일	m j ʌ̹ ŋ i ɭ
겠	k e̞ t̚
브류쎌	p ɯ ɾ j u s͈ e̞ ɭ
결심	k j ʌ̹ ɭ ɕ͈ i m
풀망둑	pʰ u ɭ m a̠ ŋ d u k̚
아마	a̠ m a̠
곱사	k o̞ p s͈ a̠
맞부딪치다	m a̠ t̚ p͈ u d i t̚ t͡ɕʰ i d a̠
임자	iː m d͡ʑ a̠
겸손	k j ʌ̹ m sʰ o̞ n
바지락	p a̠ d͡ʑ i ɾ a̠ k̚
왜가리	w ɛː ɡ a̠ ɾ i
이질	iː d͡ʑ i ɭ
헛간	h ʌ̹ t̚ k͈ a̠ n
커뮤니케이션	kʰ ʌ̹ m j u n i kʰ e̞ i ɕʰ ʌ̹ n
목차	m o̞ k̚ t͡ɕʰ a̠
석랍	sʰ ʌ̹ ŋ n a̠ p̚
구석	k u sʰ ʌ̹ k̚
이메일	i m e̞ i ɭ
약식	j a̠ k ɕ͈ i k̚
온수	o̞ n sʰ u
카바졸	kʰ a̠ b a̠ d͡ʑ o̞ ɭ
실현하다	ɕʰ i ɾ ʝ j ʌ̹ n ɦ a̠ d a̠
거듭	k ʌ̹ d ɯ p̚
싸우다	s͈ a̠ u d a̠
면사	m j ʌ̹ n sʰ a̠
바람직하다	p a̠ ɾ a̠ m d͡ʑ i kʰ a̠ d a̠
목욕실	m o̞ ɡ j o k ɕ͈ i ɭ
영성	j ʌ̹ ŋ sʰ ʌ̹ ŋ
특	tʰ ɯ k̚
아즈바이	a̠ d͡ʑ ɯ b a̠ i
운동	uː n d o̞ ŋ
이상하다	iː sʰ a̠ ŋ ɦ a̠ d a̠
황후	ɸ w a̠ ŋ β u
팔라우	pʰ a̠ ɭ ɭ a̠ u
경계	k j ʌ̹ ŋ ɡ j e̞
얘기하다	j ɛː ɡ i ɦ a̠ d a̠
떼다	t͈ e̞ː d a̠
걸림씨	k ʌ̹ ʎ ʎ i m ɕ͈ i
방향족	p a̠ ŋ ʝ j a̠ ŋ d͡ʑ o̞ k̚
추수	t͡ɕʰ u sʰ u
제외하다	t͡ɕ e̞ w e̞ ɦ a̠ d a̠
구성원	k u sʰ ʌ̹ ŋ w ʌ̹ n
카자흐어	kʰ a̠ d͡ʑ a̠ ɣ ɯ ʌ̹
바마코	p a̠ m a̠ kʰ o̞
제우스	t͡ɕ e̞ u sʰ ɯ
조차	t͡ɕ o̞ t͡ɕʰ a̠
충	t͡ɕʰ u ŋ
벨기에	p e̞ ɭ ɡ i e̞
비망록	p iː m a̠ ŋ n o̞ k̚
우의	uː ɰ i
인식표	i n ɕʰ i k̚ pʰ j o
시시덕거리다	ɕʰ i ɕʰ i d ʌ̹ k̚ k͈ ʌ̹ ɾ i d a̠
인사하다	i n sʰ a̠ ɦ a̠ d a̠
움직임	u m d͡ʑ i ɡ i m
일취월장	i ʎ t͡ɕʰ ɥ i w ʌ̹ ʎ d͡ʑ a̠ ŋ
잡	t͡ɕ a̠ p̚
머릿결	m ʌ̹ ɾ i t̚ k͈ j ʌ̹ ɭ
눈엣가시	n u n e̞ t̚ k͈ a̠ ɕʰ i
탄소	tʰ a̠ː n sʰ o̞
교복	k j oː b o̞ k̚
짝짓다	t͡ɕ͈ a̠ k̚ t͡ɕ͈ i t̚ t͈ a̠
외손녀	w e̞ː sʰ o̞ n ɲ j ʌ̹
목청	m o̞ k̚ t͡ɕʰ ʌ̹ ŋ
주소	t͡ɕ uː sʰ o̞
포리지	pʰ o̞ ɾ i d͡ʑ i
거머리	k ɘː m ʌ̹ ɾ i
긴꼬리꼬마쥐	k i n k͈ o̞ ɾ i k͈ o̞ m a̠ d͡ʑ ɥ i
두어	t u ʌ̹
어쩌면	ʌ̹ t͡ɕ͈ ʌ̹ m j ʌ̹ n
꿈	k͈ u m
올겨울	o̞ ɭ k͈ j ʌ̹ u ɭ
수레	sʰ u ɾ e̞
미주알	m i d͡ʑ u a̠ ɭ
음반	ɯ m b a̠ n
피지	pʰ i d͡ʑ i
토착	tʰ o̞ t͡ɕʰ a̠ k̚
아니메	a̠ n i m e̞
프로	pʰ ɯ ɾ o̞
굿	k u t̚
뼘	p͈ j ʌ̹ m
간단히	k a̠ n d a̠ n ʝ i
발기	p a̠ ɭ ɡ i
미얀마	m i j a̠ n m a̠
연주	j ɘː ɲ d͡ʑ u
울타리	u ɭ tʰ a̠ ɾ i
모욕	m o̞ː j o k̚
대규모	t ɛː ɡ j u m o̞
부전자전	p u d͡ʑ ʌ̹ ɲ d͡ʑ a̠ d͡ʑ ʌ̹ n
어린아이	ʌ̹ ɾ i n a̠ i
불가능하다	p u ɭ ɡ a̠ n ɯ ŋ ɦ a̠ d a̠
훤	ɸ w ʌ̹ n
사무라이	sʰ a̠ m u ɾ a̠ i
유언	j u ʌ̹ n
분류	p u ʎ ʎ j u
연고	j ɘː n ɡ o̞
훑다	ɸʷ u ɭ t͈ a̠
다들	t a̠ d ɯ ɭ
포피	pʰ o̞ pʰ i
가무이야기	k a̠ m u i j a̠ ɡ i
천둥	t͡ɕʰ ʌ̹ n d u ŋ
공업화	k o̞ː ŋ ʌ̹ pʰ w a̠
만지다	m a̠ ɲ d͡ʑ i d a̠
위협하다	ɥ i ʝ j ʌ̹ pʰ a̠ d a̠
붉은뺨가마우지	p u ɭ ɡ ɯ n p͈ j a̠ m ɡ a̠ m a̠ u d͡ʑ i
오페라	o̞ pʰ e̞ ɾ a̠
점프하다	t͡ɕ ʌ̹ m pʰ ɯ ɦ a̠ d a̠
경영	k j ʌ̹ ŋ j ʌ̹ ŋ
포켓	pʰ o̞ kʰ e̞ t̚
관찰하다	k w a̠ ɲ t͡ɕʰ a̠ ɾ ɦ a̠ d a̠
내	n ɛː
흔하다	x ɯ n ɦ a̠ d a̠
음역	ɯ m j ʌ̹ k̚
보다도	p o̞ d a̠ d o̞
인돌	i n d o̞ ɭ
쇼비니즘	ɕʰ o b i n i d͡ʑ ɯ m
건망증	k ɘː n m a̠ ŋ t͡ɕ͈ ɯ ŋ
그러다	k ɯ ɾ ʌ̹ d a̠
남성	n a̠ m sʰ ʌ̹ ŋ
안성맞춤	a̠ n sʰ ʌ̹ ŋ m a̠ t̚ t͡ɕʰ u m
옛말	j e̞ː n m a̠ ɭ
못	m o̞ː t̚
자명금	t͡ɕ a̠ m j ʌ̹ ŋ ɡ ɯ m
개별자	k ɛː b j ʌ̹ ʎ t͡ɕ͈ a̠
흑역사	x ɯ ɡ j ʌ̹ k s͈ a̠
잡담하다	t͡ɕ a̠ p̚ t͈ a̠ m ɦ a̠ d a̠
갚다	k a̠ p̚ t͈ a̠
우체국	u t͡ɕʰ e̞ ɡ u k̚
두목	t u m o̞ k̚
성상	sʰ ɘː ŋ sʰ a̠ ŋ
엄지	ʌ̹ m d͡ʑ i
계열	k j e̞ j ʌ̹ ɭ
벼리다	p j ʌ̹ ɾ i d a̠
제공하다	t͡ɕ e̞ ɡ o̞ ŋ ɦ a̠ d a̠
정하다	t͡ɕ ɘː ŋ ɦ a̠ d a̠
취향	t͡ɕʰ ɥ iː ʝ j a̠ ŋ
아주	a̠ d͡ʑ u
기차역	k i t͡ɕʰ a̠ j ʌ̹ k̚
염복	j ɘː m b o̞ k̚
미꾸리	m i k͈ u ɾ i
성심	sʰ ʌ̹ ŋ ɕʰ i m
자유	t͡ɕ a̠ j u
모르폴린	m o̞ ɾ ɯ pʰ o̞ ʎ ʎ i n
소풍	sʰ o̞ pʰ u ŋ
낮아지다	n a̠ d͡ʑ a̠ d͡ʑ i d a̠
배부	p ɛː b u
라오어	ɾ a̠ o̞ ʌ̹
왕자	w a̠ː ŋ d͡ʑ a̠
범이신론	p ʌ̹ m i ɕʰ i ɭ ɭ o̞ n
ㅛ	j o
농산물	n o̞ ŋ sʰ a̠ n m u ɭ
체위	t͡ɕʰ e̞ ɥ i
언	ʌ̹ n
부끄러워하다	p u k͈ ɯ ɾ ʌ̹ w ʌ̹ ɦ a̠ d a̠
하루	h a̠ ɾ u
관세	k w a̠ n sʰ e̞
아인슈타이늄	a̠ i n ɕʰ u tʰ a̠ i ɲ j u m
페르시아	pʰ e̞ ɾ ɯ ɕʰ i a̠
우선	u sʰ ʌ̹ n
정관사	t͡ɕ ɘː ŋ ɡ w a̠ n sʰ a̠
아나테마	a̠ n a̠ tʰ e̞ m a̠
고요하다	k o̞ j o ɦ a̠ d a̠
면역	m j ɘː ɲ j ʌ̹ k̚
관심	k w a̠ n ɕʰ i m
거만	k ɘː m a̠ n
담당	t a̠ m d a̠ ŋ
방콕	p a̠ ŋ kʰ o̞ k̚
예산	j e̞ː sʰ a̠ n
고바야시박쥐	k o̞ b a̠ j a̠ ɕʰ i b a̠ k̚ t͡ɕ͈ ɥ i
의상	ɰ i sʰ a̠ ŋ
산토도밍고	sʰ a̠ n tʰ o̞ d o̞ m i ŋ ɡ o̞
비롯되다	p i ɾ o̞ t̚ t͈ w e̞ d a̠
남친	n a̠ m t͡ɕʰ i n
멀어지다	m ɘː ɾ ʌ̹ d͡ʑ i d a̠
인터넷	i n tʰ ʌ̹ n e̞ t̚
월경	w ʌ̹ ɭ ɡ j ʌ̹ ŋ
등불	t ɯ ŋ p͈ u ɭ
경멸적	k j ʌ̹ ŋ m j ʌ̹ ʎ t͡ɕ͈ ʌ̹ k̚
완전	w a̠ ɲ d͡ʑ ʌ̹ n
ㅏ	a̠
감탄	k a̠ː m tʰ a̠ n
선상	sʰ ʌ̹ n sʰ a̠ ŋ
달력	t a̠ ʎ ʎ j ʌ̹ k̚
압록자그사니	a̠ m n o̞ k̚ t͡ɕ͈ a̠ ɡ ɯ sʰ a̠ n i
이루어지다	i ɾ u ʌ̹ d͡ʑ i d a̠
프리즘	pʰ ɯ ɾ i d͡ʑ ɯ m
이슬비	i sʰ ɯ ɭ b i
아우	a̠ u
개미	k ɛː m i
후뇌	ɸʷ u n w e̞
버팔로	p ʌ̹ pʰ a̠ ɭ ɭ o̞
꿋꿋하다	k͈ u t̚ k͈ u tʰ a̠ d a̠
청	t͡ɕʰ ʌ̹ ŋ
민족	m i ɲ d͡ʑ o̞ k̚
바다제비	p a̠ d a̠ d͡ʑ e̞ b i
군주	k u ɲ d͡ʑ u
홑이불	ɸʷ o̞ n n i b u ɭ
냥	ɲ j a̠ ŋ
길잡이	k i ʎ d͡ʑ a̠ b i
지난달	t͡ɕ i n a̠ n d a̠ ɭ
아깝다	a̠ k͈ a̠ p̚ t͈ a̠
어학	ɘː ɦ a̠ k̚
도롱뇽	t o̞ ɾ o̞ ŋ ɲ j o ŋ
은근히	ɯ n ɡ ɯ n ʝ i
관장	k w a̠ ɲ d͡ʑ a̠ ŋ
세젤귀	sʰ e̞ d͡ʑ e̞ ɭ ɡ ɥ i
퉁	tʰ u ŋ
개고기	k ɛː ɡ o̞ ɡ i
반말	p a̠ n m a̠ ɭ
비엔티안	p i e̞ n tʰ i a̠ n
브로치	p ɯ ɾ o̞ t͡ɕʰ i
청진	t͡ɕʰ ʌ̹ ŋ d͡ʑ i n
간식	k a̠ː n ɕʰ i k̚
몽고	m o̞ ŋ ɡ o̞
고통	k o̞ tʰ o̞ ŋ
머리물비누	m ʌ̹ ɾ i m u ɭ b i n u
방안	p a̠ ŋ a̠ n
중요	t͡ɕ uː ŋ j o
아피아	a̠ pʰ i a̠
대모	t ɛː m o̞
티오펜	tʰ i o̞ pʰ e̞ n
엄습	ʌ̹ m sʰ ɯ p̚
파스텔	pʰ a̠ sʰ ɯ tʰ e̞ ɭ
전환하다	t͡ɕ ɘː n β w a̠ n ɦ a̠ d a̠
윁남	w e̞ n n a̠ m
여사친	j ʌ̹ sʰ a̠ t͡ɕʰ i n
미터	m i tʰ ʌ̹
궁금하다	k u ŋ ɡ ɯ m ɦ a̠ d a̠
간물	k a̠ n m u ɭ
진부하다	t͡ɕ i n b u ɦ a̠ d a̠
읽다	i k̚ t͈ a̠
나라	n a̠ ɾ a̠
경제과학	k j ʌ̹ ŋ d͡ʑ e̞ ɡ w a̠ ɦ a̠ k̚
날짜	n a̠ ʎ t͡ɕ͈ a̠
초상	t͡ɕʰ o̞ sʰ a̠ ŋ
달성	t a̠ ɭ s͈ ʌ̹ ŋ
료리	ɾ j o ɾ i
카트만두	kʰ a̠ tʰ ɯ m a̠ n d u
동글다	t o̞ ŋ ɡ ɯ ɭ d a̠
비교급	p iː ɡ j o ɡ ɯ p̚
소고기	sʰ o̞ ɡ o̞ ɡ i
적절하다	t͡ɕ ʌ̹ k̚ t͡ɕ͈ ʌ̹ ɾ ɦ a̠ d a̠
귀뚤귀	k ɥ i t͈ u ɭ ɡ ɥ i
쿠냥	kʰ u ɲ j a̠ ŋ
건더기	k ʌ̹ n d ʌ̹ ɡ i
미륵	m i ɾ ɯ k̚
부호	p uː β o̞
얕잡다	j a̠ t̚ t͡ɕ͈ a̠ p̚ t͈ a̠
스시	sʰ ɯ ɕʰ i
곊	k j e̞ n
흠결	x ɯ m ɡ j ʌ̹ ɭ
진공	t͡ɕ i n ɡ o̞ ŋ
기똥차다	k i t͈ o̞ ŋ t͡ɕʰ a̠ d a̠
포물선	pʰ o̞ː m u ɭ s͈ ʌ̹ n
짜리	t͡ɕ͈ a̠ ɾ i
리믹스	ɾ i m i k s͈ ɯ
시장하다	ɕʰ i d͡ʑ a̠ ŋ ɦ a̠ d a̠
평온	pʰ j ʌ̹ ŋ o̞ n
엇	ʌ̹ t̚
단지	t a̠ ɲ d͡ʑ i
야한	j a̠ː ɦ a̠ n
다스	t a̠ sʰ ɯ
느껴지다	n ɯ k͈ j ʌ̹ d͡ʑ i d a̠
안테나	a̠ n tʰ e̞ n a̠
예상하다	j e̞ː sʰ a̠ ŋ ɦ a̠ d a̠
해삼	h ɛː sʰ a̠ m
포도주	pʰ o̞ d o̞ d͡ʑ u
관절염	k w a̠ ɲ d͡ʑ ʌ̹ ɾ j ʌ̹ m
저고리	t͡ɕ ʌ̹ ɡ o̞ ɾ i
시점	ɕʰ i d͡ʑ ʌ̹ m
이미	i m i
돈까스	t o̞ n k͈ a̠ sʰ ɯ
만들어지다	m a̠ n d ɯ ɾ ʌ̹ d͡ʑ i d a̠
월	w ʌ̹ ɭ
허수	h ʌ̹ sʰ u
손톱깎이	sʰ o̞ n tʰ o̞ p̚ k͈ a̠ k͈ i
원망	w ʌ̹ n m a̠ ŋ
공짜	k o̞ ŋ t͡ɕ͈ a̠
서점	sʰ ʌ̹ d͡ʑ ʌ̹ m
무릇	m u ɾ ɯ t̚
작별	t͡ɕ a̠ k̚ p͈ j ʌ̹ ɭ
밝다	p a̠ k̚ t͈ a̠
사인	sʰ a̠ː i n
감람	k a̠ː m n a̠ m
앞서	a̠ p s͈ ʌ̹
세미나	sʰ e̞ m i n a̠
모루	m o̞ː ɾ u
간균	k a̠ n ɡ j u n
민망	m i n m a̠ ŋ
모가디슈	m o̞ ɡ a̠ d i ɕʰ u
전화기	t͡ɕ ɘː n β w a̠ ɡ i
수수께끼	sʰ u sʰ u k͈ e̞ k͈ i
아스파라거스	a̠ sʰ ɯ pʰ a̠ ɾ a̠ ɡ ʌ̹ sʰ ɯ
시에라리온	ɕ͈ i e̞ ɾ a̠ ɾ i o̞ n
걱정되다	k ʌ̹ k̚ t͡ɕ͈ ʌ̹ ŋ d w e̞ d a̠
광주	k w a̠ː ŋ d͡ʑ u
십이지장	ɕʰ i b i d͡ʑ i d͡ʑ a̠ ŋ
아크리딘	a̠ k x ɯ ɾ i d i n
인격	i n k͈ j ʌ̹ k̚
부잣집	p uː d͡ʑ a̠ t̚ t͡ɕ͈ i p̚
밥벌이	p a̠ p̚ p͈ ʌ̹ ɾ i
솔직하다	sʰ o̞ ʎ d͡ʑ i kʰ a̠ d a̠
속성음식	sʰ o̞ k s͈ ʌ̹ ŋ ɯ m ɕʰ i k̚
나선	n a̠ sʰ ʌ̹ n
관할	k w a̠ n ɦ a̠ ɭ
설포닐기	sʰ ʌ̹ ɭ pʰ o̞ n i ɭ ɡ i
췌장암	t͡ɕʰ w e̞ː d͡ʑ a̠ ŋ a̠ m
주정꾼	t͡ɕ uː d͡ʑ ʌ̹ ŋ k͈ u n
엉	ʌ̹ ŋ
견디다	k j ʌ̹ n d i d a̠
아라한	a̠ ɾ a̠ ɦ a̠ n
오물	o̞ː m u ɭ
불닭	p u ɭ d a̠ k̚
점령	t͡ɕ ʌ̹ m ɲ j ʌ̹ ŋ
등피	t ɯ ŋ pʰ i
탈의실	tʰ a̠ ɾ ɰ i ɕʰ i ɭ
녘	ɲ j ʌ̹ k̚
속다	sʰ o̞ k̚ t͈ a̠
온	o̞ n
꺽지	k͈ ʌ̹ k̚ t͡ɕ͈ i
파산하다	pʰ a̠ː sʰ a̠ n ɦ a̠ d a̠
삽입곡	sʰ a̠ b i p̚ k͈ o̞ k̚
도	t o̞
매일	m ɛː i ɭ
붙다	p u t̚ t͈ a̠
모텔	m o̞ tʰ e̞ ɭ
당질	t a̠ ŋ d͡ʑ i ɭ
그런	k ɯ ɾ ʌ̹ n
허난	h ʌ̹ n a̠ n
고립지	k o̞ ɾ i p̚ t͡ɕ͈ i
노트북	n o̞ tʰ ɯ b u k̚
이마	i m a̠
상추	sʰ a̠ ŋ t͡ɕʰ u
젖다	t͡ɕ ʌ̹ t̚ t͈ a̠
검찰청	k ɘː m t͡ɕʰ a̠ ʎ t͡ɕʰ ʌ̹ ŋ
의미론	ɰ iː m i ɾ o̞ n
렬도	ɾ j ʌ̹ ɭ t͈ o̞
멱	m j ʌ̹ k̚
정통	t͡ɕ ʌ̹ ŋ tʰ o̞ ŋ
누나	n uː n a̠
조르다	t͡ɕ o̞ ɾ ɯ d a̠
대화방	t ɛː β w a̠ b a̠ ŋ
레즈비언	ɾ e̞ d͡ʑ ɯ b i ʌ̹ n
교도소	k j oː d o̞ sʰ o̞
우리들	u ɾ i d ɯ ɭ
칼리닌그라드	kʰ a̠ ʎ ʎ i n i n ɡ ɯ ɾ a̠ d ɯ
완전하다	w a̠ ɲ d͡ʑ ʌ̹ n ɦ a̠ d a̠
차다	t͡ɕʰ a̠ d a̠
조립하다	t͡ɕ o̞ ɾ i pʰ a̠ d a̠
복건성	p o̞ k̚ k͈ ʌ̹ n sʰ ʌ̹ ŋ
아편	a̠ pʰ j ʌ̹ n
굴리다	k u ʎ ʎ i d a̠
최고	t͡ɕʰ w e̞ː ɡ o̞
지복직관	t͡ɕ iː b o̞ k̚ t͡ɕ͈ i k̚ k͈ w a̠ n
방플	p a̠ː ŋ pʰ ɯ ɭ
이소시아니드	i sʰ o̞ ɕʰ i a̠ n i d ɯ
알켄	a̠ ɭ kʰ e̞ n
고발	k o̞ː b a̠ ɭ
쉬다	ʃʰ ɥ iː d a̠
넘어서다	n ʌ̹ m ʌ̹ sʰ ʌ̹ d a̠
조반	t͡ɕ o̞ː b a̠ n
둥간어	t u ŋ ɡ a̠ n ʌ̹
일본주	i ɭ b o̞ ɲ d͡ʑ u
토론하다	tʰ o̞ː ɾ o̞ n ɦ a̠ d a̠
수확	sʰ u β w a̠ k̚
대퇴	t ɛː tʰ w e̞
호박산	ɸʷ o̞ b a̠ k s͈ a̠ n
분묘	p u n m j o
세수하다	sʰ e̞ː sʰ u ɦ a̠ d a̠
쓰레기통	s͈ ɯ ɾ e̞ ɡ i tʰ o̞ ŋ
시위	ɕʰ iː ɥ i
조종사	t͡ɕ o̞ d͡ʑ o̞ ŋ sʰ a̠
아민	a̠ m i n
다르에스살람	t a̠ ɾ ɯ e̞ sʰ ɯ sʰ a̠ ɭ ɭ a̠ m
드라이기	t ɯ ɾ a̠ i ɡ i
마음씨	m a̠ ɯ m ɕ͈ i
걸리다	k ʌ̹ ʎ ʎ i d a̠
디귿	t i ɡ ɯ t̚
주장하다	t͡ɕ u d͡ʑ a̠ ŋ ɦ a̠ d a̠
지우다	t͡ɕ i u d a̠
농후하다	n o̞ ŋ β u ɦ a̠ d a̠
파친코	pʰ a̠ t͡ɕʰ i n kʰ o̞
발열	p a̠ ɾ j ʌ̹ ɭ
미분몫	m i b u n m o̞ k̚
돼지고기	t w ɛː d͡ʑ i ɡ o̞ ɡ i
단무지	t a̠ n m u d͡ʑ i
설치류	sʰ ʌ̹ ʎ t͡ɕʰ i ɾ j u
만포	m a̠ː n pʰ o̞
최선	t͡ɕʰ w e̞ː sʰ ʌ̹ n
발바리	p a̠ ɭ b a̠ ɾ i
창고	t͡ɕʰ a̠ ŋ k͈ o̞
도우미	t o̞ u m i
잡종견	t͡ɕ a̠ p̚ t͡ɕ͈ o̞ ŋ ɡ j ʌ̹ n
당나귀	t a̠ ŋ n a̠ ɡ ɥ i
헛코골다	h ʌ̹ t̚ kʰ o̞ ɡ o̞ ɭ d a̠
부끄리다	p u k͈ ɯ ɾ i d a̠
기억나다	k i ʌ̹ ŋ n a̠ d a̠
최종	t͡ɕʰ w e̞ː d͡ʑ o̞ ŋ
종아리뼈	t͡ɕ o̞ː ŋ a̠ ɾ i p͈ j ʌ̹
음경	ɯ m ɡ j ʌ̹ ŋ
장난꾸러기	t͡ɕ a̠ ŋ n a̠ n k͈ u ɾ ʌ̹ ɡ i
쑥갓	s͈ u k̚ k͈ a̠ t̚
등자	t ɯ ŋ d͡ʑ a̠
젓	t͡ɕ ʌ̹ t̚
열아홉	j ʌ̹ ɾ a̠ β o̞ p̚
자유주의	t͡ɕ a̠ j u d͡ʑ u ɰ i
크레인	k x ɯ ɾ e̞ i n
관방학	k w a̠ n b a̠ ŋ ɦ a̠ k̚
언뜻	ʌ̹ n t͈ ɯ t̚
리두	ɾ iː d u
의자	ɰ i d͡ʑ a̠
외면	w e̞ː m j ʌ̹ n
부귀	p uː ɡ ɥ i
필순	pʰ i ɭ sʰ u n
성게	sʰ ɘː ŋ ɡ e̞
걷기	k ɘː t̚ k͈ i
뉴	ɲ j u
덧	t ʌ̹ t̚
리더	ɾ i d ʌ̹
복엽기	p o̞ ɡ j ʌ̹ p̚ k͈ i
엘니노	e̞ ʎ ʎ i n o̞
얼음보숭이	ʌ̹ ɾ ɯ m b o̞ sʰ u ŋ i
도체	t o̞ː t͡ɕʰ e̞
유니폼	j u n i pʰ o̞ m
가련히	k a̠ ɾ j ʌ̹ n ʝ i
소리치다	sʰ o̞ ɾ i t͡ɕʰ i d a̠
리어카	ɾ i ʌ̹ kʰ a̠
뽀뽀하다	p͈ o̞ p͈ o̞ ɦ a̠ d a̠
오스트레일리아	o̞ sʰ ɯ tʰ ɯ ɾ e̞ i ʎ ʎ i a̠
증언	t͡ɕ ɯ ŋ ʌ̹ n
총명하다	t͡ɕʰ o̞ ŋ m j ʌ̹ ŋ ɦ a̠ d a̠
시집	ɕʰ i d͡ʑ i p̚
갈륨	k a̠ ʎ ʎ j u m
유릿조각	j u ɾ i t̚ t͡ɕ͈ o̞ ɡ a̠ k̚
항문	h a̠ ŋ m u n
분노	p uː n n o̞
믈	m ɯ ɭ
미역국	m i j ʌ̹ k̚ k͈ u k̚
빌딩	p i ɭ d i ŋ
도서관	t o̞ sʰ ʌ̹ ɡ w a̠ n
안남	a̠ n n a̠ m
사소하다	sʰ a̠ sʰ o̞ ɦ a̠ d a̠
가	k a̠
퓨린	pʰ j u ɾ i n
땅콩	t͈ a̠ ŋ kʰ o̞ ŋ
떫다	t͈ ɘː ɭ t͈ a̠
피에로	pʰ i e̞ ɾ o̞
친우	t͡ɕʰ i n u
흑로	x ɯ ŋ n o̞
전라북도	t͡ɕ ʌ̹ ɭ ɭ a̠ b u k̚ t͈ o̞
투사지	tʰ u sʰ a̠ d͡ʑ i
콤마	kʰ o̞ m m a̠
불만	p u ɭ m a̠ n
가물가물	k a̠ m u ɭ ɡ a̠ m u ɭ
식품보존료	ɕʰ i k̚ pʰ u m b o̞ d͡ʑ o̞ ʎ ʎ j o
몫몫이	m o̞ ŋ m o̞ k ɕ͈ i
엘리베이터	e̞ ʎ ʎ i b e̞ i tʰ ʌ̹
아저씨	a̠ d͡ʑ ʌ̹ ɕ͈ i
아리	a̠ ɾ i
겨드랑이	k j ʌ̹ d ɯ ɾ a̠ ŋ i
아낙	a̠ n a̠ k̚
미	m i
었	ʌ̹ t̚
제동기	t͡ɕ e̞ː d o̞ ŋ ɡ i
음식	ɯː m ɕʰ i k̚
개장국	k ɛː d͡ʑ a̠ ŋ k͈ u k̚
폭격기	pʰ o̞ k̚ k͈ j ʌ̹ k̚ k͈ i
선거	sʰ ɘː n ɡ ʌ̹
지위	t͡ɕ i ɥ i
갸웃	k j a̠ u t̚
삼인칭	sʰ a̠ m i ɲ t͡ɕʰ i ŋ
뒹굴다	t ɥ i ŋ ɡ u ɭ d a̠
열다섯	j ʌ̹ ɭ t͈ a̠ sʰ ʌ̹ t̚
얼룩동사리	ʌ̹ ɭ ɭ u k̚ t͈ o̞ ŋ sʰ a̠ ɾ i
되게	t w e̞ː ɡ e̞
경성	k j ʌ̹ ŋ sʰ ʌ̹ ŋ
들판	t ɯː ɭ pʰ a̠ n
그립다	k ɯ ɾ i p̚ t͈ a̠
비누	p i n u
대박	t ɛː b a̠ k̚
언론가	ʌ̹ ɭ ɭ o̞ n ɡ a̠
그리스	k ɯ ɾ i sʰ ɯ
찍소리	t͡ɕ͈ i k s͈ o̞ ɾ i
허가	h ʌ̹ ɡ a̠
상형	sʰ a̠ ŋ ʝ j ʌ̹ ŋ
가을	k a̠ ɯ ɭ
파산	pʰ a̠ː sʰ a̠ n
짝짓기	t͡ɕ͈ a̠ k̚ t͡ɕ͈ i t̚ k͈ i
교거	k j o ɡ ʌ̹
오이	o̞ i
성의	sʰ ʌ̹ ŋ ɰ i
아울러	a̠ u ɭ ɭ ʌ̹
만족	m a̠ ɲ d͡ʑ o̞ k̚
나르다	n a̠ ɾ ɯ d a̠
교장	k j oː d͡ʑ a̠ ŋ
나타나다	n a̠ tʰ a̠ n a̠ d a̠
조성	t͡ɕ o̞ sʰ ʌ̹ ŋ
너구리	n ʌ̹ ɡ u ɾ i
리투아니아어	ɾ i tʰ u a̠ n i a̠ ʌ̹
ㅜ	u
옷장	o̞ t̚ t͡ɕ͈ a̠ ŋ
제물	t͡ɕ e̞ m u ɭ
소환	sʰ o̞ β w a̠ n
베닌	p e̞ n i n
아이콘	a̠ i kʰ o̞ n
언론학자	ʌ̹ ɭ ɭ o̞ n ɦ a̠ k̚ t͡ɕ͈ a̠
면하다	m j ɘː n ɦ a̠ d a̠
지불	t͡ɕ i b u ɭ
자가사리	t͡ɕ a̠ ɡ a̠ sʰ a̠ ɾ i
까뀌	k͈ a̠ː k͈ ɥ i
몸통	m o̞ m tʰ o̞ ŋ
호사비오리	ɸʷ o̞ sʰ a̠ b i o̞ ɾ i
외국	w e̞ː ɡ u k̚
소화	sʰ o̞ β w a̠
윤곽	j u n ɡ w a̠ k̚
자주	t͡ɕ a̠ d͡ʑ u
습니다	s͈ ɯ m n i d a̠
자랑	t͡ɕ a̠ ɾ a̠ ŋ
사냥	sʰ a̠ ɲ j a̠ ŋ
거절	k ʌ̹ d͡ʑ ʌ̹ ɭ
똑같다	t͈ o̞ k̚ k͈ a̠ t̚ t͈ a̠
츼	t͡ɕʰ i
성분	sʰ ʌ̹ ŋ b u n
탈주병	tʰ a̠ ʎ t͡ɕ͈ u b j ʌ̹ ŋ
상관	sʰ a̠ː ŋ ɡ w a̠ n
기초하다	k i t͡ɕʰ o̞ ɦ a̠ d a̠
오사카	o̞ sʰ a̠ kʰ a̠
얇다	j a̠ː ɭ t͈ a̠
모기	m o̞ː ɡ i
설비	sʰ ʌ̹ ɭ b i
부장	p u d͡ʑ a̠ ŋ
강정	k a̠ ŋ d͡ʑ ʌ̹ ŋ
미리견	m i ɾ i ɡ j ʌ̹ n
이렇게	i ɾ ʌ̹ kʰ e̞
이벤트	i b e̞ n tʰ ɯ
박하	p a̠ kʰ a̠
건너가다	k ɘː n n ʌ̹ ɡ a̠ d a̠
입장	i p̚ t͡ɕ͈ a̠ ŋ
갑충	k a̠ p̚ t͡ɕʰ u ŋ
영화	j ʌ̹ ŋ β w a̠
알릴기	a̠ ʎ ʎ i ɭ ɡ i
얻다	ʌ̹ t̚ t͈ a̠
지식	t͡ɕ i ɕʰ i k̚
직할시	t͡ɕ i kʰ a̠ ɭ ɕʰ i
합작	h a̠ p̚ t͡ɕ͈ a̠ k̚
석탄	sʰ ʌ̹ k̚ tʰ a̠ n
보호	p o̞ː β o̞
오페레타	o̞ pʰ e̞ ɾ e̞ tʰ a̠
아이디어	a̠ i d i ʌ̹
삯	sʰ a̠ k̚
야구	j a̠ː ɡ u
마지막	m a̠ d͡ʑ i m a̠ k̚
암	a̠ m
세월	sʰ e̞ w ʌ̹ ɭ
갉	k a̠ k̚
공정하다	k o̞ ŋ d͡ʑ ʌ̹ ŋ ɦ a̠ d a̠
순양함	sʰ u ɲ j a̠ ŋ ɦ a̠ m
나찰	n a̠ t͡ɕʰ a̠ ɭ
작전	t͡ɕ a̠ k̚ t͡ɕ͈ ʌ̹ n
유교	j u ɡ j o
노아	n o̞ a̠
회계	ɸ w e̞ː ɡ j e̞
큰첨서	k x ɯ ɲ t͡ɕʰ ʌ̹ m sʰ ʌ̹
사납다	sʰ a̠ː n a̠ p̚ t͈ a̠
중화인민공화국	t͡ɕ uː ŋ β w a̠ i n m i n ɡ o̞ ŋ β w a̠ ɡ u k̚
도와주다	t o̞ w a̠ d͡ʑ u d a̠
세상	sʰ e̞ː sʰ a̠ ŋ
삼국	sʰ a̠ m ɡ u k̚
불쌍	p u ɭ s͈ a̠ ŋ
발짝	p a̠ ʎ t͡ɕ͈ a̠ k̚
눈	n u n
승하	sʰ ɯ ŋ ɦ a̠
우르두어	u ɾ ɯ d u ʌ̹
시민권	ɕʰ iː m i n k͈ w ʌ̹ n
일단	i ɭ t͈ a̠ n
죄송하다	t͡ɕ w e̞ː sʰ o̞ ŋ ɦ a̠ d a̠
광	k w a̠ː ŋ
무찌르다	m u t͡ɕ͈ i ɾ ɯ d a̠
임금	iː m ɡ ɯ m
속도	sʰ o̞ k̚ t͈ o̞
늙은이	n ɯ ɭ ɡ ɯ n i
포르토노보	pʰ o̞ ɾ ɯ tʰ o̞ n o̞ b o̞
고추자지	k o̞ t͡ɕʰ u d͡ʑ a̠ d͡ʑ i
조카딸	t͡ɕ o̞ kʰ a̠ t͈ a̠ ɭ
위험하다	ɥ i ɦ ʌ̹ m ɦ a̠ d a̠
얼음	ʌ̹ ɾ ɯ m
헬기	h e̞ ɭ ɡ i
실린더	ɕʰ i ʎ ʎ i n d ʌ̹
과금	k w a̠ ɡ ɯ m
내각	n ɛː ɡ a̠ k̚
고유어	k o̞ j u ʌ̹
남아프리카	n a̠ m a̠ pʰ ɯ ɾ i kʰ a̠
테니스	tʰ e̞ n i sʰ ɯ
이력서	iː ɾ j ʌ̹ k s͈ ʌ̹
허락하다	h ʌ̹ ɾ a̠ kʰ a̠ d a̠
수리아	sʰ u ɾ i a̠
외동딸	w e̞ d o̞ ŋ t͈ a̠ ɭ
오금	o̞ ɡ ɯ m
광물	k w a̠ː ŋ m u ɭ
가야금	k a̠ j a̠ ɡ ɯ m
사탄	sʰ a̠ tʰ a̠ n
젤리	t͡ɕ e̞ ʎ ʎ i
달구지	t a̠ ɭ ɡ u d͡ʑ i
산문	sʰ a̠ː n m u n
드라이브	t ɯ ɾ a̠ i b ɯ
특유	tʰ ɯ ɡ j u
붓	p u t̚
물수리	m u ɭ s͈ u ɾ i
사모아	sʰ a̠ m o̞ a̠
칩	t͡ɕʰ i p̚
기자	k i d͡ʑ a̠
냐	ɲ j a̠
소독제	sʰ o̞ d o̞ k̚ t͡ɕ͈ e̞
흥하다	x ɯ ŋ ɦ a̠ d a̠
방법	p a̠ ŋ b ʌ̹ p̚
악몽	a̠ ŋ m o̞ ŋ
카불	kʰ a̠ b u ɭ
수영하다	sʰ u j ʌ̹ ŋ ɦ a̠ d a̠
차별	t͡ɕʰ a̠ b j ʌ̹ ɭ
지껄이다	t͡ɕ i k͈ ʌ̹ ɾ i d a̠
분점	p u ɲ d͡ʑ ʌ̹ m
입술	i p s͈ u ɭ
중량	t͡ɕ uː ŋ ɲ j a̠ ŋ
치닫다	t͡ɕʰ i d a̠ t̚ t͈ a̠
무치다	m u t͡ɕʰ i d a̠
반바지	p a̠ː n b a̠ d͡ʑ i
마천루	m a̠ t͡ɕʰ ʌ̹ ɭ ɭ u
허구	h ʌ̹ ɡ u
한반도	h a̠ n b a̠ n d o̞
글쓰기	k ɯ ɭ s͈ ɯ ɡ i
충청북도	t͡ɕʰ u ŋ t͡ɕʰ ʌ̹ ŋ b u k̚ t͈ o̞
바깥	p a̠ k͈ a̠ t̚
윷놀이	j uː n n o̞ ɾ i
벵골어	p e̞ ŋ ɡ o̞ ɾ ʌ̹
호선	ɸʷ o̞ sʰ ʌ̹ n
유형	j uː ʝ j ʌ̹ ŋ
명주	m j ʌ̹ ŋ d͡ʑ u
쪼박	t͡ɕ͈ o̞ b a̠ k̚
관문	k w a̠ n m u n
몹시	m o̞ː p ɕ͈ i
전등	t͡ɕ ɘː n d ɯ ŋ
이사	i sʰ a̠
학명	h a̠ ŋ m j ʌ̹ ŋ
그런데	k ɯ ɾ ʌ̹ n d e̞
퓔	pʰ ɥ i ɭ
네거리	n e̞ː ɡ ʌ̹ ɾ i
물굽이	m u ɭ ɡ u b i
흨	x ɯ k̚
있으시다	i s͈ ɯ ɕʰ i d a̠
결석	k j ʌ̹ ɭ s͈ ʌ̹ k̚
방가면	p a̠ ŋ ɡ a̠ m j ʌ̹ n
유로퓸	j u ɾ o̞ pʰ j u m
부풀다	p u pʰ u ɭ d a̠
걱정	k ʌ̹ k̚ t͡ɕ͈ ʌ̹ ŋ
수명	sʰ u m j ʌ̹ ŋ
툴륨	tʰ u ʎ ʎ j u m
소믈리에	sʰ o̞ m ɯ ʎ ʎ i e̞
자동계단	t͡ɕ a̠ d o̞ ŋ ɡ j e̞ d a̠ n
경기	k j ʌ̹ ŋ ɡ i
뉴스	ɲ j u sʰ ɯ
신	ɕʰ i n
직물	t͡ɕ i ŋ m u ɭ
성립되다	sʰ ʌ̹ ŋ n i p̚ t͈ w e̞ d a̠
할인	h a̠ ɾ i n
란	ɾ a̠ n
수소폭탄	sʰ u sʰ o̞ pʰ o̞ k̚ tʰ a̠ n
나우루	n a̠ u ɾ u
은혜	ɯ n ʝ j e̞
충고하다	t͡ɕʰ u ŋ ɡ o̞ ɦ a̠ d a̠
춘	t͡ɕʰ u n
칼라	kʰ a̠ ɭ ɭ a̠
화장	ɸ w a̠ d͡ʑ a̠ ŋ
츠	t͡ɕʰ ɯ
뽀르뚜갈	p͈ o̞ ɾ ɯ t͈ u ɡ a̠ ɭ
철폐	t͡ɕʰ ʌ̹ ɭ pʰ j e̞
공사	k o̞ ŋ sʰ a̠
황소	ɸ w a̠ ŋ sʰ o̞
슬로벤스꼬	sʰ ɯ ɭ ɭ o̞ b e̞ n sʰ ɯ k͈ o̞
천황	t͡ɕʰ ʌ̹ n β w a̠ ŋ
진단	t͡ɕ iː n d a̠ n
연뿌리	j ʌ̹ n p͈ u ɾ i
보복	p o̞ b o̞ k̚
귀주	k ɥ i d͡ʑ u
부리다	p u ɾ i d a̠
즐거움	t͡ɕ ɯ ɭ ɡ ʌ̹ u m
충분하다	t͡ɕʰ u ŋ b u n ɦ a̠ d a̠
괴롭다	k w e̞ ɾ o̞ p̚ t͈ a̠
문명	m u n m j ʌ̹ ŋ
화염병	ɸ w a̠ː j ʌ̹ m b j ʌ̹ ŋ
같이	k a̠ t͡ɕʰ i
풋볼	pʰ u t̚ p͈ o̞ ɭ
잔뜩	t͡ɕ a̠ n t͈ ɯ k̚
불고기	p u ɭ ɡ o̞ ɡ i
배심	p ɛː ɕʰ i m
비롯하다	p i ɾ o̞ tʰ a̠ d a̠
자칼	t͡ɕ a̠ kʰ a̠ ɭ
자격지심	t͡ɕ a̠ ɡ j ʌ̹ k̚ t͡ɕ͈ i ɕʰ i m
안방	a̠ n b a̠ ŋ
개인	k ɛː i n
양자역학	j a̠ ŋ d͡ʑ a̠ j ʌ̹ kʰ a̠ k̚
아악	a̠ː a̠ k̚
반사경	p a̠ n sʰ a̠ ɡ j ʌ̹ ŋ
제의하다	t͡ɕ e̞ ɰ i ɦ a̠ d a̠
알데히드	a̠ ɭ d e̞ ʝ i d ɯ
부럼	p uː ɾ ʌ̹ m
원피스	w ʌ̹ n pʰ i sʰ ɯ
크레파스	k x ɯ ɾ e̞ pʰ a̠ sʰ ɯ
당기다	t a̠ ŋ ɡ i d a̠
서두르다	sʰ ʌ̹ d u ɾ ɯ d a̠
구두	k u d u
쇼룸	ɕʰ o ɾ u m
실시하다	ɕʰ i ɭ ɕʰ i ɦ a̠ d a̠
제기차기	t͡ɕ e̞ ɡ i t͡ɕʰ a̠ ɡ i
않다	a̠ n tʰ a̠
흠뻑	x ɯ m p͈ ʌ̹ k̚
루	ɾ u
정치판	t͡ɕ ʌ̹ ŋ t͡ɕʰ i pʰ a̠ n
응용	ɯː ŋ j o ŋ
스미다	sʰ ɯ m i d a̠
트리니다드	tʰ ɯ ɾ i n i d a̠ d ɯ
흥미진진하다	x ɯː ŋ m i d͡ʑ i ɲ d͡ʑ i n ɦ a̠ d a̠
고사기	k o̞ sʰ a̠ ɡ i
미처	m i t͡ɕʰ ʌ̹
필업	pʰ i ɾ ʌ̹ p̚
지질	t͡ɕ i d͡ʑ i ɭ
표정	pʰ j o d͡ʑ ʌ̹ ŋ
옅다	j ʌ̹ t̚ t͈ a̠
마당	m a̠ d a̠ ŋ
고질병	k o̞ d͡ʑ i ɭ p͈ j ʌ̹ ŋ
지폐	t͡ɕ i pʰ j e̞
가창오리	k a̠ t͡ɕʰ a̠ ŋ o̞ ɾ i
귀고리	k ɥ i ɡ o̞ ɾ i
발표하다	p a̠ ɭ pʰ j o ɦ a̠ d a̠
배낭	p ɛː n a̠ ŋ
명령하다	m j ɘː ŋ ɲ j ʌ̹ ŋ ɦ a̠ d a̠
연못	j ʌ̹ n m o̞ t̚
따라가다	t͈ a̠ ɾ a̠ ɡ a̠ d a̠
간모	k a̠ n m o̞
징계	t͡ɕ i ŋ ɡ j e̞
수수미꾸리	sʰ u sʰ u m i k͈ u ɾ i
가없다	k a̠ː ʌ̹ p̚ t͈ a̠
우수리	u sʰ u ɾ i
물려받다	m u ʎ ʎ j ʌ̹ b a̠ t̚ t͈ a̠
쓸데	s͈ ɯ ɭ t͈ e̞
조언하다	t͡ɕ o̞ː ʌ̹ n ɦ a̠ d a̠
찰흙	t͡ɕʰ a̠ ɾ ɣ ɯ k̚
공원	k o̞ ŋ w ʌ̹ n
풀어지다	pʰ u ɾ ʌ̹ d͡ʑ i d a̠
흞	x ɯ p̚
홀아비	ɸʷ o̞ ɾ a̠ b i
이탈리아	i tʰ a̠ ʎ ʎ i a̠
가난	k a̠ n a̠ n
개성	k ɛː sʰ ʌ̹ ŋ
비평가	p i pʰ j ʌ̹ ŋ ɡ a̠
누리	n u ɾ i
고난	k o̞ n a̠ n
라틴	ɾ a̠ tʰ i n
싹	s͈ a̠ k̚
판문점	pʰ a̠ n m u ɲ d͡ʑ ʌ̹ m
참되다	t͡ɕʰ a̠ m t͈ w e̞ d a̠
동반자	t o̞ ŋ b a̠ ɲ d͡ʑ a̠
강도다리	k a̠ ŋ d o̞ d a̠ ɾ i
주의하다	t͡ɕ u ɰ i ɦ a̠ d a̠
목마름	m o̞ ŋ m a̠ ɾ ɯ m
가소롭다	k a̠ː sʰ o̞ ɾ o̞ p̚ t͈ a̠
접다	t͡ɕ ʌ̹ p̚ t͈ a̠
단골	t a̠ n ɡ o̞ ɭ
버들가지	p ʌ̹ d ɯ ɭ ɡ a̠ d͡ʑ i
보잘것없다	p o̞ d͡ʑ a̠ ɭ k͈ ʌ̹ sʰ ʌ̹ p̚ t͈ a̠
퇴진	tʰ w e̞ː d͡ʑ i n
단발	t a̠ n b a̠ ɭ
우유	u j u
누설하다	n uː sʰ ʌ̹ ɾ ɦ a̠ d a̠
마푸토	m a̠ pʰ u tʰ o̞
대사관	t ɛː sʰ a̠ ɡ w a̠ n
함묵증	h a̠ m m u k̚ t͡ɕ͈ ɯ ŋ
식물학	ɕʰ i ŋ m u ɾ ɦ a̠ k̚
건설	k ɘː n sʰ ʌ̹ ɭ
밈	m i m
나프티리딘	n a̠ pʰ ɯ tʰ i ɾ i d i n
메카	m e̞ kʰ a̠
중독	t͡ɕ u ŋ d o̞ k̚
불가지론	p u ɭ ɡ a̠ d͡ʑ i ɾ o̞ n
주류	t͡ɕ u ɾ j u
자연	t͡ɕ a̠ j ʌ̹ n
전세	t͡ɕ ɘː n sʰ e̞
마트료시카	m a̠ tʰ ɯ ɾ j o ɕʰ i kʰ a̠
흖	x ɯ n
열여섯	j ʌ̹ ʎ ʎ j ʌ̹ sʰ ʌ̹ t̚
아예	a̠ j e̞
유신론	j u ɕʰ i n n o̞ n
분석	p u n sʰ ʌ̹ k̚
우는토끼	uː n ɯ n tʰ o̞ k͈ i
릴롱궤	ɾ i ɭ ɭ o̞ ŋ ɡ w e̞
큰납지리	k x ɯ n n a̠ p̚ t͡ɕ͈ i ɾ i
아가미	a̠ ɡ a̠ m i
헤르메스	h e̞ ɾ ɯ m e̞ sʰ ɯ
다림질	t a̠ ɾ i m d͡ʑ i ɭ
참외	t͡ɕʰ a̠ m w e̞
개꿩	k ɛː k͈ w ʌ̹ ŋ
자뻑	t͡ɕ a̠ p͈ ʌ̹ k̚
체크어	t͡ɕʰ e̞ k x ɯ ʌ̹
아라	a̠ ɾ a̠
할아버님	h a̠ ɾ a̠ b ʌ̹ n i m
만일	m a̠ː n i ɭ
의도	ɰ iː d o̞
첩	t͡ɕʰ ʌ̹ p̚
김치전	k i m t͡ɕʰ i d͡ʑ ʌ̹ n
데이트하다	t e̞ i tʰ ɯ ɦ a̠ d a̠
석탄산	sʰ ʌ̹ k̚ tʰ a̠ n sʰ a̠ n
부처님	p u t͡ɕʰ ʌ̹ n i m
응집력	ɯː ŋ d͡ʑ i m ɲ j ʌ̹ k̚
견과	k j ʌ̹ n ɡ w a̠
제조	t͡ɕ e̞ d͡ʑ o̞
요구르트	j o ɡ u ɾ ɯ tʰ ɯ
목탄	m o̞ k̚ tʰ a̠ n
과팅	k w a̠ tʰ i ŋ
나서다	n a̠ sʰ ʌ̹ d a̠
죄송	t͡ɕ w e̞ː sʰ o̞ ŋ
기합	k i ɦ a̠ p̚
코알라	kʰ o̞ a̠ ɭ ɭ a̠
약력	j a̠ ŋ ɲ j ʌ̹ k̚
그렇다	k ɯ ɾ ʌ̹ tʰ a̠
고마워	k o̞ m a̠ w ʌ̹
방송국	p a̠ː ŋ sʰ o̞ ŋ ɡ u k̚
카우치	kʰ a̠ u t͡ɕʰ i
불륜하다	p u ʎ ʎ j u n ɦ a̠ d a̠
담그다	t a̠ m ɡ ɯ d a̠
탐라	tʰ a̠ m n a̠
아람어	a̠ ɾ a̠ m ʌ̹
제설차	t͡ɕ e̞ sʰ ʌ̹ ʎ t͡ɕʰ a̠
십자가	ɕʰ i p̚ t͡ɕ͈ a̠ ɡ a̠
풀네임	pʰ u ɭ ɭ e̞ i m
큰일	k x ɯ n n i ɭ
계시	k j e̞ː ɕʰ i
등광	t ɯ ŋ ɡ w a̠ ŋ
미성	m i sʰ ʌ̹ ŋ
접선	t͡ɕ ʌ̹ p s͈ ʌ̹ n
중공	t͡ɕ u ŋ ɡ o̞ ŋ
장수	t͡ɕ a̠ː ŋ sʰ u
풍부하다	pʰ u ŋ b u ɦ a̠ d a̠
수입	sʰ u i p̚
코튼	kʰ o̞ tʰ ɯ n
촉법소년	t͡ɕʰ o̞ k̚ p͈ ʌ̹ p s͈ o̞ ɲ j ʌ̹ n
청동	t͡ɕʰ ʌ̹ ŋ d o̞ ŋ
요르단	j o ɾ ɯ d a̠ n
카	kʰ a̠
기니	k iː n i
기침하다	k i t͡ɕʰ i m ɦ a̠ d a̠
장점	t͡ɕ a̠ ŋ t͡ɕ͈ ʌ̹ m
웰링턴	w e̞ ʎ ʎ i ŋ tʰ ʌ̹ n
자식	t͡ɕ a̠ ɕʰ i k̚
우체부	uː t͡ɕʰ e̞ b u
긍정적	k ɯː ŋ d͡ʑ ʌ̹ ŋ d͡ʑ ʌ̹ k̚
하룻밤	h a̠ ɾ u t̚ p͈ a̠ m
시들다	ɕʰ i d ɯ ɭ d a̠
시나브로	ɕʰ i n a̠ b ɯ ɾ o̞
원주율	w ʌ̹ ɲ d͡ʑ u j u ɭ
가방	k a̠ b a̠ ŋ
두견	t u ɡ j ʌ̹ n
곧다	k o̞ t̚ t͈ a̠
퓐	pʰ ɥ i n
하와	h a̠ w a̠
동아리	t o̞ ŋ a̠ ɾ i
레몬	ɾ e̞ m o̞ n
비소	p i sʰ o̞
폭풍우	pʰ o̞ k̚ pʰ u ŋ u
설립하다	sʰ ʌ̹ ʎ ʎ i pʰ a̠ d a̠
북두칠성	p u k̚ t͈ u t͡ɕʰ i ɭ sʰ ʌ̹ ŋ
거인	k ɘː i n
교의	k j oː ɰ i
실	ɕʰ iː ɭ
한강	h a̠ː n ɡ a̠ ŋ
공알	k o̞ː ŋ a̠ ɭ
똥싸다	t͈ o̞ ŋ s͈ a̠ d a̠
나선형	n a̠ sʰ ʌ̹ n ʝ j ʌ̹ ŋ
템플렛	tʰ e̞ m pʰ ɯ ɭ ɭ e̞ t̚
조랑말	t͡ɕ o̞ ɾ a̠ ŋ m a̠ ɭ
탁아소	tʰ a̠ ɡ a̠ sʰ o̞
드시다	t ɯ ɕʰ i d a̠
알리고	a̠ ʎ ʎ i ɡ o̞
나아지다	n a̠ a̠ d͡ʑ i d a̠
상인	sʰ a̠ ŋ i n
회의	ɸ w e̞ː ɰ i
연기	j ʌ̹ n ɡ i
집중되다	t͡ɕ i p̚ t͡ɕ͈ u ŋ d w e̞ d a̠
베짱이	p e̞ t͡ɕ͈ a̠ ŋ i
간편하다	k a̠ n pʰ j ʌ̹ n ɦ a̠ d a̠
디카	t i kʰ a̠
지리산	t͡ɕ i ɾ i sʰ a̠ n
로망스	ɾ o̞ m a̠ ŋ sʰ ɯ
발효	p a̠ ɾ ʝ j o
퀴즈	kʰ ɥ i d͡ʑ ɯ
국화	k u kʰ w a̠
온	o̞ː n
세계적	sʰ e̞ː ɡ j e̞ d͡ʑ ʌ̹ k̚
보호하다	p o̞ː β o̞ ɦ a̠ d a̠
장인	t͡ɕ a̠ː ŋ i n
엄지손가락	ʌ̹ m d͡ʑ i sʰ o̞ n ɡ a̠ ɾ a̠ k̚
출근하다	t͡ɕʰ u ɭ ɡ ɯ n ɦ a̠ d a̠
설거지	sʰ ʌ̹ ɭ ɡ ʌ̹ d͡ʑ i
위	ɥ i
창조적	t͡ɕʰ a̠ː ŋ d͡ʑ o̞ d͡ʑ ʌ̹ k̚
십자고상	ɕʰ i p̚ t͡ɕ͈ a̠ ɡ o̞ sʰ a̠ ŋ
뛰르끼예	t͈ ɥ i ɾ ɯ k͈ i j e̞
조심	t͡ɕ o̞ː ɕʰ i m
텔레타이프	tʰ e̞ ɭ ɭ e̞ tʰ a̠ i pʰ ɯ
갂	k a̠ k̚
확인되다	ɸ w a̠ ɡ i n d w e̞ d a̠
메시아	m e̞ ɕʰ i a̠
저급	t͡ɕ ɘː ɡ ɯ p̚
이거	i ɡ ʌ̹
백수	p ɛː k s͈ u
인정하다	i ɲ d͡ʑ ʌ̹ ŋ ɦ a̠ d a̠
코카인	kʰ o̞ kʰ a̠ i n
용	j o ŋ
질량	t͡ɕ i ʎ ʎ j a̠ ŋ
낮잠	n a̠ t̚ t͡ɕ͈ a̠ m
계획	k j e̞ː β w e̞ k̚
들다	t ɯ ɭ d a̠
진정하다	t͡ɕ i ɲ d͡ʑ ʌ̹ ŋ ɦ a̠ d a̠
괄호	k w a̠ ɾ β o̞
암자	a̠ m d͡ʑ a̠
묵다	m u k̚ t͈ a̠
가강수량	k a̠ ɡ a̠ ŋ sʰ u ɾ j a̠ ŋ
영하	j ʌ̹ ŋ ɦ a̠
푸껫	pʰ u k͈ e̞ t̚
크롬	k x ɯ ɾ o̞ m
욕조	j o k̚ t͡ɕ͈ o̞
낟	n a̠ t̚
매장	m ɛː d͡ʑ a̠ ŋ
귀절	k ɥ i d͡ʑ ʌ̹ ɭ
떨어지다	t͈ ʌ̹ ɾ ʌ̹ d͡ʑ i d a̠
코냑	kʰ o̞ ɲ j a̠ k̚
옮아가다	o̞ ɭ m a̠ ɡ a̠ d a̠
중국집	t͡ɕ u ŋ ɡ u k̚ t͡ɕ͈ i p̚
부정사	p u d͡ʑ ʌ̹ ŋ sʰ a̠
믹서	m i k s͈ ʌ̹
지원자	t͡ɕ i w ʌ̹ ɲ d͡ʑ a̠
얼	ʌ̹ ɭ
스톤헨지	sʰ ɯ tʰ o̞ n ɦ e̞ ɲ d͡ʑ i
세탁하다	sʰ e̞ː tʰ a̠ kʰ a̠ d a̠
근데	k ɯ n d e̞
코치	kʰ o̞ t͡ɕʰ i
살살하다	sʰ a̠ː ɭ sʰ a̠ ɾ ɦ a̠ d a̠
중적분	t͡ɕ u ŋ d͡ʑ ʌ̹ k̚ p͈ u n
문장	m u ɲ d͡ʑ a̠ ŋ
굶주림	k uː m d͡ʑ u ɾ i m
빙점	p i ŋ d͡ʑ ʌ̹ m
인물	i n m u ɭ
사증	sʰ a̠ t͡ɕ͈ ɯ ŋ
앉다	a̠ n t͈ a̠
꽉	k͈ w a̠ k̚
ㅕ	j ʌ̹
외접원	w e̞ː d͡ʑ ʌ̹ b w ʌ̹ n
제주모치망둑	t͡ɕ e̞ː d͡ʑ u m o̞ t͡ɕʰ i m a̠ ŋ d u k̚
버마어	p ʌ̹ m a̠ ʌ̹
방언	p a̠ ŋ ʌ̹ n
복	p o̞ k̚
기원	k i w ʌ̹ n
투명	tʰ u m j ʌ̹ ŋ
확장	ɸ w a̠ k̚ t͡ɕ͈ a̠ ŋ
유아원	j u a̠ w ʌ̹ n
골수	k o̞ ɭ s͈ u
무궁화	m u ɡ u ŋ β w a̠
서반아	sʰ ʌ̹ b a̠ n a̠
휠체어	h ɥ i ʎ t͡ɕʰ e̞ ʌ̹
노숙하다	n o̞ː sʰ u kʰ a̠ d a̠
감자튀김	k a̠ m d͡ʑ a̠ tʰ ɥ i ɡ i m
몹	m o̞ p̚
매출	m ɛː t͡ɕʰ u ɭ
김밥	k iː m p͈ a̠ p̚
사항	sʰ a̠ː ɦ a̠ ŋ
발간	p a̠ ɭ ɡ a̠ n
독일어	t o̞ ɡ i ɾ ʌ̹
통역자	tʰ o̞ ŋ j ʌ̹ k̚ t͡ɕ͈ a̠
글쎄	k ɯ ɭ s͈ e̞
상상하다	sʰ a̠ː ŋ sʰ a̠ ŋ ɦ a̠ d a̠
스푼	sʰ ɯ pʰ u n
콜레스테롤	kʰ o̞ ɭ ɭ e̞ sʰ ɯ tʰ e̞ ɾ o̞ ɭ
테니스장	tʰ e̞ n i sʰ ɯ d͡ʑ a̠ ŋ
시숙	ɕʰ i sʰ u k̚
사월	sʰ a̠ː w ʌ̹ ɭ
뇌	n w e̞
뒤집다	t ɥ i d͡ʑ i p̚ t͈ a̠
검정	k ʌ̹ m d͡ʑ ʌ̹ ŋ
찌릿하다	t͡ɕ͈ i ɾ i tʰ a̠ d a̠
유도기	j u d o̞ ɡ i
엽	j ʌ̹ p̚
고독하다	k o̞ d o̞ kʰ a̠ d a̠
락	ɾ a̠ k̚
퇴근	tʰ w e̞ː ɡ ɯ n
미인	m iː i n
크메르어	k x ɯ m e̞ ɾ ɯ ʌ̹
말똥구리	m a̠ ɭ t͈ o̞ ŋ ɡ u ɾ i
쓰이다	s͈ ɯ i d a̠
동남	t o̞ ŋ n a̠ m
익살스럽다	i k s͈ a̠ ɭ sʰ ɯ ɾ ʌ̹ p̚ t͈ a̠
고환	k o̞ β w a̠ n
학공치	h a̠ k̚ k͈ o̞ ŋ t͡ɕʰ i
브뤼셀	p ɯ ɾ ɥ i sʰ e̞ ɭ
이모부	i m o̞ b u
빤쯔	p͈ a̠ ɲ t͡ɕ͈ ɯ
웹사이트	w e̞ p s͈ a̠ i tʰ ɯ
전화하다	t͡ɕ ʌ̹ n β w a̠ ɦ a̠ d a̠
보양탕	p o̞ j a̠ ŋ tʰ a̠ ŋ
주인공	t͡ɕ u i n ɡ o̞ ŋ
무겁다	m u ɡ ʌ̹ p̚ t͈ a̠
구결자	k u ɡ j ʌ̹ ʎ d͡ʑ a̠
멜버른	m e̞ ɭ b ʌ̹ ɾ ɯ n
공식	k o̞ ŋ ɕʰ i k̚
참사	t͡ɕʰ a̠ m sʰ a̠
신기하다	ɕʰ iː n ɡ i ɦ a̠ d a̠
홀리다	ɸʷ o̞ ʎ ʎ i d a̠
어도	ʌ̹ d o̞
강원도	k a̠ ŋ w ʌ̹ n d o̞
찌그러지다	t͡ɕ͈ i ɡ ɯ ɾ ʌ̹ d͡ʑ i d a̠
지구의	t͡ɕ i ɡ u ɰ i
아스콜빅산	a̠ sʰ ɯ kʰ o̞ ɭ b i k s͈ a̠ n
집권당	t͡ɕ i p̚ k͈ w ʌ̹ n d a̠ ŋ
명운	m j ɘː ŋ u n
아테나	a̠ tʰ e̞ n a̠
시꺼멓다	ɕʰ i k͈ ʌ̹ m ʌ̹ tʰ a̠
찾아보다	t͡ɕʰ a̠ d͡ʑ a̠ b o̞ d a̠
아이스케이크	a̠ i sʰ ɯ kʰ e̞ i k x ɯ
짬뽕	t͡ɕ͈ a̠ m p͈ o̞ ŋ
브금	p ɯ ɡ ɯ m
있다	i t̚ t͈ a̠
연령	j ʌ̹ ʎ ʎ j ʌ̹ ŋ
적당	t͡ɕ ʌ̹ k̚ t͈ a̠ ŋ
술독	sʰ u ɭ d o̞ k̚
반복	p a̠ː n b o̞ k̚
씹두덩	ɕ͈ i p̚ t͈ u d ʌ̹ ŋ
페르샤어	pʰ e̞ ɾ ɯ ɕʰ a̠ ʌ̹
언어학	ʌ̹ n ʌ̹ ɦ a̠ k̚
방법론	p a̠ ŋ b ʌ̹ m n o̞ n
반침	p a̠ ɲ t͡ɕʰ i m
콤퓨터	kʰ o̞ m pʰ j u tʰ ʌ̹
입원	i b w ʌ̹ n
터럭	tʰ ʌ̹ ɾ ʌ̹ k̚
조지아어	t͡ɕ o̞ d͡ʑ i a̠ ʌ̹
신교도	ɕʰ i n ɡ j o d o̞
괴롭히다	k w e̞ ɾ o̞ pʰ i d a̠
무쿠리	m u kʰ u ɾ i
화석	ɸ w a̠ː sʰ ʌ̹ k̚
사실	sʰ a̠ː ɕʰ i ɭ
자	t͡ɕ a̠
쩡	t͡ɕ͈ ʌ̹ ŋ
결정화	k j ʌ̹ ʎ t͡ɕ͈ ʌ̹ ŋ β w a̠
달다	t a̠ ɭ d a̠
연습	j ɘː n sʰ ɯ p̚
토픽	tʰ o̞ pʰ i k̚
부들	p u d ɯ ɭ
제시	t͡ɕ e̞ ɕʰ i
담요	t a̠ː m ɲ j o
지붕	t͡ɕ i b u ŋ
중사	t͡ɕ u ŋ sʰ a̠
일부	i ɭ b u
근무	k ɯː n m u
고기후학	k o̞ ɡ i β u ɦ a̠ k̚
바닷물고기	p a̠ d a̠ n m u ɭ ɡ o̞ ɡ i
고사리	k o̞ sʰ a̠ ɾ i
산둥	sʰ a̠ n d u ŋ
별세하다	p j ʌ̹ ɭ s͈ e̞ ɦ a̠ d a̠
그을다	k ɯ ɯ ɭ d a̠
계집	k j e̞ː d͡ʑ i p̚
빵집	p͈ a̠ ŋ t͡ɕ͈ i p̚
아나콘다	a̠ n a̠ kʰ o̞ n d a̠
두껍다	t u k͈ ʌ̹ p̚ t͈ a̠
찬란하다	t͡ɕʰ a̠ ɭ ɭ a̠ n ɦ a̠ d a̠
저거	t͡ɕ ʌ̹ ɡ ʌ̹
봉밀	p o̞ ŋ m i ɭ
의미	ɰ iː m i
하플로그룹	h a̠ pʰ ɯ ɭ ɭ o̞ ɡ ɯ ɾ u p̚
스트론튬	sʰ ɯ tʰ ɯ ɾ o̞ n tʰ j u m
오스뮴	o̞ sʰ ɯ m j u m
화단	ɸ w a̠ d a̠ n
따깐	t͈ a̠ k͈ a̠ n
괴수	k w e̞ː sʰ u
노엽다	n o̞ː j ʌ̹ p̚ t͈ a̠
들어서다	t ɯ ɾ ʌ̹ sʰ ʌ̹ d a̠
멕시코시티	m e̞ k ɕ͈ i kʰ o̞ ɕʰ i tʰ i
윷	j uː t̚
폐렴	pʰ j e̞ː ɾ j ʌ̹ m
갈림길	k a̠ ʎ ʎ i m k͈ i ɭ
데이터	t e̞ i tʰ ʌ̹
학기	h a̠ k̚ k͈ i
크림	k x ɯ ɾ iː m
하나님	h a̠ n a̠ n i m
흑체	x ɯ k̚ t͡ɕʰ e̞
모처럼	m o̞ t͡ɕʰ ʌ̹ ɾ ʌ̹ m
낳다	n a̠ tʰ a̠
가발	k a̠ b a̠ ɭ
벽화	p j ʌ̹ kʰ w a̠
함	h a̠ m
슈니첼	ɕʰ u n i t͡ɕʰ e̞ ɭ
십날	ɕʰ i m n a̠ ɭ
지출	t͡ɕ i t͡ɕʰ u ɭ
환영하다	ɸ w a̠ ɲ j ʌ̹ ŋ ɦ a̠ d a̠
말라위	m a̠ ɭ ɭ a̠ ɥ i
과연	k w a̠ː j ʌ̹ n
가로막	k a̠ ɾ o̞ m a̠ k̚
추석	t͡ɕʰ u sʰ ʌ̹ k̚
민족주의	m i ɲ d͡ʑ o̞ k̚ t͡ɕ͈ u ɰ i
도파민	t o̞ pʰ a̠ m i n
신데렐라	ɕʰ i n d e̞ ɾ e̞ ɭ ɭ a̠
증명	t͡ɕ ɯ ŋ m j ʌ̹ ŋ
복습하다	p o̞ k s͈ ɯ pʰ a̠ d a̠
사기	sʰ a̠ ɡ i
꺾다	k͈ ʌ̹ k̚ t͈ a̠
진균	t͡ɕ i n ɡ j u n
추가	t͡ɕʰ u ɡ a̠
착석	t͡ɕʰ a̠ k s͈ ʌ̹ k̚
대량	t ɛː ɾ j a̠ ŋ
능	n ɯ ŋ
자아	t͡ɕ a̠ a̠
망치	m a̠ ŋ t͡ɕʰ i
중력자	t͡ɕ uː ŋ ɲ j ʌ̹ k̚ t͡ɕ͈ a̠
단계	t a̠ n ɡ j e̞
친	t͡ɕʰ i n
긴발톱첨서	k i n b a̠ ɭ tʰ o̞ p̚ t͡ɕʰ ʌ̹ m sʰ ʌ̹
묵	m u k̚
존나	t͡ɕ o̞ n n a̠
플	pʰ ɯ ɭ
검도	k ɘː m d o̞
천	t͡ɕʰ ʌ̹ n
고루	k o̞ ɾ u
인삼차	i n sʰ a̠ m t͡ɕʰ a̠
미수	m i sʰ u
슬	sʰ ɯ ɭ
신고	ɕʰ i n ɡ o̞
노랑	n o̞ ɾ a̠ ŋ
방추	p a̠ ŋ t͡ɕʰ u
경우	k j ʌ̹ ŋ u
빻다	p͈ a̠ː tʰ a̠
역사적	j ʌ̹ k s͈ a̠ d͡ʑ ʌ̹ k̚
방송사	p a̠ː ŋ sʰ o̞ ŋ sʰ a̠
사과하다	sʰ a̠ː ɡ w a̠ ɦ a̠ d a̠
구라파	k u ɾ a̠ pʰ a̠
세멘트	sʰ e̞ m e̞ n tʰ ɯ
칠면조	t͡ɕʰ i ɭ m j ʌ̹ ɲ d͡ʑ o̞
쁠류스	p͈ ɯ ʎ ʎ j u sʰ ɯ
락사	ɾ a̠ k s͈ a̠
북서	p u k s͈ ʌ̹
당하다	t a̠ ŋ ɦ a̠ d a̠
운석	uː n sʰ ʌ̹ k̚
오바마	o̞ b a̠ m a̠
그리스도교	k ɯ ɾ i sʰ ɯ d o̞ ɡ j o
차지하다	t͡ɕʰ a̠ d͡ʑ i ɦ a̠ d a̠
고전적	k o̞ː d͡ʑ ʌ̹ ɲ d͡ʑ ʌ̹ k̚
복소수	p o̞ k s͈ o̞ s͈ u
덕트	t ʌ̹ k̚ tʰ ɯ
련	ɾ j ʌ̹ n
녀석	ɲ j ʌ̹ sʰ ʌ̹ k̚
호흡	ɸʷ o̞ ɣ ɯ p̚
프러포즈	pʰ ɯ ɾ ʌ̹ pʰ o̞ d͡ʑ ɯ
선교사	sʰ ʌ̹ n ɡ j o sʰ a̠
로그아웃	ɾ o̞ ɡ ɯ a̠ u t̚
다양	t a̠ j a̠ ŋ
압	a̠ p̚
국한	k u kʰ a̠ n
서브컬처	sʰ ʌ̹ b ɯ kʰ ʌ̹ ʎ t͡ɕʰ ʌ̹
설탕	sʰ ʌ̹ ɭ tʰ a̠ ŋ
써리다	s͈ ɘː ɾ i d a̠
누구세요	n u ɡ u sʰ e̞ j o
애국주의	ɛː ɡ u k̚ t͡ɕ͈ u ɰ i
보닛	p o̞ n i t̚
들	t ɯː ɭ
무관심하다	m u ɡ w a̠ n ɕʰ i m ɦ a̠ d a̠
장로교회	t͡ɕ a̠ː ŋ n o̞ ɡ j o β w e̞
네이멍구	n e̞ i m ʌ̹ ŋ ɡ u
차리다	t͡ɕʰ a̠ ɾ i d a̠
관료제	k w a̠ ʎ ʎ j o d͡ʑ e̞
떳떳하다	t͈ ʌ̹ t̚ t͈ ʌ̹ tʰ a̠ d a̠
필승	pʰ iː ɭ sʰ ɯ ŋ
마치	m a̠ t͡ɕʰ i
폴란드인	pʰ o̞ ɭ ɭ a̠ n d ɯ i n
라디에이터	ɾ a̠ d i e̞ i tʰ ʌ̹
사이다	sʰ a̠ i d a̠
남성고음	n a̠ m sʰ ʌ̹ ŋ ɡ o̞ ɯ m
마시다	m a̠ ɕʰ i d a̠
정류장	t͡ɕ ʌ̹ ŋ ɲ j u d͡ʑ a̠ ŋ
신임하다	ɕʰ iː n i m ɦ a̠ d a̠
업다	ʌ̹ p̚ t͈ a̠
십일	ɕʰ i b i ɭ
자막	t͡ɕ a̠ m a̠ k̚
악인	a̠ ɡ i n
초신성	t͡ɕʰ o̞ː ɕʰ i n sʰ ʌ̹ ŋ
비끼다	p i k͈ i d a̠
티슈	tʰ i ɕʰ u
불가피	p u ɭ ɡ a̠ pʰ i
바르샤바	p a̠ ɾ ɯ ɕʰ a̠ b a̠
세탁소	sʰ e̞ː tʰ a̠ k s͈ o̞
읍	ɯ p̚
광구	k w a̠ ŋ ɡ u
넘어지다	n ʌ̹ m ʌ̹ d͡ʑ i d a̠
불황	p u ɾ β w a̠ ŋ
붓펜	p u t̚ pʰ e̞ n
이테르븀	i tʰ e̞ ɾ ɯ b j u m
그야말로	k ɯ j a̠ m a̠ ɭ ɭ o̞
결석하다	k j ʌ̹ ɭ s͈ ʌ̹ kʰ a̠ d a̠
똥차	t͈ o̞ ŋ t͡ɕʰ a̠
의심되다	ɰ i ɕʰ i m d w e̞ d a̠
일꾼	i ɭ k͈ u n
미끈망둑	m i k͈ ɯ n m a̠ ŋ d u k̚
짜릿하다	t͡ɕ͈ a̠ ɾ i tʰ a̠ d a̠
애교	ɛː ɡ j o
카세트	kʰ a̠ sʰ e̞ tʰ ɯ
말하기	m a̠ː ɾ ɦ a̠ ɡ i
인력거	i ʎ ʎ j ʌ̹ k̚ k͈ ʌ̹
내접원	n ɛː d͡ʑ ʌ̹ b w ʌ̹ n
피우다	pʰ i u d a̠
혼합	ɸʷ o̞ n ɦ a̠ p̚
정교회	t͡ɕ ɘː ŋ ɡ j o β w e̞
장작	t͡ɕ a̠ ŋ d͡ʑ a̠ k̚
페지	pʰ e̞ː d͡ʑ i
건드리다	k ɘː n d ɯ ɾ i d a̠
몽골어	m o̞ ŋ ɡ o̞ ɾ ʌ̹
나성	n a̠ sʰ ʌ̹ ŋ
수급	sʰ u ɡ ɯ p̚
왕가	w a̠ ŋ ɡ a̠
성체성사	sʰ ɘː ŋ t͡ɕʰ e̞ sʰ ʌ̹ ŋ sʰ a̠
어치	ʌ̹ t͡ɕʰ i
착용하다	t͡ɕʰ a̠ ɡ j o ŋ ɦ a̠ d a̠
서류	sʰ ʌ̹ ɾ j u
동양	t o̞ ŋ j a̠ ŋ
내강	n ɛː ɡ a̠ ŋ
슬기롭다	sʰ ɯ ɭ ɡ i ɾ o̞ p̚ t͈ a̠
음성	ɯ m sʰ ʌ̹ ŋ
순서	sʰ uː n sʰ ʌ̹
분사	p u n sʰ a̠
그녀	k ɯ ɲ j ʌ̹
얼핏	ʌ̹ ɭ pʰ i t̚
덮다	t ʌ̹ p̚ t͈ a̠
반응	p a̠ː n ɯ ŋ
벨라루스어	p e̞ ɭ ɭ a̠ ɾ u sʰ ɯ ʌ̹
그렇지만	k ɯ ɾ ʌ̹ t͡ɕʰ i m a̠ n
타나토스	tʰ a̠ n a̠ tʰ o̞ sʰ ɯ
전장	t͡ɕ ɘː ɲ d͡ʑ a̠ ŋ
자율	t͡ɕ a̠ j u ɭ
콜레라	kʰ o̞ ɭ ɭ e̞ ɾ a̠
용이	j o ŋ i
반물질	p a̠ː n m u ʎ t͡ɕ͈ i ɭ
법인	p ʌ̹ b i n
압록강	a̠ m n o̞ k̚ k͈ a̠ ŋ
작업복	t͡ɕ a̠ ɡ ʌ̹ p̚ p͈ o̞ k̚
남쪽	n a̠ m t͡ɕ͈ o̞ k̚
바듯하다	p a̠ d ɯ tʰ a̠ d a̠
지적	t͡ɕ i t͡ɕ͈ ʌ̹ k̚
제주	t͡ɕ e̞ː d͡ʑ u
익숙하다	i k s͈ u kʰ a̠ d a̠
올라가다	o̞ ɭ ɭ a̠ ɡ a̠ d a̠
엷다	j ɘː ɭ t͈ a̠
만하다	m a̠ n ɦ a̠ d a̠
솥	sʰ o̞ t̚
지나다	t͡ɕ i n a̠ d a̠
도구	t o̞ː ɡ u
잇다	iː t̚ t͈ a̠
헌법	h ɘː n p͈ ʌ̹ p̚
중	t͡ɕ u ŋ
용기	j oː ŋ ɡ i
굴	k u ɭ
튀각	tʰ ɥ i ɡ a̠ k̚
말라빠지다	m a̠ ɭ ɭ a̠ p͈ a̠ d͡ʑ i d a̠
황혼	ɸ w a̠ ŋ β o̞ n
우크라이나	u k x ɯ ɾ a̠ i n a̠
일상	i ɭ sʰ a̠ ŋ
식료	ɕʰ i ŋ ɲ j o
질	t͡ɕ i ɭ
말거머리	m a̠ ɭ ɡ ʌ̹ m ʌ̹ ɾ i
오늘날	o̞ n ɯ ɭ ɭ a̠ ɭ
대변	t ɛː b j ʌ̹ n
당당하다	t a̠ ŋ d a̠ ŋ ɦ a̠ d a̠
민감	m i n ɡ a̠ m
무어	m u ʌ̹
팔라듐	pʰ a̠ ɭ ɭ a̠ d j u m
유륜	j u ɾ j u n
예	j e̞
강도	k a̠ː ŋ d o̞
악동	a̠ k̚ t͈ o̞ ŋ
잘못되다	t͡ɕ a̠ ɭ m o̞ t̚ t͈ w e̞ d a̠
승화	sʰ ɯ ŋ β w a̠
프탈라진	pʰ ɯ tʰ a̠ ɭ ɭ a̠ d͡ʑ i n
오만	o̞ m a̠ n
이끼	i k͈ i
젓가락질	t͡ɕ ʌ̹ t̚ k͈ a̠ ɾ a̠ k̚ t͡ɕ͈ i ɭ
무시하다	m u ɕʰ i ɦ a̠ d a̠
돌잔치	t o̞ ʎ d͡ʑ a̠ ɲ t͡ɕʰ i
사찰	sʰ a̠ t͡ɕʰ a̠ ɭ
치리	t͡ɕʰ i ɾ i
벼	p j ʌ̹
집게	t͡ɕ i p̚ k͈ e̞
이딸리아	i t͈ a̠ ʎ ʎ i a̠
짜장면	t͡ɕ͈ a̠ d͡ʑ a̠ ŋ m j ʌ̹ n
확률	ɸ w a̠ ŋ ɲ j u ɭ
구무	k u m u
텔레비죤	tʰ e̞ ɭ ɭ e̞ b i d͡ʑ o n
동무	t o̞ ŋ m u
팔꿈치	pʰ a̠ ɭ k͈ u m t͡ɕʰ i
완두	w a̠ n d u
닐	n i ɭ
개념	k ɛː ɲ j ʌ̹ m
불포화	p u ɭ pʰ o̞ β w a̠
금고	k ɯ m ɡ o̞
전문화	t͡ɕ ʌ̹ n m u n β w a̠
동	t o̞ ŋ
꾀꼬리	k͈ w e̞ k͈ o̞ ɾ i
군국주의	k u n ɡ u k̚ t͡ɕ͈ u ɰ i
서문	sʰ ɘː m u n
보편적	p o̞ː pʰ j ʌ̹ ɲ d͡ʑ ʌ̹ k̚
집들이	t͡ɕ i p̚ t͈ ɯ ɾ i
체	t͡ɕʰ e̞
혹시나	ɸʷ o̞ k ɕ͈ i n a̠
업신여기다	ɘː p ɕ͈ i n ɲ j ʌ̹ ɡ i d a̠
여정	j ʌ̹ d͡ʑ ʌ̹ ŋ
잔점박이물범	t͡ɕ a̠ ɲ d͡ʑ ʌ̹ m b a̠ ɡ i m u ɭ b ʌ̹ m
교실	k j oː ɕʰ i ɭ
궤도	k w e̞ː d o̞
괴	k w e̞
구락부	k u ɾ a̠ k̚ p͈ u
호모포비아	ɸʷ o̞ m o̞ pʰ o̞ b i a̠
그늘	k ɯ n ɯ ɭ
여기저기	j ʌ̹ ɡ i d͡ʑ ʌ̹ ɡ i
저녁밥	t͡ɕ ʌ̹ ɲ j ʌ̹ k̚ p͈ a̠ p̚
가렵다	k a̠ ɾ j ʌ̹ p̚ t͈ a̠
텐트	tʰ e̞ n tʰ ɯ
착각	t͡ɕʰ a̠ k̚ k͈ a̠ k̚
예레반	j e̞ ɾ e̞ b a̠ n
여야	j ɘː j a̠
려	ɾ j ʌ̹
똑똑	t͈ o̞ k̚ t͈ o̞ k̚
대폭적	t ɛː pʰ o̞ k̚ t͡ɕ͈ ʌ̹ k̚
달려가다	t a̠ ʎ ʎ j ʌ̹ ɡ a̠ d a̠
유독하다	j uː d o̞ kʰ a̠ d a̠
증후군	t͡ɕ ɯ ŋ β u ɡ u n
구입하다	k u i pʰ a̠ d a̠
시	ɕʰ i
난소	n a̠ n sʰ o̞
장난감	t͡ɕ a̠ ŋ n a̠ n k͈ a̠ m
고슴도치	k o̞ sʰ ɯ m d o̞ t͡ɕʰ i
망막	m a̠ ŋ m a̠ k̚
풍부	pʰ u ŋ b u
구축	k u t͡ɕʰ u k̚
학살	h a̠ k s͈ a̠ ɭ
잃다	i ɭ tʰ a̠
우리집	u ɾ i d͡ʑ i p̚
서장	sʰ ʌ̹ d͡ʑ a̠ ŋ
폭발물	pʰ o̞ k̚ p͈ a̠ ɭ m u ɭ
칠판	t͡ɕʰ i ɭ pʰ a̠ n
방위각	p a̠ ŋ ɥ i ɡ a̠ k̚
링크	ɾ i ŋ k x ɯ
세인트루시아	sʰ e̞ i n tʰ ɯ ɾ u ɕʰ i a̠
강세	k a̠ ŋ sʰ e̞
헌	h ʌ̹ n
청년	t͡ɕʰ ʌ̹ ŋ ɲ j ʌ̹ n
해주	h ɛː d͡ʑ u
양	j a̠ ŋ
물놀이장	m u ɭ ɭ o̞ ɾ i d͡ʑ a̠ ŋ
선박	sʰ ʌ̹ n b a̠ k̚
리포트	ɾ i pʰ o̞ tʰ ɯ
온몸	o̞ː n m o̞ m
뭄바이	m u m b a̠ i
육십	j u k ɕ͈ i p̚
오만	o̞ː m a̠ n
운전기사	uː ɲ d͡ʑ ʌ̹ n ɡ i sʰ a̠
리가	ɾ i ɡ a̠
찹쌀	t͡ɕʰ a̠ p s͈ a̠ ɭ
쓸데없다	s͈ ɯ ɭ t͈ e̞ ʌ̹ p̚ t͈ a̠
말리다	m a̠ ʎ ʎ i d a̠
투르	tʰ u ɾ ɯ
브라자빌	p ɯ ɾ a̠ d͡ʑ a̠ b i ɭ
진랍	t͡ɕ i ɭ ɭ a̠ p̚
겨레	k j ʌ̹ ɾ e̞
다하다	t a̠ː ɦ a̠ d a̠
카메라	kʰ a̠ m e̞ ɾ a̠
십육	ɕʰ i m ɲ j u k̚
저분	t͡ɕ ʌ̹ b u n
고뿌	k o̞ p͈ u
선물	sʰ ɘː n m u ɭ
떨어뜨리다	t͈ ʌ̹ ɾ ʌ̹ t͈ ɯ ɾ i d a̠
파트너	pʰ a̠ tʰ ɯ n ʌ̹
조미료	t͡ɕ o̞ m i ɾ j o
접골	t͡ɕ ʌ̹ p̚ k͈ o̞ ɭ
버리다	p ʌ̹ ɾ i d a̠
한국인	h a̠ n ɡ u ɡ i n
높다	n o̞ p̚ t͈ a̠
박물관	p a̠ ŋ m u ɭ ɡ w a̠ n
찻집	t͡ɕʰ a̠ t̚ t͡ɕ͈ i p̚
바텐더	p a̠ tʰ e̞ n d ʌ̹
정	t͡ɕ ʌ̹ ŋ
준비하다	t͡ɕ uː n b i ɦ a̠ d a̠
물속	m u ɭ s͈ o̞ k̚
놀이감	n o̞ ɾ i ɡ a̠ m
약국	j a̠ k̚ k͈ u k̚
문제	m uː ɲ d͡ʑ e̞
면세	m j ɘː n sʰ e̞
가락지빵	k a̠ ɾ a̠ k̚ t͡ɕ͈ i p͈ a̠ ŋ
꼬치구이	k͈ o̞ t͡ɕʰ i ɡ u i
무사하다	m u sʰ a̠ ɦ a̠ d a̠
망연	m a̠ ŋ j ʌ̹ n
뼜	p͈ j ʌ̹ t̚
조현병	t͡ɕ o̞ ʝ j ʌ̹ n b j ʌ̹ ŋ
페레스트로이카	pʰ e̞ ɾ e̞ sʰ ɯ tʰ ɯ ɾ o̞ i kʰ a̠
명명법	m j ɘː ŋ m j ʌ̹ ŋ b ʌ̹ p̚
다수	t a̠ sʰ u
독도	t o̞ k̚ t͈ o̞
합법화되다	h a̠ p̚ p͈ ʌ̹ pʰ w a̠ d w e̞ d a̠
초기	t͡ɕʰ o̞ ɡ i
서양인	sʰ ʌ̹ j a̠ ŋ i n
포옹	pʰ o̞ː o̞ ŋ
어란	ʌ̹ ɾ a̠ n
채용하다	t͡ɕʰ ɛː j o ŋ ɦ a̠ d a̠
부수	p uː sʰ u
푹	pʰ u k̚
변	p j ʌ̹ n
맡다	m a̠ t̚ t͈ a̠
엔진	e̞ ɲ d͡ʑ i n
이맘	i m a̠ m
일	iː ɭ
사인	s͈ a̠ i n
정원	t͡ɕ ʌ̹ ŋ w ʌ̹ n
띠	t͈ i
과일단물	k w a̠ i ɭ d a̠ n m u ɭ
오랑우탄	o̞ ɾ a̠ ŋ u tʰ a̠ n
두벌식	t u b ʌ̹ ɭ ɕʰ i k̚
어간	ɘː ɡ a̠ n
아직	a̠ d͡ʑ i k̚
전람회	t͡ɕ ɘː ɭ ɭ a̠ m β w e̞
불어	p u ɾ ʌ̹
화창하다	ɸ w a̠ t͡ɕʰ a̠ ŋ ɦ a̠ d a̠
코끼리	kʰ o̞ k͈ i ɾ i
뒷간	t ɥ iː t̚ k͈ a̠ n
방수	p a̠ː ŋ sʰ u
궁수	k u ŋ sʰ u
정부	t͡ɕ ʌ̹ ŋ b u
약속	j a̠ k s͈ o̞ k̚
권위주의	k w ʌ̹ n ɥ i d͡ʑ u ɰ i
부제	p uː d͡ʑ e̞
정규	t͡ɕ ʌ̹ ŋ ɡ j u
프로파길	pʰ ɯ ɾ o̞ pʰ a̠ ɡ i ɭ
판도	pʰ a̠ n d o̞
문자반	m u ɲ t͡ɕ͈ a̠ b a̠ n
각각	k a̠ k̚ k͈ a̠ k̚
코토레타	kʰ o̞ tʰ o̞ ɾ e̞ tʰ a̠
켈빈	kʰ e̞ ɭ b i n
거세	k ʌ̹ sʰ e̞
공세	k o̞ː ŋ sʰ e̞
외삼촌	w e̞ː sʰ a̠ m t͡ɕʰ o̞ n
뜻	t͈ ɯ t̚
알라	a̠ ɭ ɭ a̠
양면	j a̠ ŋ m j ʌ̹ n
목련	m o̞ ŋ ɲ j ʌ̹ n
전설	t͡ɕ ɘː n sʰ ʌ̹ ɭ
할아버지	h a̠ ɾ a̠ b ʌ̹ d͡ʑ i
전차	t͡ɕ ɘː ɲ t͡ɕʰ a̠
노면전차	n o̞ m j ʌ̹ ɲ d͡ʑ ʌ̹ ɲ t͡ɕʰ a̠
아침	a̠ t͡ɕʰ i m
포기하다	pʰ o̞ː ɡ i ɦ a̠ d a̠
목화	m o̞ kʰ w a̠
교환	k j o β w a̠ n
이익	iː i k̚
옹	o̞ ŋ
고시원	k o̞ː ɕʰ i w ʌ̹ n
정치가	t͡ɕ ʌ̹ ŋ t͡ɕʰ i ɡ a̠
거야	k ʌ̹ j a̠
사양	sʰ a̠ j a̠ ŋ
원조	w ɘː ɲ d͡ʑ o̞
코스	kʰ o̞ sʰ ɯ
서류철	sʰ ʌ̹ ɾ j u t͡ɕʰ ʌ̹ ɭ
서귀포	sʰ ʌ̹ ɡ ɥ i pʰ o̞
본성	p o̞ n sʰ ʌ̹ ŋ
기술자	k i sʰ u ʎ t͡ɕ͈ a̠
수리	sʰ uː ɾ i
법랑질	p ʌ̹ m n a̠ ŋ d͡ʑ i ɭ
금년	k ɯ m ɲ j ʌ̹ n
앗	a̠ t̚
만년필	m a̠ː n ɲ j ʌ̹ n pʰ i ɭ
맘속	m a̠ː m s͈ o̞ k̚
갈밭쥐	k a̠ ɭ b a̠ t̚ t͡ɕ͈ ɥ i
설거지하다	sʰ ʌ̹ ɭ ɡ ʌ̹ d͡ʑ i ɦ a̠ d a̠
창조자	t͡ɕʰ a̠ː ŋ d͡ʑ o̞ d͡ʑ a̠
죽음	t͡ɕ u ɡ ɯ m
비리다	p i ɾ i d a̠
관자놀이	k w a̠ ɲ d͡ʑ a̠ n o̞ ɾ i
김	k iː m
확인	ɸ w a̠ ɡ i n
원시	w ɘː n ɕʰ i
음표	ɯ m pʰ j o
최강	t͡ɕʰ w e̞ː ɡ a̠ ŋ
예절	j e̞ d͡ʑ ʌ̹ ɭ
국산	k u k s͈ a̠ n
창	t͡ɕʰ a̠ ŋ
설계	sʰ ʌ̹ ɭ ɡ j e̞
한류	h a̠ ʎ ʎ j u
으스름하다	ɯ sʰ ɯ ɾ ɯ m ɦ a̠ d a̠
신시사이저	ɕʰ i n ɕʰ i sʰ a̠ i d͡ʑ ʌ̹
숙명	sʰ u ŋ m j ʌ̹ ŋ
송어	sʰ o̞ ŋ ʌ̹
대황어	t ɛː β w a̠ ŋ ʌ̹
낮추다	n a̠ t̚ t͡ɕʰ u d a̠
리터	ɾ i tʰ ʌ̹
보디빌딩	p o̞ d i b i ɭ d i ŋ
덮이다	t ʌ̹ pʰ i d a̠
누	n u
말차	m a̠ ʎ t͡ɕʰ a̠
샴푸	ɕʰ a̠ m pʰ u
완곡하다	w a̠ː n ɡ o̞ kʰ a̠ d a̠
묶다	m u k̚ t͈ a̠
양봉	j a̠ː ŋ b o̞ ŋ
못하다	m o̞ tʰ a̠ d a̠
횡적	ɸ w e̞ ŋ t͡ɕ͈ ʌ̹ k̚
근거	k ɯ n ɡ ʌ̹
물만두	m u ɭ m a̠ n d u
쏟아지다	s͈ o̞ d a̠ d͡ʑ i d a̠
날숨	n a̠ ɭ sʰ u m
오르간	o̞ ɾ ɯ ɡ a̠ n
코	kʰ o̞
머무르다	m ʌ̹ m u ɾ ɯ d a̠
걸레	k ʌ̹ ɭ ɭ e̞
각주구검	k a̠ k̚ t͡ɕ͈ u ɡ u ɡ ʌ̹ m
사고	sʰ a̠ ɡ o̞
바오로	p a̠ o̞ ɾ o̞
쳐죽이다	t͡ɕʰ ʌ̹ d͡ʑ u ɡ i d a̠
뉴욕	ɲ j u j o k̚
사령부	sʰ a̠ ɾ j ʌ̹ ŋ b u
독음	t o̞ ɡ ɯ m
빛	p i t̚
ㅈ	t͡ɕ
이어	i ʌ̹
음	ɯ m
공자	k o̞ ŋ d͡ʑ a̠
훈제	ɸʷ u ɲ d͡ʑ e̞
수속	sʰ u sʰ o̞ k̚
되뇌다	t w e̞ n w e̞ d a̠
붙잡히다	p u t̚ t͡ɕ͈ a̠ pʰ i d a̠
지다	t͡ɕ i d a̠
러브호텔	ɾ ʌ̹ b ɯ β o̞ tʰ e̞ ɭ
기지	k i d͡ʑ i
놀라움	n o̞ː ɭ ɭ a̠ u m
야당	j a̠ː d a̠ ŋ
벌	p ɘː ɭ
기독	k i d o̞ k̚
붉다	p u k̚ t͈ a̠
성사	sʰ ɘː ŋ sʰ a̠
바쁘다	p a̠ p͈ ɯ d a̠
제로	t͡ɕ e̞ ɾ o̞
기공	k i ɡ o̞ ŋ
놀다	n o̞ː ɭ d a̠
지루하다	t͡ɕ i ɾ u ɦ a̠ d a̠
이불	i b u ɭ
어떡하다	ʌ̹ t͈ ʌ̹ kʰ a̠ d a̠
양성자	j a̠ ŋ sʰ ʌ̹ ŋ d͡ʑ a̠
상어	sʰ a̠ ŋ ʌ̹
이엉	i ʌ̹ ŋ
하이드라존	h a̠ i d ɯ ɾ a̠ d͡ʑ o̞ n
기린	k i ɾ i n
익명	i ŋ m j ʌ̹ ŋ
붕어	p uː ŋ ʌ̹
푸르다	pʰ u ɾ ɯ d a̠
도마	t o̞ m a̠
깨지다	k͈ ɛː d͡ʑ i d a̠
니은	n i ɯ n
이틀	i tʰ ɯ ɭ
카지노	kʰ a̠ d͡ʑ i n o̞
멋없다	m ʌ̹ d ʌ̹ p̚ t͈ a̠
건달	k ʌ̹ n d a̠ ɭ
삭	sʰ a̠ k̚
신선	ɕʰ i n sʰ ʌ̹ n
신강	ɕʰ i n ɡ a̠ ŋ
광학	k w a̠ ŋ ɦ a̠ k̚
계절적	k j e̞ː d͡ʑ ʌ̹ ʎ t͡ɕ͈ ʌ̹ k̚
보수주의	p o̞ sʰ u d͡ʑ u ɰ i
편도	pʰ j ʌ̹ n d o̞
마르티니크	m a̠ ɾ ɯ tʰ i n i k x ɯ
노트	n o̞ tʰ ɯ
직	t͡ɕ i k̚
의존하다	ɰ i d͡ʑ o̞ n ɦ a̠ d a̠
친근감	t͡ɕʰ i n ɡ ɯ n ɡ a̠ m
누렇다	n uː ɾ ʌ̹ tʰ a̠
산과	sʰ a̠ n ɡ w a̠
침묵하다	t͡ɕʰ i m m u kʰ a̠ d a̠
알제	a̠ ʎ d͡ʑ e̞
남기다	n a̠ m ɡ i d a̠
장소	t͡ɕ a̠ ŋ sʰ o̞
좀	t͡ɕ o̞ m
여유	j ʌ̹ j u
부담	p uː d a̠ m
에르븀	e̞ ɾ ɯ b j u m
연옥	j ɘː n o̞ k̚
직원	t͡ɕ i ɡ w ʌ̹ n
욱	u k̚
서술	sʰ ɘː sʰ u ɭ
불화	p u ɾ β w a̠
퀴나졸린	kʰ ɥ i n a̠ d͡ʑ o̞ ʎ ʎ i n
딴	t͈ a̠ n
적응도	t͡ɕ ʌ̹ ɡ ɯ ŋ d o̞
어버이	ʌ̹ b ʌ̹ i
만약	m a̠ː ɲ j a̠ k̚
수학자	sʰ uː ɦ a̠ k̚ t͡ɕ͈ a̠
과장	k w a̠ d͡ʑ a̠ ŋ
장시	t͡ɕ a̠ ŋ ɕʰ i
별자리	p j ɘː ʎ d͡ʑ a̠ ɾ i
나이팅게일	n a̠ i tʰ i ŋ ɡ e̞ i ɭ
이사하다	i sʰ a̠ ɦ a̠ d a̠
선인장	sʰ ʌ̹ n i ɲ d͡ʑ a̠ ŋ
실마리	ɕʰ iː ɭ m a̠ ɾ i
뜨리다	t͈ ɯ ɾ i d a̠
주뼛주뼛	t͡ɕ u p͈ j ʌ̹ t̚ t͡ɕ͈ u p͈ j ʌ̹ t̚
한	h a̠ n
부정관사	p u d͡ʑ ʌ̹ ŋ ɡ w a̠ n sʰ a̠
분류학	p u ʎ ʎ j u ɦ a̠ k̚
코토누	kʰ o̞ tʰ o̞ n u
밧줄	p a̠ t̚ t͡ɕ͈ u ɭ
핀란드어	pʰ i ɭ ɭ a̠ n d ɯ ʌ̹
꿀	k͈ u ɭ
순위	sʰ uː n ɥ i
시립	ɕʰ iː ɾ i p̚
한국학	h a̠ː n ɡ u kʰ a̠ k̚
농	n o̞ː ŋ
본받다	p o̞ n b a̠ t̚ t͈ a̠
부레	p u ɾ e̞
투르크메니스탄	tʰ u ɾ ɯ k x ɯ m e̞ n i sʰ ɯ tʰ a̠ n
앞뒤	a̠ p̚ t͈ ɥ i
평민	pʰ j ʌ̹ ŋ m i n
샤쓰	ɕʰ a̠ s͈ ɯ
로마	ɾ o̞ m a̠
진주층	t͡ɕ i ɲ d͡ʑ u t͡ɕʰ ɯ ŋ
겹	k j ʌ̹ p̚
비단털쥐	p i d a̠ n tʰ ʌ̹ ʎ d͡ʑ ɥ i
용과	j o ŋ ɡ w a̠
종아리	t͡ɕ o̞ː ŋ a̠ ɾ i
식초	ɕʰ i k̚ t͡ɕʰ o̞
기법	k i p͈ ʌ̹ p̚
짙푸르다	t͡ɕ i t̚ pʰ u ɾ ɯ d a̠
담임	t a̠ m i m
아연	a̠ j ʌ̹ n
판단하다	pʰ a̠ n d a̠ n ɦ a̠ d a̠
동의하다	t o̞ ŋ ɰ i ɦ a̠ d a̠
구니하다	k u n i ɦ a̠ d a̠
동성	t o̞ ŋ sʰ ʌ̹ ŋ
구역질	k u j ʌ̹ k̚ t͡ɕ͈ i ɭ
마늘	m a̠ n ɯ ɭ
얼쑤	ʌ̹ ɭ s͈ u
나아가다	n a̠ a̠ ɡ a̠ d a̠
열도	j ʌ̹ ɭ t͈ o̞
레스토랑	ɾ e̞ sʰ ɯ tʰ o̞ ɾ a̠ ŋ
따다	t͈ a̠ d a̠
볼일	p o̞ː ʎ ʎ i ɭ
증오심	t͡ɕ ɯ ŋ o̞ ɕʰ i m
나이지리아	n a̠ i d͡ʑ i ɾ i a̠
격	k j ʌ̹ k̚
선창	sʰ ʌ̹ ɲ t͡ɕʰ a̠ ŋ
늘리다	n ɯ ʎ ʎ i d a̠
고등어	k o̞ d ɯ ŋ ʌ̹
그릇되다	k ɯ ɾ ɯ t̚ t͈ w e̞ d a̠
다툼	t a̠ tʰ u m
이사	iː sʰ a̠
물음	m u ɾ ɯ m
합법화	h a̠ p̚ p͈ ʌ̹ pʰ w a̠
격리	k j ʌ̹ ŋ n i
도움말	t o̞ u m m a̠ ɭ
벽난로	p j ʌ̹ ŋ n a̠ ɭ ɭ o̞
달리	t a̠ ʎ ʎ i
교구	k j o ɡ u
추격	t͡ɕʰ u ɡ j ʌ̹ k̚
입쌀	i p s͈ a̠ ɭ
침략	t͡ɕʰ iː m ɲ j a̠ k̚
도하	t o̞ ɦ a̠
프로이센	pʰ ɯ ɾ o̞ i sʰ e̞ n
언젠가	ɘː ɲ d͡ʑ e̞ n ɡ a̠
모스크바	m o̞ sʰ ɯ k x ɯ b a̠
완료	w a̠ ʎ ʎ j o
시멘트	ɕʰ i m e̞ n tʰ ɯ
람	ɾ a̠ m
노환	n o̞ː β w a̠ n
걸핏걸핏	k ʌ̹ ɭ pʰ i t̚ k͈ ʌ̹ ɭ pʰ i t̚
군주국	k u ɲ d͡ʑ u ɡ u k̚
경향	k j ʌ̹ ŋ ʝ j a̠ ŋ
원폭	w ʌ̹ n pʰ o̞ k̚
랑	ɾ a̠ ŋ
연속	j ʌ̹ n sʰ o̞ k̚
문화어	m u n β w a̠ ʌ̹
의복	ɰ i b o̞ k̚
칡	t͡ɕʰ i k̚
의심	ɰ i ɕʰ i m
확	ɸ w a̠ k̚
따르다	t͈ a̠ ɾ ɯ d a̠
닭	t a̠ k̚
판공실	pʰ a̠ n ɡ o̞ ŋ ɕʰ i ɭ
천리안	t͡ɕʰ ʌ̹ ʎ ʎ i a̠ n
정리하다	t͡ɕ ɘː ŋ n i ɦ a̠ d a̠
손바닥	sʰ o̞ n p͈ a̠ d a̠ k̚
거리	k ʌ̹ ɾ i
남	n a̠ m
고소하다	k o̞ː sʰ o̞ ɦ a̠ d a̠
즉시	t͡ɕ ɯ k ɕ͈ i
냉면	n ɛː ŋ m j ʌ̹ n
시보귬	ɕʰ i b o̞ ɡ j u m
유진	j u d͡ʑ i n
아이고	a̠ i ɡ o̞
과	k w a̠
주머니	t͡ɕ u m ʌ̹ n i
줄	t͡ɕ u ɭ
졸혼	t͡ɕ o̞ ɾ β o̞ n
시디	ɕʰ i d i
낫다	n a̠ː t̚ t͈ a̠
부류	p u ɾ j u
승	sʰ ɯ ŋ
문	m u n
띠걸이	t͈ i ɡ ʌ̹ ɾ i
바다표범	p a̠ d a̠ pʰ j o b ʌ̹ m
잔가시고기	t͡ɕ a̠ n ɡ a̠ ɕʰ i ɡ o̞ ɡ i
규소	k j u sʰ o̞
마구	m a̠ ɡ u
버티다	p ʌ̹ tʰ i d a̠
병	p j ʌ̹ ŋ
자신	t͡ɕ a̠ ɕʰ i n
겁나다	k ʌ̹ m n a̠ d a̠
은하계	ɯ n ɦ a̠ ɡ j e̞
안녕	a̠ n ɲ j ʌ̹ ŋ
뛰어넘다	t͈ ɥ i ʌ̹ n ʌ̹ m t͈ a̠
식사	ɕʰ i k s͈ a̠
바람둥이	p a̠ ɾ a̠ m d u ŋ i
시도	ɕʰ iː d o̞
브라더	p ɯ ɾ a̠ d ʌ̹
계모	k j e̞ː m o̞
가마치	k a̠ m a̠ t͡ɕʰ i
난수	n a̠ n sʰ u
사나	sʰ a̠ n a̠
똥양인	t͈ o̞ ŋ j a̠ ŋ i n
반찬	p a̠ ɲ t͡ɕʰ a̠ n
사막	sʰ a̠ m a̠ k̚
요하다	j o ɦ a̠ d a̠
독립성	t o̞ ŋ n i p s͈ ʌ̹ ŋ
거짓말	k ɘː d͡ʑ i n m a̠ ɭ
마르코	m a̠ ɾ ɯ kʰ o̞
튀니스	tʰ ɥ i n i sʰ ɯ
검열	k ɘː m ɲ j ʌ̹ ɭ
지나가다	t͡ɕ i n a̠ ɡ a̠ d a̠
측	t͡ɕʰ ɯ k̚
돌멩이	t o̞ː ɭ m e̞ ŋ i
모두	m o̞ d u
라이터돌	ɾ a̠ i tʰ ʌ̹ d o̞ ɭ
정구	t͡ɕ ʌ̹ ŋ ɡ u
똑똑이	t͈ o̞ k̚ t͈ o̞ ɡ i
길림	k i ʎ ʎ i m
찌푸리다	t͡ɕ͈ i pʰ u ɾ i d a̠
주위	t͡ɕ u ɥ i
일정하다	i ʎ d͡ʑ ʌ̹ ŋ ɦ a̠ d a̠
미꾸라지	m i k͈ u ɾ a̠ d͡ʑ i
치앙마이	t͡ɕʰ i a̠ ŋ m a̠ i
맹렬하다	m ɛː ŋ ɲ j ʌ̹ ɾ ɦ a̠ d a̠
며느리	m j ʌ̹ n ɯ ɾ i
가타나	k a̠ tʰ a̠ n a̠
갈비	k a̠ ɭ b i
서너	sʰ ʌ̹ n ʌ̹
연구소	j ʌ̹ n ɡ u sʰ o̞
멀쩡	m ʌ̹ ʎ t͡ɕ͈ ʌ̹ ŋ
의문	ɰ i m u n
항구	h a̠ː ŋ ɡ u
초원	t͡ɕʰ o̞ w ʌ̹ n
교전	k j o d͡ʑ ʌ̹ n
둘러보다	t u ɭ ɭ ʌ̹ b o̞ d a̠
진공청소기	t͡ɕ i n ɡ o̞ ŋ t͡ɕʰ ʌ̹ ŋ sʰ o̞ ɡ i
언문	ɘː n m u n
한성	h a̠ː n sʰ ʌ̹ ŋ
나란히	n a̠ ɾ a̠ n ʝ i
신도	ɕʰ i n d o̞
달하다	t a̠ ɾ ɦ a̠ d a̠
각자	k a̠ k̚ t͡ɕ͈ a̠
나이트	n a̠ i tʰ ɯ
초콜릿	t͡ɕʰ o̞ kʰ o̞ ʎ ʎ i t̚
조건	t͡ɕ o̞ k͈ ʌ̹ n
부러지다	p u ɾ ʌ̹ d͡ʑ i d a̠
결정되다	k j ʌ̹ ʎ t͡ɕ͈ ʌ̹ ŋ d w e̞ d a̠
항공기	h a̠ː ŋ ɡ o̞ ŋ ɡ i
약어	j a̠ ɡ ʌ̹
샤워	ɕʰ a̠ w ʌ̹
미투리	m i tʰ u ɾ i
헐	h ʌ̹ ɭ
튀니지	tʰ ɥ i n i d͡ʑ i
하이퍼링크	h a̠ i pʰ ʌ̹ ɾ i ŋ k x ɯ
통근하다	tʰ o̞ ŋ ɡ ɯ n ɦ a̠ d a̠
의지하다	ɰ i d͡ʑ i ɦ a̠ d a̠
후쿠시마	ɸʷ u kʰ u ɕʰ i m a̠
글꼴	k ɯ ɭ k͈ o̞ ɭ
영원히	j ɘː ŋ w ʌ̹ n ʝ i
숙취	sʰ u k̚ t͡ɕʰ ɥ i
오토바이	o̞ tʰ o̞ b a̠ i
수업	sʰ u ʌ̹ p̚
레위기	ɾ e̞ ɥ i ɡ i
볶이	p o̞ k͈ i
예방	j e̞ː b a̠ ŋ
학회	h a̠ kʰ w e̞
해결	h ɛː ɡ j ʌ̹ ɭ
환송하다	ɸ w a̠ n sʰ o̞ ŋ ɦ a̠ d a̠
호숫가	ɸʷ o̞ sʰ u t̚ k͈ a̠
북조선	p u k̚ t͡ɕ͈ o̞ sʰ ʌ̹ n
강간	k a̠ː ŋ ɡ a̠ n
복용량	p o̞ ɡ j o ŋ ɲ j a̠ ŋ
파스타	pʰ a̠ sʰ ɯ tʰ a̠
여성	j ʌ̹ sʰ ʌ̹ ŋ
왕국	w a̠ ŋ ɡ u k̚
방송원	p a̠ ŋ sʰ o̞ ŋ w ʌ̹ n
이레	i ɾ e̞
쇠기러기	sʰ w e̞ ɡ i ɾ ʌ̹ ɡ i
풀무	pʰ u ɭ m u
트로피	tʰ ɯ ɾ o̞ pʰ i
미분	m i b u n
의연금	ɰ iː j ʌ̹ n ɡ ɯ m
여와	j ʌ̹ w a̠
빈민굴	p i n m i n ɡ u ɭ
허브티	h ʌ̹ b ɯ tʰ i
인근	i n ɡ ɯ n
전도사	t͡ɕ ʌ̹ n d o̞ sʰ a̠
기민하다	k i m i n ɦ a̠ d a̠
도자기	t o̞ d͡ʑ a̠ ɡ i
나일틸라피아	n a̠ i ɭ tʰ i ɭ ɭ a̠ pʰ i a̠
둔치다	t u ɲ t͡ɕʰ i d a̠
특성	tʰ ɯ k s͈ ʌ̹ ŋ
두샨베	t u ɕʰ a̠ n b e̞
안목	a̠ː n m o̞ k̚
비잔티움	p i d͡ʑ a̠ n tʰ i u m
작은두꺼비	t͡ɕ a̠ː ɡ ɯ n d u k͈ ʌ̹ b i
간판	k a̠ n pʰ a̠ n
흘러나오다	x ɯ ɭ ɭ ʌ̹ n a̠ o̞ d a̠
발끝	p a̠ ɭ k͈ ɯ t̚
불규칙하다	p u ɭ ɡ j u t͡ɕʰ i kʰ a̠ d a̠
부인	p uː i n
믿음	m i d ɯ m
체포하다	t͡ɕʰ e̞ pʰ o̞ ɦ a̠ d a̠
손수건	sʰ o̞ n s͈ u ɡ ʌ̹ n
밀월	m i ɾ w ʌ̹ ɭ
소식	sʰ o̞ ɕʰ i k̚
감염	k a̠ː m j ʌ̹ m
면포	m j ʌ̹ n pʰ o̞
흐느끼다	x ɯ n ɯ k͈ i d a̠
왁자지껄하다	w a̠ k̚ t͡ɕ͈ a̠ d͡ʑ i k͈ ʌ̹ ɾ ɦ a̠ d a̠
곪다	k o̞ː m t͈ a̠
편지	pʰ j ɘː ɲ d͡ʑ i
대략	t ɛː ɾ j a̠ k̚
계부	k j e̞ː b u
법관	p ʌ̹ p̚ k͈ w a̠ n
들려오다	t ɯ ʎ ʎ j ʌ̹ o̞ d a̠
증기	t͡ɕ ɯ ŋ ɡ i
안휘	a̠ n ɦ ɥ i
통지	tʰ o̞ ŋ d͡ʑ i
인형	i n ʝ j ʌ̹ ŋ
시토회	ɕʰ i tʰ o̞ β w e̞
유죄	j uː d͡ʑ w e̞
소굴	sʰ o̞ ɡ u ɭ
장뇌	t͡ɕ a̠ ŋ n w e̞
조용하다	t͡ɕ o̞ j o ŋ ɦ a̠ d a̠
필획	pʰ i ɾ β w e̞ k̚
전도	t͡ɕ ʌ̹ n d o̞
크리스마스	k x ɯ ɾ i sʰ ɯ m a̠ sʰ ɯ
고려하다	k o̞ ɾ j ʌ̹ ɦ a̠ d a̠
육각수	j u k̚ k͈ a̠ k s͈ u
잊히다	i t͡ɕʰ i d a̠
과거형	k w a̠ ɡ ʌ̹ ʝ j ʌ̹ ŋ
촬영	t͡ɕʰ w a̠ ɾ j ʌ̹ ŋ
우편번호	u pʰ j ʌ̹ n b ʌ̹ n β o̞
해석하다	h ɛː sʰ ʌ̹ kʰ a̠ d a̠
사	sʰ a̠ː
먹물	m ʌ̹ ŋ m u ɭ
성체	sʰ ɘː ŋ t͡ɕʰ e̞
소비에트	sʰ o̞ b i e̞ tʰ ɯ
요일	j o i ɭ
두려움	t u ɾ j ʌ̹ u m
떠올리다	t͈ ʌ̹ o̞ ʎ ʎ i d a̠
득도	t ɯ k̚ t͈ o̞
어떠하다	ʌ̹ t͈ ʌ̹ ɦ a̠ d a̠
에게	e̞ ɡ e̞
선비	sʰ ʌ̹ n b i
조동사	t͡ɕ o̞ d o̞ ŋ sʰ a̠
저곳	t͡ɕ ʌ̹ ɡ o̞ t̚
명절	m j ʌ̹ ŋ d͡ʑ ʌ̹ ɭ
모국어	m o̞ ɡ u ɡ ʌ̹
폭군	pʰ o̞ k̚ k͈ u n
이모지	i m o̞ d͡ʑ i
보물	p o̞ː m u ɭ
에피소드	e̞ pʰ i sʰ o̞ d ɯ
거듭홀소리	k ʌ̹ d ɯ pʰ o̞ ɭ sʰ o̞ ɾ i
빛깔	p i t̚ k͈ a̠ ɭ
작곡가	t͡ɕ a̠ k̚ k͈ o̞ k̚ k͈ a̠
메서드	m e̞ sʰ ʌ̹ d ɯ
팔방미인	pʰ a̠ ɭ b a̠ ŋ m i i n
차	t͡ɕʰ a̠
쇠뒤쥐	sʰ w e̞ d ɥ i d͡ʑ ɥ i
망	m a̠ ŋ
살치	sʰ a̠ ʎ t͡ɕʰ i
부스러기	p u sʰ ɯ ɾ ʌ̹ ɡ i
거만하다	k ɘː m a̠ n ɦ a̠ d a̠
증설	t͡ɕ ɯ ŋ sʰ ʌ̹ ɭ
커브	kʰ ʌ̹ b ɯ
감정	k a̠ː m d͡ʑ ʌ̹ ŋ
터븀	tʰ ʌ̹ b j u m
레위니옹	ɾ e̞ ɥ i n i o̞ ŋ
테이블	tʰ e̞ i b ɯ ɭ
그레나다	k ɯ ɾ e̞ n a̠ d a̠
잠비아	t͡ɕ a̠ m b i a̠
개나리꽃	k ɛː n a̠ ɾ i k͈ o̞ t̚
등반	t ɯ ŋ b a̠ n
막부	m a̠ː k̚ p͈ u
밀접하다	m i ʎ t͡ɕ͈ ʌ̹ pʰ a̠ d a̠
주어지다	t͡ɕ u ʌ̹ d͡ʑ i d a̠
닭살	t a̠ k s͈ a̠ ɭ
천만	t͡ɕʰ ʌ̹ n m a̠ n
풀다	pʰ u ɭ d a̠
슈트	ɕʰ u tʰ ɯ
펶	pʰ j ʌ̹ k̚
인원	i n w ʌ̹ n
속보	sʰ o̞ː k̚ p͈ o̞
전압	t͡ɕ ɘː n a̠ p̚
페니	pʰ e̞ n i
슬프다	sʰ ɯ ɭ pʰ ɯ d a̠
플루오렌	pʰ ɯ ɭ ɭ u o̞ ɾ e̞ n
수	sʰ u
동시	t o̞ː ŋ ɕʰ i
불량	p u ʎ ʎ j a̠ ŋ
가시고기	k a̠ ɕʰ i ɡ o̞ ɡ i
제과점	t͡ɕ e̞ː ɡ w a̠ d͡ʑ ʌ̹ m
곡	k o̞ k̚
어머나	ɘː m ʌ̹ n a̠
셍	sʰ e̞ ŋ
부름	p u ɾ ɯ m
강당	k a̠ː ŋ d a̠ ŋ
엉엉	ʌ̹ ŋ ʌ̹ ŋ
오트밀	o̞ tʰ ɯ m i ɭ
적극	t͡ɕ ʌ̹ k̚ k͈ ɯ k̚
고민하다	k o̞ m i n ɦ a̠ d a̠
기업인	k i ʌ̹ b i n
단	t a̠ n
알코올	a̠ ɭ kʰ o̞ o̞ ɭ
부딪히다	p u d i t͡ɕʰ i d a̠
윅셔너리	ɥ i k ɕ͈ ʌ̹ n ʌ̹ ɾ i
은	ɯ n
동기	t o̞ ŋ ɡ i
편집하다	pʰ j ʌ̹ ɲ d͡ʑ i pʰ a̠ d a̠
은하수	ɯ n ɦ a̠ sʰ u
칠리	t͡ɕʰ i ʎ ʎ i
베를린	p e̞ ɾ ɯ ʎ ʎ i n
갑옷	k a̠ b o̞ t̚
이월	iː w ʌ̹ ɭ
집	t͡ɕ i p̚
눈송이	n uː n s͈ o̞ ŋ i
개꿈	k ɛː k͈ u m
프레젠테이션	pʰ ɯ ɾ e̞ d͡ʑ e̞ n tʰ e̞ i ɕʰ ʌ̹ n
정당	t͡ɕ ʌ̹ ŋ d a̠ ŋ
커튼	kʰ ʌ̹ tʰ ɯ n
바다사자	p a̠ d a̠ sʰ a̠ d͡ʑ a̠
우정	u d͡ʑ ʌ̹ ŋ
수라	sʰ u ɾ a̠
한도	h a̠ː n d o̞
증상	t͡ɕ ɯ ŋ sʰ a̠ ŋ
신장	ɕʰ i ɲ d͡ʑ a̠ ŋ
머리통	m ʌ̹ ɾ i tʰ o̞ ŋ
고프다	k o̞ pʰ ɯ d a̠
응가	ɯ ŋ ɡ a̠
과부	k w a̠ː b u
어원학	ɘː w ʌ̹ n ɦ a̠ k̚
류음	ɾ j u ɯ m
불굴	p u ɭ ɡ u ɭ
쌀	s͈ a̠ ɭ
자리	t͡ɕ a̠ ɾ i
슬로건	s͈ ɯ ɭ ɭ o̞ ɡ ʌ̹ n
근처	k ɯː ɲ t͡ɕʰ ʌ̹
포인트	pʰ o̞ i n tʰ ɯ
약자	j a̠ k̚ t͡ɕ͈ a̠
섧다	sʰ ɘː ɭ t͈ a̠
안락사	a̠ ɭ ɭ a̠ k s͈ a̠
갈고랑이	k a̠ ɭ ɡ o̞ ɾ a̠ ŋ i
신장	ɕʰ iː ɲ d͡ʑ a̠ ŋ
피다	pʰ i d a̠
그러면	k ɯ ɾ ʌ̹ m j ʌ̹ n
모음	m o̞ː ɯ m
붇다	p uː t̚ t͈ a̠
맞이하다	m a̠ d͡ʑ i ɦ a̠ d a̠
언니	ʌ̹ n n i
영적	j ʌ̹ ŋ t͡ɕ͈ ʌ̹ k̚
잠시	t͡ɕ a̠ː m ɕʰ i
북쩡	p u k̚ t͡ɕ͈ ʌ̹ ŋ
모치망둑	m o̞ t͡ɕʰ i m a̠ ŋ d u k̚
종다리	t͡ɕ o̞ ŋ d a̠ ɾ i
쓰레기	s͈ ɯ ɾ e̞ ɡ i
이뤄지다	i ɾ w ʌ̹ d͡ʑ i d a̠
투발루	tʰ u b a̠ ɭ ɭ u
영자팔법	j ʌ̹ ŋ d͡ʑ a̠ pʰ a̠ ɭ b ʌ̹ p̚
요크셔	j o k x ɯ ɕʰ ʌ̹
영향력	j ɘː ŋ ʝ j a̠ ŋ ɲ j ʌ̹ k̚
정은	t͡ɕ ɘː ŋ ɯ n
붙임표	p u t͡ɕʰ i m pʰ j o
아이폰	a̠ i pʰ o̞ n
강수량	k a̠ː ŋ sʰ u ɾ j a̠ ŋ
맛집	m a̠ t̚ t͡ɕ͈ i p̚
뻼	p͈ e̞ m
언덕	ʌ̹ n d ʌ̹ k̚
영	j ʌ̹ ŋ
쩍다	t͡ɕ͈ ʌ̹ k̚ t͈ a̠
통화	tʰ o̞ ŋ β w a̠
창자	t͡ɕʰ a̠ ŋ d͡ʑ a̠
만능	m a̠ n n ɯ ŋ
지명학	t͡ɕ i m j ʌ̹ ŋ ɦ a̠ k̚
배	p ɛː
금지	k ɯː m d͡ʑ i
검둥이	k ʌ̹ m d u ŋ i
반면	p a̠ː n m j ʌ̹ n
레일	ɾ e̞ i ɭ
쌍곡선	s͈ a̠ ŋ ɡ o̞ k s͈ ʌ̹ n
아이누어	a̠ i n u ʌ̹
이웃	i u t̚
접전	t͡ɕ ʌ̹ p̚ t͡ɕ͈ ʌ̹ n
쫓다	t͡ɕ͈ o̞ t̚ t͈ a̠
회원	ɸ w e̞ː w ʌ̹ n
생쥐	sʰ ɛː ŋ d͡ʑ ɥ i
납작하다	n a̠ p̚ t͡ɕ͈ a̠ kʰ a̠ d a̠
뼁	p͈ e̞ ŋ
위음성	ɥ i ɯ m sʰ ʌ̹ ŋ
자세	t͡ɕ a̠ sʰ e̞
평가	pʰ j ɘː ŋ k͈ a̠
꼬치	k͈ o̞ t͡ɕʰ i
왕관	w a̠ ŋ ɡ w a̠ n
신의주	ɕʰ i n ɰ i d͡ʑ u
구성되다	k u sʰ ʌ̹ ŋ d w e̞ d a̠
시럽	ɕʰ i ɾ ʌ̹ p̚
갈고리	k a̠ ɭ ɡ o̞ ɾ i
파랑	pʰ a̠ ɾ a̠ ŋ
요한	j o ɦ a̠ n
공갈치다	k o̞ː ŋ ɡ a̠ ʎ t͡ɕʰ i d a̠
표지판	pʰ j o d͡ʑ i pʰ a̠ n
노숙하다	n o̞ sʰ u kʰ a̠ d a̠
투기	tʰ u ɡ i
고니	k o̞ n i
아순시온	a̠ sʰ u n ɕʰ i o̞ n
물다	m u ɭ d a̠
칠십	t͡ɕʰ i ɭ ɕ͈ i p̚
미소짓다	m i sʰ o̞ d͡ʑ i t̚ t͈ a̠
응결	ɯ ŋ ɡ j ʌ̹ ɭ
야쿠츠크	j a̠ kʰ u t͡ɕʰ ɯ k x ɯ
노른자	n o̞ ɾ ɯ ɲ d͡ʑ a̠
엄격하다	ʌ̹ m k͈ j ʌ̹ kʰ a̠ d a̠
지경	t͡ɕ i ɡ j ʌ̹ ŋ
버릇	p ʌ̹ ɾ ɯ t̚
ㅠ	j u
구들	k u d ɯ ɭ
찾아오다	t͡ɕʰ a̠ d͡ʑ a̠ o̞ d a̠
바륨	p a̠ ɾ j u m
천사	t͡ɕʰ ʌ̹ n sʰ a̠
화살표	ɸ w a̠ sʰ a̠ ɭ pʰ j o
꽃봉오리	k͈ o̞ t̚ p͈ o̞ ŋ o̞ ɾ i
어린이집	ʌ̹ ɾ i n i d͡ʑ i p̚
포커	pʰ o̞ kʰ ʌ̹
예수	j e̞ sʰ u
파괴	pʰ a̠ː ɡ w e̞
험	h ʌ̹ m
배반	p ɛː b a̠ n
사귀다	sʰ a̠ ɡ ɥ i d a̠
법	p ʌ̹ p̚
친삼촌	t͡ɕʰ i n sʰ a̠ m t͡ɕʰ o̞ n
당근	t a̠ ŋ ɡ ɯ n
공식어	k o̞ ŋ ɕʰ i ɡ ʌ̹
땔나무	t͈ ɛː ɭ ɭ a̠ m u
란제리	ɾ a̠ ɲ d͡ʑ e̞ ɾ i
그림	k ɯː ɾ i m
자전거	t͡ɕ a̠ d͡ʑ ʌ̹ n ɡ ʌ̹
가치관	k a̠ t͡ɕʰ i ɡ w a̠ n
알제리	a̠ ʎ d͡ʑ e̞ ɾ i
바누아투	p a̠ n u a̠ tʰ u
의성어	ɰ i sʰ ʌ̹ ŋ ʌ̹
안드레이	a̠ n d ɯ ɾ e̞ i
우레	u ɾ e̞
어부	ʌ̹ b u
양쪽	j a̠ː ŋ t͡ɕ͈ o̞ k̚
냉동고	n ɛː ŋ d o̞ ŋ ɡ o̞
체첸어	t͡ɕʰ e̞ t͡ɕʰ e̞ n ʌ̹
욕심	j o k ɕ͈ i m
파악하다	pʰ a̠ a̠ kʰ a̠ d a̠
흑	x ɯ k̚
머리하다	m ʌ̹ ɾ i ɦ a̠ d a̠
악마	a̠ ŋ m a̠
정치질	t͡ɕ ʌ̹ ŋ t͡ɕʰ i d͡ʑ i ɭ
북방흰뺨오리	p u k̚ p͈ a̠ ŋ ʝ i n p͈ j a̠ m o̞ ɾ i
소비하다	sʰ o̞ b i ɦ a̠ d a̠
곡창	k o̞ k̚ t͡ɕʰ a̠ ŋ
석관	sʰ ʌ̹ k̚ k͈ w a̠ n
평창	pʰ j ʌ̹ ŋ t͡ɕʰ a̠ ŋ
싼룬처	s͈ a̠ ɭ ɭ u ɲ t͡ɕʰ ʌ̹
사회적	sʰ a̠ β w e̞ d͡ʑ ʌ̹ k̚
어쩌다	ʌ̹ t͡ɕ͈ ʌ̹ d a̠
물어뜯다	m u ɾ ʌ̹ t͈ ɯ t̚ t͈ a̠
수다떨다	sʰ u d a̠ t͈ ʌ̹ ɭ d a̠
제화	t͡ɕ e̞ː β w a̠
부남	p u n a̠ m
밀치다	m iː ʎ t͡ɕʰ i d a̠
자손	t͡ɕ a̠ sʰ o̞ n
초록	t͡ɕʰ o̞ ɾ o̞ k̚
재야당	t͡ɕ ɛː j a̠ d a̠ ŋ
기분	k i b u n
총	t͡ɕʰ o̞ ŋ
한민족	h a̠ː n m i ɲ d͡ʑ o̞ k̚
유고슬라비아	j u ɡ o̞ sʰ ɯ ɭ ɭ a̠ b i a̠
잉	i ŋ
멍청이	m ʌ̹ ŋ t͡ɕʰ ʌ̹ ŋ i
병사	p j ʌ̹ ŋ sʰ a̠
끌다	k͈ ɯː ɭ d a̠
지리학	t͡ɕ i ɾ i ɦ a̠ k̚
공수도	k o̞ ŋ sʰ u d o̞
옥토	o̞ k̚ tʰ o̞
붉은가슴흰죽지	p u ɭ ɡ ɯ n ɡ a̠ sʰ ɯ m ʝ i ɲ d͡ʑ u k̚ t͡ɕ͈ i
부모님	p u m o̞ n i m
개체	k ɛː t͡ɕʰ e̞
틀리다	tʰ ɯ ʎ ʎ i d a̠
산서	sʰ a̠ n sʰ ʌ̹
살찌우다	sʰ a̠ ʎ t͡ɕ͈ i u d a̠
까불다	k͈ a̠ b u ɭ d a̠
방정식	p a̠ ŋ d͡ʑ ʌ̹ ŋ ɕʰ i k̚
갸울다	k j a̠ u ɭ d a̠
라며	ɾ a̠ m j ʌ̹
초밥	t͡ɕʰ o̞ b a̠ p̚
와	w a̠
뼏	p͈ j ʌ̹ t̚
어떤	ʌ̹ t͈ ʌ̹ n
파괴하다	pʰ a̠ː ɡ w e̞ ɦ a̠ d a̠
대문	t ɛː m u n
남방동사리	n a̠ m b a̠ ŋ d o̞ ŋ sʰ a̠ ɾ i
몸비누	m o̞ m b i n u
목욕탕	m o̞ ɡ j o k̚ tʰ a̠ ŋ
코너	kʰ o̞ n ʌ̹
체스꼬슬로벤스꼬	t͡ɕʰ e̞ sʰ ɯ k͈ o̞ sʰ ɯ ɭ ɭ o̞ b e̞ n sʰ ɯ k͈ o̞
강물	k a̠ ŋ m u ɭ
결정하다	k j ʌ̹ ʎ t͡ɕ͈ ʌ̹ ŋ ɦ a̠ d a̠
축복	t͡ɕʰ u k̚ p͈ o̞ k̚
시스템	ɕ͈ i sʰ ɯ tʰ e̞ m
모서리	m o̞ sʰ ʌ̹ ɾ i
유지	j u d͡ʑ i
윤리학	j u ʎ ʎ i ɦ a̠ k̚
방귀뀌다	p a̠ ŋ ɡ ɥ i k͈ ɥ i d a̠
가감	k a̠ ɡ a̠ m
실현	ɕʰ i ɾ ʝ j ʌ̹ n
아미노	a̠ m i n o̞
집필	t͡ɕ i p̚ pʰ i ɭ
풍수	pʰ u ŋ sʰ u
네티즌	n e̞ tʰ i d͡ʑ ɯ n
발레	p a̠ ɭ ɭ e̞
전모	t͡ɕ ʌ̹ n m o̞
바자회	p a̠ d͡ʑ a̠ β w e̞
비치다	p i t͡ɕʰ i d a̠
신미	ɕʰ i n m i
부끄러움	p u k͈ ɯ ɾ ʌ̹ u m
커서	kʰ ʌ̹ sʰ ʌ̹
끔찍하다	k͈ ɯ m t͡ɕ͈ i kʰ a̠ d a̠
덴푸라	t e̞ n pʰ u ɾ a̠
광동	k w a̠ ŋ d o̞ ŋ
써레	s͈ ʌ̹ ɾ e̞
외우다	w e̞ u d a̠
설레다	sʰ ʌ̹ ɭ ɭ e̞ d a̠
인기	i n k͈ i
강렬하다	k a̠ ŋ ɲ j ʌ̹ ɾ ɦ a̠ d a̠
계속	k j e̞ː sʰ o̞ k̚
황학루	ɸ w a̠ ŋ ɦ a̠ ŋ n u
붕	p u ŋ
우두커니	u d u kʰ ʌ̹ n i
남방	n a̠ m b a̠ ŋ
화차	ɸ w a̠ː t͡ɕʰ a̠
분수	p uː n sʰ u
벗겨지다	p ʌ̹ t̚ k͈ j ʌ̹ d͡ʑ i d a̠
중미주	t͡ɕ u ŋ m i d͡ʑ u
노리다	n o̞ ɾ i d a̠
불가리아어	p u ɭ ɡ a̠ ɾ i a̠ ʌ̹
역시	j ʌ̹ k ɕ͈ i
머리맡	m ʌ̹ ɾ i m a̠ t̚
류블랴나	ɾ j u b ɯ ʎ ʎ j a̠ n a̠
호버크라프트	ɸʷ o̞ b ʌ̹ k x ɯ ɾ a̠ pʰ ɯ tʰ ɯ
폭력단	pʰ o̞ ŋ ɲ j ʌ̹ k̚ t͈ a̠ n
이데올로기	i d e̞ o̞ ɭ ɭ o̞ ɡ i
지갑	t͡ɕ i ɡ a̠ p̚
부문	p u m u n
당황하다	t a̠ ŋ β w a̠ ŋ ɦ a̠ d a̠
창조	t͡ɕʰ a̠ ŋ d͡ʑ o̞
추위	t͡ɕʰ u ɥ i
팔십	pʰ a̠ ɭ ɕ͈ i p̚
공직자	k o̞ ŋ d͡ʑ i k̚ t͡ɕ͈ a̠
소금	sʰ o̞ ɡ ɯ m
약리학	j a̠ ŋ n i ɦ a̠ k̚
조롱	t͡ɕ o̞ ɾ o̞ ŋ
이런	i ɾ ʌ̹ n
료법	ɾ j o b ʌ̹ p̚
바탕	p a̠ tʰ a̠ ŋ
경어	k j ɘː ŋ ʌ̹
풍뎅이	pʰ u ŋ d e̞ ŋ i
무선	m u sʰ ʌ̹ n
고조되다	k o̞ d͡ʑ o̞ d w e̞ d a̠
확립	ɸ w a̠ ŋ n i p̚
그동안	k ɯ d o̞ ŋ a̠ n
고전	k o̞ː d͡ʑ ʌ̹ n
여권	j ʌ̹ k͈ w ʌ̹ n
보고타	p o̞ ɡ o̞ tʰ a̠
거	k ʌ̹
다마스쿠스	t a̠ m a̠ sʰ ɯ kʰ u sʰ ɯ
짓	t͡ɕ iː t̚
웃음	u sʰ ɯ m
탄도	tʰ a̠ː n d o̞
전자메일	t͡ɕ ʌ̹ ɲ d͡ʑ a̠ m e̞ i ɭ
근육	k ɯ ɲ j u k̚
공산주의	k o̞ː ŋ sʰ a̠ ɲ d͡ʑ u ɰ i
조수	t͡ɕ o̞ː sʰ u
음침하다	ɯ m t͡ɕʰ i m ɦ a̠ d a̠
뱉다	p ɛː t̚ t͈ a̠
쑤시다	s͈ u ɕʰ i d a̠
헬리콥터	h e̞ ʎ ʎ i kʰ o̞ p̚ tʰ ʌ̹
ㅗ	o̞
스페인	sʰ ɯ pʰ e̞ i n
할렐루야	h a̠ ɭ ɭ e̞ ɭ ɭ u j a̠
호지명	ɸʷ o̞ d͡ʑ i m j ʌ̹ ŋ
컵	kʰ ʌ̹ p̚
파렴치하다	pʰ a̠ː ɾ j ʌ̹ m t͡ɕʰ i ɦ a̠ d a̠
촛불	t͡ɕʰ o̞ t̚ p͈ u ɭ
가극	k a̠ ɡ ɯ k̚
기사	k i sʰ a̠
복받치다	p o̞ k̚ p͈ a̠ t̚ t͡ɕʰ i d a̠
석거	sʰ ʌ̹ k̚ k͈ ʌ̹
덕천	t ʌ̹ k̚ t͡ɕʰ ʌ̹ n
아까	a̠ k͈ a̠
무아	m u a̠
빚	p i t̚
두뇌	t u n w e̞
부도	p u d o̞
횡단	ɸ w e̞ ŋ d a̠ n
표현	pʰ j o ʝ j ʌ̹ n
도장	t o̞ d͡ʑ a̠ ŋ
무디다	m u d i d a̠
유인원	j uː i n w ʌ̹ n
삿포로	sʰ a̠ t̚ pʰ o̞ ɾ o̞
반값	p a̠ n ɡ a̠ p̚
오목하다	o̞ m o̞ kʰ a̠ d a̠
풍속	pʰ u ŋ sʰ o̞ k̚
펃	pʰ ʌ̹ t̚
폋	pʰ j ʌ̹ t̚
소제	sʰ o̞ː d͡ʑ e̞
적용되다	t͡ɕ ʌ̹ ɡ j o ŋ d w e̞ d a̠
뽈스까	p͈ o̞ ɭ sʰ ɯ k͈ a̠
바깥쪽	p a̠ k͈ a̠ t̚ t͡ɕ͈ o̞ k̚
요술	j o sʰ u ɭ
수출품	sʰ u t͡ɕʰ u ɭ pʰ u m
발견되다	p a̠ ɭ ɡ j ʌ̹ n d w e̞ d a̠
서구	sʰ ʌ̹ ɡ u
경상북도	k j ɘː ŋ sʰ a̠ ŋ b u k̚ t͈ o̞
브라질	p ɯ ɾ a̠ d͡ʑ i ɭ
돗자리	t o̞ t̚ t͡ɕ͈ a̠ ɾ i
후베이	ɸʷ u b e̞ i
선종	sʰ ʌ̹ ɲ d͡ʑ o̞ ŋ
떨다	t͈ ɘː ɭ d a̠
갖추다	k a̠ t̚ t͡ɕʰ u d a̠
올	o̞ ɭ
흘	x ɯ ɭ
의례	ɰ i ɾ j e̞
춤	t͡ɕʰ u m
멧닭	m e̞ t̚ t͈ a̠ k̚
강퍅하다	k a̠ ŋ pʰ j a̠ kʰ a̠ d a̠
회상	ɸ w e̞ sʰ a̠ ŋ
망둑	m a̠ ŋ d u k̚
쓰다듬다	s͈ ɯ d a̠ d ɯ m d a̠
두통	t u tʰ o̞ ŋ
곈	k j e̞ n
도중	t o̞ː d͡ʑ u ŋ
보상하다	p o̞ː sʰ a̠ ŋ ɦ a̠ d a̠
곡물	k o̞ ŋ m u ɭ
쏜살같이	s͈ o̞ n sʰ a̠ ɭ ɡ a̠ t͡ɕʰ i
없어지다	ɘː p s͈ ʌ̹ d͡ʑ i d a̠
강화하다	k a̠ ŋ β w a̠ ɦ a̠ d a̠
왕좌	w a̠ ŋ d͡ʑ w a̠
달다	t a̠ː ɭ d a̠
레루	ɾ e̞ː ɾ u
결정짓다	k j ʌ̹ ʎ t͡ɕ͈ ʌ̹ ŋ d͡ʑ i t̚ t͈ a̠
온통	o̞ː n tʰ o̞ ŋ
충성	t͡ɕʰ u ŋ sʰ ʌ̹ ŋ
쯤	t͡ɕ͈ ɯ m
오르되브르	o̞ ɾ ɯ d w e̞ b ɯ ɾ ɯ
원자	w ʌ̹ ɲ d͡ʑ a̠
부피	p u pʰ i
껌	k͈ ʌ̹ m
살인자	sʰ a̠ ɾ i ɲ d͡ʑ a̠
도기	t o̞ ɡ i
뜰	t͈ ɯ ɭ
이러쿵저러쿵	i ɾ ʌ̹ kʰ u ŋ d͡ʑ ʌ̹ ɾ ʌ̹ kʰ u ŋ
비슈케크	p i ɕʰ u kʰ e̞ k x ɯ
국제보조어	k uː k̚ t͡ɕ͈ e̞ b o̞ d͡ʑ o̞ ʌ̹
갇히다	k a̠ tʰ i d a̠
명하다	m j ɘː ŋ ɦ a̠ d a̠
귀두	k ɥ i d u
금요일	k ɯ m j o i ɭ
발바리차	p a̠ː ɭ b a̠ ɾ i t͡ɕʰ a̠
풍령	pʰ u ŋ ɲ j ʌ̹ ŋ
여겨지다	j ʌ̹ ɡ j ʌ̹ d͡ʑ i d a̠
학년	h a̠ ŋ ɲ j ʌ̹ n
입천장	i p̚ t͡ɕʰ ʌ̹ ɲ d͡ʑ a̠ ŋ
주문	t͡ɕ uː m u n
콩나물	kʰ o̞ ŋ n a̠ m u ɭ
학식	h a̠ k ɕ͈ i k̚
황금	ɸ w a̠ ŋ ɡ ɯ m
사마륨	sʰ a̠ m a̠ ɾ j u m
비늘흰발망둑	p i n ɯ ɾ ʝ i n b a̠ ɭ m a̠ ŋ d u k̚
널다	n ɘː ɭ d a̠
친절	t͡ɕʰ i ɲ d͡ʑ ʌ̹ ɭ
찌창	t͡ɕ͈ i t͡ɕʰ a̠ ŋ
접수하다	t͡ɕ ʌ̹ p s͈ u ɦ a̠ d a̠
구름다리	k u ɾ ɯ m d a̠ ɾ i
단위	t a̠ n ɥ i
플루트	pʰ ɯ ɭ ɭ u tʰ ɯ
천만에요	t͡ɕʰ ʌ̹ n m a̠ n e̞ j o
순흥	sʰ u n ɣ ɯ ŋ
수심	sʰ u ɕʰ i m
영상	j ʌ̹ ŋ sʰ a̠ ŋ
묵은지	m u ɡ ɯ ɲ d͡ʑ i
황동	ɸ w a̠ ŋ d o̞ ŋ
문구	m u n ɡ u
령도자	ɾ j ʌ̹ ŋ d o̞ d͡ʑ a̠
경치	k j ʌ̹ ŋ t͡ɕʰ i
사기죄	sʰ a̠ ɡ i d͡ʑ w e̞
텐구	tʰ e̞ n ɡ u
테레비	tʰ e̞ ɾ e̞ b i
늘	n ɯ ɭ
선전	sʰ ɘː ɲ d͡ʑ ʌ̹ n
사	sʰ a̠
모이	m o̞ i
유희	j u ʝ i
카브	kʰ a̠ b ɯ
마케도니아	m a̠ kʰ e̞ d o̞ n i a̠
교미하다	k j o m i ɦ a̠ d a̠
다소	t a̠ sʰ o̞
활발하다	ɸ w a̠ ɭ b a̠ ɾ ɦ a̠ d a̠
야망	j a̠ː m a̠ ŋ
광선	k w a̠ ŋ sʰ ʌ̹ n
습격	sʰ ɯ p̚ k͈ j ʌ̹ k̚
걸어가다	k ʌ̹ ɾ ʌ̹ ɡ a̠ d a̠
정직	t͡ɕ ɘː ŋ d͡ʑ i k̚
표면장력	pʰ j o m j ʌ̹ ɲ d͡ʑ a̠ ŋ ɲ j ʌ̹ k̚
간곡	k a̠ː n ɡ o̞ k̚
우러러보다	u ɾ ʌ̹ ɾ ʌ̹ b o̞ d a̠
교역	k j o j ʌ̹ k̚
봉급	p o̞ː ŋ ɡ ɯ p̚
스피커	s͈ ɯ pʰ i kʰ ʌ̹
만년	m a̠ː n ɲ j ʌ̹ n
패전	pʰ ɛː d͡ʑ ʌ̹ n
묠니르	m j o ʎ ʎ i ɾ ɯ
지린	t͡ɕ i ɾ i n
누쿠알로파	n u kʰ u a̠ ɭ ɭ o̞ pʰ a̠
식량	ɕʰ i ŋ ɲ j a̠ ŋ
구슬	k u sʰ ɯ ɭ
구강	k u ɡ a̠ ŋ
천부	t͡ɕʰ ʌ̹ n b u
숙련자	sʰ u ŋ ɲ j ʌ̹ ɲ d͡ʑ a̠
느낌	n ɯ k͈ i m
악력	a̠ ŋ ɲ j ʌ̹ k̚
계절	k j e̞ː d͡ʑ ʌ̹ ɭ
메가나	m e̞ ɡ a̠ n a̠
에터	e̞ tʰ ʌ̹
미사일	m i sʰ a̠ i ɭ
이란	i ɾ a̠ n
굳이	k u d͡ʑ i
금지하다	k ɯː m d͡ʑ i ɦ a̠ d a̠
전구	t͡ɕ ɘː n ɡ u
민서	m i n s͈ ʌ̹
검은딸기	k ʌ̹ m ɯ n t͈ a̠ ɭ ɡ i
판권	pʰ a̠ n ɡ w ʌ̹ n
살결	sʰ a̠ ɭ ɡ j ʌ̹ ɭ
중성자	t͡ɕ u ŋ sʰ ʌ̹ ŋ d͡ʑ a̠
불안	p u ɾ a̠ n
광초	k w a̠ ŋ t͡ɕʰ o̞
제국주의	t͡ɕ e̞ː ɡ u k̚ t͡ɕ͈ u ɰ i
활용	ɸ w a̠ ɾ j o ŋ
파이	pʰ a̠ i
종어	t͡ɕ o̞ ŋ ʌ̹
박	p a̠ k̚
잉여	iː ŋ j ʌ̹
화요일	ɸ w a̠ j o i ɭ
문제점	m u ɲ d͡ʑ e̞ d͡ʑ ʌ̹ m
피라미	pʰ i ɾ a̠ m i
상놈	sʰ a̠ ŋ n o̞ m
면적	m j ɘː ɲ d͡ʑ ʌ̹ k̚
우펀국	u pʰ ʌ̹ n ɡ u k̚
열일곱	j ʌ̹ ʎ ʎ i ɭ ɡ o̞ p̚
바알	p a̠ a̠ ɭ
망간	m a̠ ŋ ɡ a̠ n
답장	t a̠ p̚ t͡ɕ͈ a̠ ŋ
철	t͡ɕʰ ʌ̹ ɭ
득도하다	t ɯ k̚ t͈ o̞ ɦ a̠ d a̠
정비	t͡ɕ ɘː ŋ b i
무서워하다	m u sʰ ʌ̹ w ʌ̹ ɦ a̠ d a̠
지불하다	t͡ɕ i b u ɾ ɦ a̠ d a̠
섹시하다	sʰ e̞ k ɕ͈ i ɦ a̠ d a̠
입맞춤	i m m a̠ t̚ t͡ɕʰ u m
새	sʰ ɛː
자세하다	t͡ɕ a̠ sʰ e̞ ɦ a̠ d a̠
수평선	sʰ u pʰ j ʌ̹ ŋ sʰ ʌ̹ n
고모	k o̞ m o̞
발자국	p a̠ ʎ t͡ɕ͈ a̠ ɡ u k̚
물통	m u ɭ tʰ o̞ ŋ
간쑤	k a̠ n s͈ u
신탁통치	ɕʰ i n tʰ a̠ k̚ tʰ o̞ ŋ t͡ɕʰ i
성병	sʰ ɘː ŋ p͈ j ʌ̹ ŋ
멜라닌	m e̞ ɭ ɭ a̠ n i n
생	sʰ ɛː ŋ
세우다	sʰ e̞ u d a̠
조치	t͡ɕ o̞ t͡ɕʰ i
몽롱	m o̞ ŋ n o̞ ŋ
심성	ɕʰ i m sʰ ʌ̹ ŋ
제논	t͡ɕ e̞ n o̞ n
정확하다	t͡ɕ ɘː ŋ β w a̠ kʰ a̠ d a̠
숙주나물	sʰ u k̚ t͡ɕ͈ u n a̠ m u ɭ
ᆸ시다	p ɕ͈ i d a̠
평양	pʰ j ʌ̹ ŋ j a̠ ŋ
탄환	tʰ a̠ː n β w a̠ n
코발트	kʰ o̞ b a̠ ɭ tʰ ɯ
담담하다	t a̠ m d a̠ m ɦ a̠ d a̠
폭넓다	pʰ o̞ ŋ n ʌ̹ ɭ t͈ a̠
악덕	a̠ k̚ t͈ ʌ̹ k̚
강추	k a̠ ŋ t͡ɕʰ u
불바다	p u ɭ b a̠ d a̠
분자	p u ɲ d͡ʑ a̠
주판	t͡ɕ uː pʰ a̠ n
끌리다	k͈ ɯː ʎ ʎ i d a̠
건조기	k ʌ̹ ɲ d͡ʑ o̞ ɡ i
더블유	t͈ ʌ̹ b ɯ ʎ ʎ j u
일화	i ɾ β w a̠
그르치다	k ɯ ɾ ɯ t͡ɕʰ i d a̠
돼지꿈	t w ɛː d͡ʑ i k͈ u m
뼘	p͈ j ɘː m
유리하다	j uː ɾ i ɦ a̠ d a̠
감상	k a̠ m sʰ a̠ ŋ
평판	pʰ j ɘː ŋ pʰ a̠ n
표고	pʰ j o ɡ o̞
혹여나	ɸʷ o̞ ɡ j ʌ̹ n a̠
당연히	t a̠ ŋ j ʌ̹ n ʝ i
범주	p ɘː m d͡ʑ u
멜로디	m e̞ ɭ ɭ o̞ d i
생방송	sʰ ɛː ŋ b a̠ ŋ sʰ o̞ ŋ
밖에	p a̠ k͈ e̞
불도저	p u ɭ d o̞ d͡ʑ ʌ̹
누르다	n uː ɾ ɯ d a̠
근교	k ɯː n ɡ j o
거절하다	k ɘː d͡ʑ ʌ̹ ɾ ɦ a̠ d a̠
위탁	ɥ i tʰ a̠ k̚
굴곡위	k u ɭ ɡ o̞ ɡ ɥ i
로고	ɾ o̞ ɡ o̞
위구르어	ɥ i ɡ u ɾ ɯ ʌ̹
늦다	n ɯ t̚ t͈ a̠
안타깝다	a̠ n tʰ a̠ k͈ a̠ p̚ t͈ a̠
김일성화	k i m i ɭ sʰ ʌ̹ ŋ β w a̠
리듬	ɾ i d ɯ m
의견	ɰ iː ɡ j ʌ̹ n
헌병	h ɘː n b j ʌ̹ ŋ
자외선	t͡ɕ a̠ː w e̞ sʰ ʌ̹ n
그루지야	k ɯ ɾ u d͡ʑ i j a̠
뙤약볕	t͈ w e̞ j a̠ k̚ p͈ j ʌ̹ t̚
자유롭다	t͡ɕ a̠ j u ɾ o̞ p̚ t͈ a̠
홍어	ɸʷ o̞ ŋ ʌ̹
국회의원	k u kʰ w e̞ ɰ i w ʌ̹ n
전선	t͡ɕ ʌ̹ n sʰ ʌ̹ n
입방체	i p̚ p͈ a̠ ŋ t͡ɕʰ e̞
증가하다	t͡ɕ ɯ ŋ ɡ a̠ ɦ a̠ d a̠
아프로디테	a̠ pʰ ɯ ɾ o̞ d i tʰ e̞
거주하다	k ʌ̹ d͡ʑ u ɦ a̠ d a̠
님	n i m
교섭	k j o sʰ ʌ̹ p̚
관련	k w a̠ ʎ ʎ j ʌ̹ n
통증	tʰ o̞ː ŋ d͡ʑ ɯ ŋ
소녀	sʰ o̞ː ɲ j ʌ̹
비숍	p i ɕʰ o p̚
수십	sʰ uː ɕʰ i p̚
루마니아	ɾ u m a̠ n i a̠
납량	n a̠ m ɲ j a̠ ŋ
깁다	k iː p̚ t͈ a̠
해고하다	h ɛː ɡ o̞ ɦ a̠ d a̠
불편	p u ɭ pʰ j ʌ̹ n
구마모또	k u m a̠ m o̞ t͈ o̞
줄곧	t͡ɕ u ɭ ɡ o̞ t̚
정상치	t͡ɕ ɘː ŋ sʰ a̠ ŋ t͡ɕʰ i
국가	k u k̚ k͈ a̠
묘	m j o
진주	t͡ɕ i ɲ d͡ʑ u
번데기	p ʌ̹ n d e̞ ɡ i
헝가리	h ʌ̹ ŋ ɡ a̠ ɾ i
하프늄	h a̠ pʰ ɯ ɲ j u m
성공하다	sʰ ʌ̹ ŋ ɡ o̞ ŋ ɦ a̠ d a̠
춘하추동	t͡ɕʰ u n ɦ a̠ t͡ɕʰ u d o̞ ŋ
엿기름	j ʌ̹ t̚ k͈ i ɾ ɯ m
울리짜	u ʎ ʎ i t͡ɕ͈ a̠
무려	m u ɾ j ʌ̹
전세	t͡ɕ ʌ̹ n sʰ e̞
쇠풀	sʰ w e̞ pʰ u ɭ
약혼	j a̠ kʰ o̞ n
곱셈	k o̞ p s͈ e̞ m
비극	p iː ɡ ɯ k̚
받아들이다	p a̠ d a̠ d ɯ ɾ i d a̠
틈	tʰ ɯ m
도적	t o̞ d͡ʑ ʌ̹ k̚
체형	t͡ɕʰ e̞ ʝ j ʌ̹ ŋ
근면하다	k ɯː n m j ʌ̹ n ɦ a̠ d a̠
논병아리	n o̞ n b j ʌ̹ ŋ a̠ ɾ i
전투	t͡ɕ ʌ̹ n tʰ u
도교	t o̞ː ɡ j o
신뢰	ɕʰ iː ɭ ɭ w e̞
대기업	t ɛː ɡ i ʌ̹ p̚
이응	i ɯ ŋ
변이하다	p j ɘː n i ɦ a̠ d a̠
복음서	p o̞ ɡ ɯ m sʰ ʌ̹
거실	k ʌ̹ ɕʰ i ɭ
법가	p ɘː p̚ k͈ a̠
국민학교	k u ŋ m i n ɦ a̠ k̚ k͈ j o
월드컵	w ʌ̹ ɭ d ɯ kʰ ʌ̹ p̚
발코니	p a̠ ɭ kʰ o̞ n i
화장지	ɸ w a̠ d͡ʑ a̠ ŋ d͡ʑ i
바리	p a̠ ɾ i
지사	t͡ɕ i sʰ a̠
부정하다	p u d͡ʑ ʌ̹ ŋ ɦ a̠ d a̠
바오즈	p a̠ o̞ d͡ʑ ɯ
저렇게	t͡ɕ ʌ̹ ɾ ʌ̹ kʰ e̞
파벌	pʰ a̠ b ʌ̹ ɭ
감숙	k a̠ m sʰ u k̚
속	sʰ o̞ː k̚
밀당	m i ɭ t͈ a̠ ŋ
나누이다	n a̠ n u i d a̠
카인	kʰ a̠ i n
평화롭다	pʰ j ʌ̹ ŋ β w a̠ ɾ o̞ p̚ t͈ a̠
중학교	t͡ɕ u ŋ ɦ a̠ k̚ k͈ j o
폭풍	pʰ o̞ k̚ pʰ u ŋ
사이시옷	sʰ a̠ i ɕʰ i o̞ t̚
행복하다	h ɛː ŋ b o̞ kʰ a̠ d a̠
동역학	t o̞ ŋ j ʌ̹ kʰ a̠ k̚
러더포듐	ɾ ʌ̹ d ʌ̹ pʰ o̞ d j u m
도표	t o̞ pʰ j o
낯익다	n a̠ n n i k̚ t͈ a̠
설치하다	sʰ ʌ̹ ʎ t͡ɕʰ i ɦ a̠ d a̠
장수	t͡ɕ a̠ ŋ sʰ u
릴	ɾ i ɭ
메소드	m e̞ sʰ o̞ d ɯ
대형	t ɛː ʝ j ʌ̹ ŋ
미하일	m i ɦ a̠ i ɭ
기어가다	k i ʌ̹ ɡ a̠ d a̠
불타	p u ɭ tʰ a̠
소주	s͈ o̞ d͡ʑ u
연결하다	j ʌ̹ n ɡ j ʌ̹ ɾ ɦ a̠ d a̠
닿소리	t a̠ s͈ o̞ ɾ i
유리기	j u ɾ i ɡ i
체모	t͡ɕʰ e̞ m o̞
투아례	tʰ u a̠ ɾ j e̞
창원	t͡ɕʰ a̠ ŋ w ʌ̹ n
덱스트린	t e̞ k s͈ ɯ tʰ ɯ ɾ i n
센터	sʰ e̞ n tʰ ʌ̹
화성	ɸ w a̠ː sʰ ʌ̹ ŋ
당구	t a̠ ŋ ɡ u
의의	ɰ iː ɰ i
비김	p iː ɡ i m
깊다	k i p̚ t͈ a̠
뜻하다	t͈ ɯ tʰ a̠ d a̠
못	m o̞ t̚
남미	n a̠ m m i
위증	ɥ i d͡ʑ ɯ ŋ
시합	ɕʰ i ɦ a̠ p̚
예니레	j e̞ n i ɾ e̞
잘다	t͡ɕ a̠ ɭ d a̠
한마디	h a̠ n m a̠ d i
딜	t i ɭ
광야	k w a̠ː ŋ j a̠
어머님	ʌ̹ m ʌ̹ n i m
친족	t͡ɕʰ i ɲ d͡ʑ o̞ k̚
미누스	m i n u sʰ ɯ
토나멘트	tʰ o̞ː n a̠ m e̞ n tʰ ɯ
바티칸	p a̠ tʰ i kʰ a̠ n
지명	t͡ɕ i m j ʌ̹ ŋ
반딧불	p a̠ n d i t̚ p͈ u ɭ
퓨란	pʰ j u ɾ a̠ n
아이스크림	a̠ i sʰ ɯ k x ɯ ɾ iː m
세인트조지스	sʰ e̞ i n tʰ ɯ d͡ʑ o̞ d͡ʑ i sʰ ɯ
발라드	p a̠ ɭ ɭ a̠ d ɯ
무료	m u ɾ j o
카르보닐기	kʰ a̠ ɾ ɯ b o̞ n i ɭ ɡ i
글	k ɯ ɭ
산동	sʰ a̠ n d o̞ ŋ
십오	ɕʰ i b o̞
운전사	uː ɲ d͡ʑ ʌ̹ n sʰ a̠
달마다	t a̠ ɭ m a̠ d a̠
속담	sʰ o̞ k̚ t͈ a̠ m
프린터	pʰ ɯ ɾ i n tʰ ʌ̹
엿	j ʌ̹ t̚
신경	ɕʰ i n ɡ j ʌ̹ ŋ
헤로인	h e̞ ɾ o̞ i n
출연	t͡ɕʰ u ɾ j ʌ̹ n
세르비아	s͈ e̞ ɾ ɯ b i a̠
친근하다	t͡ɕʰ i n ɡ ɯ n ɦ a̠ d a̠
성당	sʰ ɘː ŋ d a̠ ŋ
간성	k a̠ n sʰ ʌ̹ ŋ
마리화나	m a̠ ɾ i β w a̠ n a̠
사위	sʰ a̠ ɥ i
동갑	t o̞ ŋ ɡ a̠ p̚
친밀	t͡ɕʰ i n m i ɭ
꼬리표	k͈ o̞ ɾ i pʰ j o
웃다	uː t̚ t͈ a̠
인구	i n ɡ u
해롭다	h ɛː ɾ o̞ p̚ t͈ a̠
얼리다	ʌ̹ ʎ ʎ i d a̠
체코	t͡ɕʰ e̞ kʰ o̞
포기	pʰ o̞ ɡ i
핀란드	pʰ i ɭ ɭ a̠ n d ɯ
스테아르산	sʰ ɯ tʰ e̞ a̠ ɾ ɯ sʰ a̠ n
어룡	ʌ̹ ɾ j o ŋ
건물	k ɘː n m u ɭ
아미노산	a̠ m i n o̞ sʰ a̠ n
요람본	j o ɾ a̠ m b o̞ n
환락	ɸ w a̠ ɭ ɭ a̠ k̚
대체로	t ɛː t͡ɕʰ e̞ ɾ o̞
넓다	n ʌ̹ ɭ t͈ a̠
니카라과	n i kʰ a̠ ɾ a̠ ɡ w a̠
진열장	t͡ɕ iː ɲ j ʌ̹ ʎ d͡ʑ a̠ ŋ
평의회	pʰ j ɘː ŋ ɰ i β w e̞
체념	t͡ɕʰ e̞ ɲ j ʌ̹ m
평정	pʰ j ʌ̹ ŋ d͡ʑ ʌ̹ ŋ
맛있다	m a̠ ɕʰ i t̚ t͈ a̠
폴로늄	pʰ o̞ ɭ ɭ o̞ ɲ j u m
조약	t͡ɕ o̞ j a̠ k̚
찬사	t͡ɕʰ a̠ː n sʰ a̠
싱	ɕʰ i ŋ
천성	t͡ɕʰ ʌ̹ n sʰ ʌ̹ ŋ
나치즘	n a̠ t͡ɕʰ i d͡ʑ ɯ m
체커	t͡ɕʰ e̞ kʰ ʌ̹
소용	sʰ o̞ː j o ŋ
날다	n a̠ ɭ d a̠
필통	pʰ i ɭ tʰ o̞ ŋ
사다	sʰ a̠ d a̠
여자친구	j ʌ̹ d͡ʑ a̠ t͡ɕʰ i n ɡ u
표어	pʰ j o ʌ̹
얼마나	ʌ̹ ɭ m a̠ n a̠
연락처	j ʌ̹ ɭ ɭ a̠ k̚ t͡ɕʰ ʌ̹
스텝	sʰ ɯ tʰ e̞ p̚
니케아	n i kʰ e̞ a̠
혼돈	ɸʷ o̞ n d o̞ n
그	k ɯ
두서너	t u sʰ ʌ̹ n ʌ̹
구하다	k u ɦ a̠ d a̠
새똥	sʰ ɛː t͈ o̞ ŋ
침묵	t͡ɕʰ i m m u k̚
우편함	u pʰ j ʌ̹ n ɦ a̠ m
가련하다	k a̠ː ɾ j ʌ̹ n ɦ a̠ d a̠
페르뮴	pʰ e̞ ɾ ɯ m j u m
망고	m a̠ ŋ ɡ o̞
페미니즘	pʰ e̞ m i n i d͡ʑ ɯ m
석방	sʰ ʌ̹ k̚ p͈ a̠ ŋ
는지	n ɯ ɲ d͡ʑ i
정치인	t͡ɕ ʌ̹ ŋ t͡ɕʰ i i n
혹여	ɸʷ o̞ ɡ j ʌ̹
심사	ɕʰ i m sʰ a̠
고무	k o̞ m u
유방	j u b a̠ ŋ
공수병	k o̞ː ŋ sʰ u b j ʌ̹ ŋ
보이프렌드	p o̞ i pʰ ɯ ɾ e̞ n d ɯ
볶다	p o̞ k̚ t͈ a̠
대학원	t ɛː ɦ a̠ ɡ w ʌ̹ n
담박하다	t a̠ m b a̠ kʰ a̠ d a̠
뽑히다	p͈ o̞ pʰ i d a̠
걸다	k ɘː ɭ d a̠
짐바브웨	t͡ɕ i m b a̠ b ɯ w e̞
바	p͈ a̠
모스크	m o̞ sʰ ɯ k x ɯ
천장	t͡ɕʰ ʌ̹ ɲ d͡ʑ a̠ ŋ
그렇게	k ɯ ɾ ʌ̹ kʰ e̞
기숙사	k i sʰ u k s͈ a̠
본능	p o̞ n n ɯ ŋ
근시	k ɯː n ɕʰ i
씌우다	ɕ͈ i u d a̠
숭	sʰ u ŋ
야차	j a̠ t͡ɕʰ a̠
버클	p ʌ̹ k x ɯ ɭ
피씨방	pʰ i ɕ͈ i b a̠ ŋ
평균	pʰ j ʌ̹ ŋ ɡ j u n
급기야	k ɯ p̚ k͈ i j a̠
골다	k o̞ː ɭ d a̠
섬네일	sʰ ʌ̹ m n e̞ i ɭ
일기	i ɭ ɡ i
남비	n a̠ m b i
한잔	h a̠ ɲ d͡ʑ a̠ n
또한	t͈ o̞ ɦ a̠ n
풀리다	pʰ u ʎ ʎ i d a̠
공병	k o̞ ŋ b j ʌ̹ ŋ
말레이시아	m a̠ ɭ ɭ e̞ i ɕʰ i a̠
불상놈	p uː ɭ sʰ a̠ ŋ n o̞ m
수조	sʰ u d͡ʑ o̞
수말	sʰ u m a̠ ɭ
한라산	h a̠ ɭ ɭ a̠ sʰ a̠ n
짜다	t͡ɕ͈ a̠ d a̠
가면극	k a̠ː m j ʌ̹ n ɡ ɯ k̚
께	k͈ e̞
아마도	a̠ m a̠ d o̞
천국	t͡ɕʰ ʌ̹ n ɡ u k̚
가슴뼈	k a̠ sʰ ɯ m p͈ j ʌ̹
윈난	ɥ i n n a̠ n
자위하다	t͡ɕ a̠ ɥ i ɦ a̠ d a̠
임명	i m m j ʌ̹ ŋ
몰다	m o̞ː ɭ d a̠
포도탄	pʰ o̞ d o̞ tʰ a̠ n
피폭자	pʰ i pʰ o̞ k̚ t͡ɕ͈ a̠
빨다	p͈ a̠ ɭ d a̠
통근	tʰ o̞ ŋ ɡ ɯ n
순수	sʰ u n sʰ u
기준	k i d͡ʑ u n
명자	m j ʌ̹ ŋ t͡ɕ͈ a̠
쫄면	t͡ɕ͈ o̞ ɭ m j ʌ̹ n
사시	sʰ a̠ ɕʰ i
접촉	t͡ɕ ʌ̹ p̚ t͡ɕʰ o̞ k̚
시간표	ɕʰ i ɡ a̠ n pʰ j o
탈린	tʰ a̠ ʎ ʎ i n
도합	t o̞ ɦ a̠ p̚
관리	k w a̠ ʎ ʎ i
줄납자루	t͡ɕ u ɭ ɭ a̠ p̚ t͡ɕ͈ a̠ ɾ u
비판적	p iː pʰ a̠ ɲ d͡ʑ ʌ̹ k̚
픙	pʰ ɯ ŋ
낡	n a̠ k̚
열병	j ʌ̹ ɭ b j ʌ̹ ŋ
상아	sʰ a̠ ŋ a̠
어긋나다	ʌ̹ ɡ ɯ n n a̠ d a̠
속삭이다	sʰ o̞ k s͈ a̠ ɡ i d a̠
집중하다	t͡ɕ i p̚ t͡ɕ͈ u ŋ ɦ a̠ d a̠
우박	uː b a̠ k̚
양주	j a̠ ŋ d͡ʑ u
그늘지다	k ɯ n ɯ ʎ d͡ʑ i d a̠
수영장	sʰ u j ʌ̹ ŋ d͡ʑ a̠ ŋ
피통	pʰ i tʰ o̞ ŋ
함량	h a̠ m ɲ j a̠ ŋ
방학	p a̠ ŋ ɦ a̠ k̚
불과하다	p u ɭ ɡ w a̠ ɦ a̠ d a̠
실험	ɕʰ i ɾ ɦ ʌ̹ m
특별하다	tʰ ɯ k̚ p͈ j ʌ̹ ɾ ɦ a̠ d a̠
의존증	ɰ i d͡ʑ o̞ ɲ d͡ʑ ɯ ŋ
캄판	kʰ a̠ m pʰ a̠ n
느끼다	n ɯ k͈ i d a̠
조심스럽다	t͡ɕ o̞ː ɕʰ i m sʰ ɯ ɾ ʌ̹ p̚ t͈ a̠
친구	t͡ɕʰ i n ɡ u
퍼브	pʰ ʌ̹ b ɯ
산양	sʰ a̠ ɲ j a̠ ŋ
획	ɸ w e̞ k̚
나사	n a̠ sʰ a̠
저금통	t͡ɕ ɘː ɡ ɯ m tʰ o̞ ŋ
발기다	p a̠ ɭ ɡ i d a̠
먐	m j a̠ m
군함조	k u n ɦ a̠ m d͡ʑ o̞
불구	p u ɭ ɡ u
안락의자	a̠ ɭ ɭ a̠ ɡ ɰ i d͡ʑ a̠
신뢰하다	ɕʰ iː ɭ ɭ w e̞ ɦ a̠ d a̠
고기	k o̞ː ɡ i
전염병	t͡ɕ ʌ̹ ɲ j ʌ̹ m b j ʌ̹ ŋ
불면증	p u ɭ m j ʌ̹ ɲ t͡ɕ͈ ɯ ŋ
육체	j u k̚ t͡ɕʰ e̞
나근나근	n a̠ ɡ ɯ n n a̠ ɡ ɯ n
아라비아	a̠ ɾ a̠ b i a̠
거북선	k ʌ̹ b u k s͈ ʌ̹ n
잘되다	t͡ɕ a̠ ɭ d w e̞ d a̠
흑인	x ɯ ɡ i n
더구나	t ʌ̹ ɡ u n a̠
퇴직금	tʰ w e̞ː d͡ʑ i k̚ k͈ ɯ m
끝나다	k͈ ɯ n n a̠ d a̠
대서양	t ɛː sʰ ʌ̹ j a̠ ŋ
목장	m o̞ k̚ t͡ɕ͈ a̠ ŋ
가장자리	k a̠ː d͡ʑ a̠ ŋ d͡ʑ a̠ ɾ i
아프리카	a̠ pʰ ɯ ɾ i kʰ a̠
남자아이	n a̠ m d͡ʑ a̠ a̠ i
아리수	a̠ ɾ i sʰ u
뒤따르다	t ɥ iː t͈ a̠ ɾ ɯ d a̠
타이타늄	tʰ a̠ i tʰ a̠ ɲ j u m
종합	t͡ɕ o̞ ŋ ɦ a̠ p̚
다운로드	t a̠ u n n o̞ d ɯ
펩	pʰ e̞ p̚
이러다	i ɾ ʌ̹ d a̠
차마당	t͡ɕʰ a̠ m a̠ d a̠ ŋ
뉴웁말	ɲ j u u m m a̠ ɭ
오롯하다	o̞ ɾ o̞ tʰ a̠ d a̠
꺽저기	k͈ ʌ̹ k̚ t͡ɕ͈ ʌ̹ ɡ i
축복하다	t͡ɕʰ u k̚ p͈ o̞ kʰ a̠ d a̠
된장녀	t w e̞ː ɲ d͡ʑ a̠ ŋ ɲ j ʌ̹
집단화	t͡ɕ i p̚ t͈ a̠ n β w a̠
멍텅구리	m ʌ̹ ŋ tʰ ʌ̹ ŋ ɡ u ɾ i
곱사연어	k o̞ p s͈ a̠ j ʌ̹ n ʌ̹
옴즈기다	o̞ m d͡ʑ ɯ ɡ i d a̠
악곡	a̠ k̚ k͈ o̞ k̚
미카엘	m i kʰ a̠ e̞ ɭ
코스모스	kʰ o̞ sʰ ɯ m o̞ sʰ ɯ
셔츠	ɕʰ ʌ̹ t͡ɕʰ ɯ
부탁하다	p uː tʰ a̠ kʰ a̠ d a̠
파티	pʰ a̠ tʰ i
인도양	i n d o̞ j a̠ ŋ
이집트	i d͡ʑ i p̚ tʰ ɯ
그제	k ɯ d͡ʑ e̞
노크하다	n o̞ k x ɯ ɦ a̠ d a̠
문의	m uː n ɰ i
주연	t͡ɕ u j ʌ̹ n
교반	k j o b a̠ n
네로	n e̞ ɾ o̞
종일	t͡ɕ o̞ ŋ i ɭ
이스탄불	i sʰ ɯ tʰ a̠ n b u ɭ
불안하다	p u ɾ a̠ n ɦ a̠ d a̠
기념품	k i ɲ j ʌ̹ m pʰ u m
나무라다	n a̠ m u ɾ a̠ d a̠
장기	t͡ɕ a̠ː ŋ ɡ i
조지타운	t͡ɕ o̞ d͡ʑ i tʰ a̠ u n
장치	t͡ɕ a̠ ŋ t͡ɕʰ i
아파트	a̠ pʰ a̠ tʰ ɯ
세종	sʰ e̞ d͡ʑ o̞ ŋ
끊임없다	k͈ ɯ n i m ʌ̹ p̚ t͈ a̠
타이머	tʰ a̠ i m ʌ̹
수산기	sʰ u sʰ a̠ n ɡ i
숙소	sʰ u k s͈ o̞
간질거리다	k a̠ ɲ d͡ʑ i ɭ ɡ ʌ̹ ɾ i d a̠
대학교	t ɛː ɦ a̠ k̚ k͈ j o
총알	t͡ɕʰ o̞ ŋ a̠ ɭ
어서	ʌ̹ sʰ ʌ̹
남한	n a̠ m ɦ a̠ n
욕망	j o ŋ m a̠ ŋ
험담	h ɘː m d a̠ m
동굴	t o̞ː ŋ ɡ u ɭ
가끔씩	k a̠ k͈ ɯ m ɕ͈ i k̚
그거	k ɯ ɡ ʌ̹
기만되다	k i m a̠ n d w e̞ d a̠
싫다	ɕʰ i ɭ tʰ a̠
인후	i n β u
탈북자	tʰ a̠ ɭ b u k̚ t͡ɕ͈ a̠
수프	sʰ u pʰ ɯ
음양	ɯ m j a̠ ŋ
말뚝	m a̠ ɭ t͈ u k̚
일없다	iː ɾ ʌ̹ p̚ t͈ a̠
메다	m e̞ː d a̠
쓰딸로바야	s͈ ɯ t͈ a̠ ɭ ɭ o̞ b a̠ j a̠
오직	o̞ d͡ʑ i k̚
괴물	k w e̞ː m u ɭ
공인	k o̞ ŋ i n
나	n a̠
팔다리	pʰ a̠ ɭ d a̠ ɾ i
몬순	m o̞ n sʰ u n
어요	ʌ̹ j o
심부름	ɕʰ iː m b u ɾ ɯ m
감초	k a̠ m t͡ɕʰ o̞