ذرية	ð u r r i j j a h
وعد	w a ʕ d
رأسمال	r a ʔ s m a l
أمس	ʔ a m a s s i
الآن	a l ʔ a n
عبوثران	ʕ a b a w θ a r a n
مقايسة	m u q a j a s a
أمس	ʔ u m a s s u
ركل	r a k l
حزم	ħ a z a m a
ع	ʕ
بوري	b u r i
مينا	m i n a
عند	ʕ i n d a
استعصم	i s t a ʕ sˤ a m a
مصنع	m a sˤ n a ʕ
مغزل	m i ɣ z a l
معارف	m a ʕ a r i f
عائلة	ʕ a ʔ i l a
سلح	s a l ħ
تواضع	t a w a dˤ u ʕ
شيص	ʃ i sˤ
كرفس	k a r a f s
أسهل	ʔ u s a h h i l
كبيكج	k a b i k a d͡ʒ
شاهد	ʃ a h a d a
مراجع	m u r a d͡ʒ i ʕ
دبار	d i b a r
عربي	ʕ a r a b i j j
بهيم	b a h i m
ريال	r i j a l
مكدس	m u k a d d i s
صهريج	sˤ i h r i d͡ʒ
شهوة	ʃ a h w a
أنف	ʔ a n f u
فحص	f a ħ a sˤ a
نظر	n a ðˤ ðˤ a r a
إهليلج	ʔ i h l i l a d͡ʒ
تمارة	t a m a r a
بلوة	b i l w a
كساء	k i s a ʔ
مناظرة	m u n a ðˤ a r a h
ضال	dˤ a l l
ولكن	w a l a k ɪ n
شخص	ʃ a x x a sˤ a
سذاب	s u ð a b
ترك	t a r a k a
سونكي	s u n k i j j
عصير	ʕ a sˤ i r
أنزروت	ʔ a n z a r u t
باع	b a ʕ a
حمار	ħ i m a r
حكمة	ħ a k a m a
أزرع	ʔ a z r a ʕ a
سحم	s a ħ i m a
مشوي	m a ʃ w i j j
قرد	q i r d
مكحلة	m u k ħ u l a
كامبوديا	k a m b o d i j a
ممسحة	m i m s a ħ a
مرو	m a r w
مطبخ	m a tˤ b a x
محسن	m u ħ a s s i n
نخل	n a x a l a
نازع	n a z i ʕ
معارضة	m u ʕ a r a dˤ a
انعقاد	i n ʕ i q a d
توغو	t o ɣ o
أوبرا	ʔ u b i r a
جادل	d͡ʒ a d a l a
بارد	b a r i d
غسل	ɣ a s a l a
أحسن	ʔ u ħ a s s a n u
سوء	s u ʔ
ماز	m a z a
انقلب	i n q a l a b a
حافلة	ħ a f i l a
أميرة	æ m i r a
مص	m a sˤ sˤ a
شاقول	ʃ a q u l
شج	ʃ a d͡ʒ i n
سعى	s a ʕ a
واحد	w a ħ i d
أمير	ʔ a m i r
شهلاء	ʃ a h l a ʔ
شبح	ʃ a b a ħ
جنى	d͡ʒ a n a
شمس	ʃ a m i s a
قارورة	q a r u r a
عزا	ʕ a z a
مكياج	m a k j a d͡ʒ
سنط	s a n tˤ
صعتر	sˤ a ʕ t a r
لباس	l i b a s
إقالة	ʔ i q a l a h
شاقولي	ʃ a q u l i j j
أنف	ʔ a n f i
ناخوذاة	n a x u ð a h
أسهر	ʔ a s h a r a
نور	n a w r
بحاح	b u ħ a ħ
صعب	sˤ a ʕ u b a
سنبوسج	s a m b u s a d͡ʒ
ذ	ð a l
دويبة	d u w a j b b a t u n
خبط	χ a bˤ tˤ
عض	ʕ a dˤ dˤ a
يسار	j a s a r
شبح	ʃ a b u ħ a
بشرية	b a ʃ a r i j j a
كوم	k a w m
نسرين	n i s r i n
زميلة	z a m i l a
معين	m u ʕ a j j i n
ناجود	n a d͡ʒ u d
نقض	n a q dˤ i
مشربة	m i ʃ r a b a
قروش	q u r u ʃ
فصح	f a sˤ ħ
طقم	tˤ a q m
رخاخ	r i x a x
تعطى	t a ʕ a tˤ tˤ a
سوق	s u ɡ
ثاقبايليث	θ a q b a j l i θ
أعجم	ʔ a ʕ d͡ʒ a m a
لأك	l a ʔ a k a
دنر	d a n n a r a
مشط	m a ʃ tˤ
تضمن	t a dˤ a m m u n
تحيز	t a ħ a w w a z a
ألماني	ʔ a l m a n i j j
يتيم	j a t i m
توكيد	t a w k i d
مؤسس	m u ʔ a s s a s
كيف	k a j f a
صبي	sˤ u b b i
عمود	ʕ a m u d
أزعر	ʔ a z ʕ a r
طالم	tˤ a l a m
أردني	ʔ u r d u n n i j j
ألا	ʔ a l l a
عتبات	ʕ a t a b a t
سامور	s a m u r
عاهل	ʕ a h i l
بيت	b a j j a t a
سلالة	s u l a l a
هم	h u m
فرغة	f a r i ɣ a
جزاء	d͡ʒ a z a ʔ
ألف	ʔ a l i f
منظمة	m u n a ðˤ ðˤ a m a
إغليق	ʔ i ɣ l i q
كويكب	k u w a j k i b
صنبور	sˤ u n b u r
أخضر	ʔ a x dˤ a r
الدانوب	a d d a n u b
مشعر	m a ʃ ʕ a r
شبح	ʃ a b a ħ a
طرق	tˤ u r u q
محافظ	m u ħ a f i ðˤ
م	m i m
جبن	d͡ʒ a b u n a
قنصلية	q u n sˤ u l i j j a
أما	ʔ a m m a
برق	b a r q
نتأ	n a t a ʔ a
غرب	ɣ a r u b a
انقضى	i n q a dˤ a
منجاة	m a n d͡ʒ a h
نظر	n a ðˤ a r
هدى	h u d a n
شماتة	ʃ a m a t a
أعور	ʔ a ʕ w a r
إعلام	ʔ i ʕ l a m
طريخ	tˤ i r r i x
طهران	tˤ a h r a n
قرفص	q a r f a sˤ a
وقف	w a q f
مرحبا	m a r ħ a b a
واو	w a w
صغر	sˤ a ɣ ɣ a r a
شجرة	ʃ a d͡ʒ a r a
انفتح	i n f a t a ħ a
ثمن	θ u m n
فص	f i sˤ sˤ
فرخ	f a r r a x a
ضأن	dˤ a ʔ n
ملوكيا	m u l u k i j j a
موتوسيكل	m o t o s i k i l
خيرات	x a j r a t
ذو	ð u
دكتور	d ɪ k t o r
سيجارة	s i ɡ a r a
سقيم	s a q i m
عادات	ʕ a d a t
شبرم	ʃ a b r a m
يورانيم	j u r a n j u m
تنفس	t a n f a s
عربن	ʕ a r b a n a
قداد	q u d a d
شخصيا	ʃ a x sˤ i j j a n
مئة	m i ʔ a
غرب	ɣ a r r a b a
تزامن	t a z a m u n
بطء	b u tˤ ʔ
ويكة	w a j k a
ويكة	w e k a
أنطاكية	ʔ a n tˤ a k i j j a
التقط	i l t a q a tˤ a
ليزر	l a j z i r
أدهش	ʔ u d h i ʃ
زوج	z a w w a d͡ʒ a
بدني	b a d a n i j j
تواقف	t a w a q a f a
دودة	d u d a
صاد	sˤ a d
حرق	ħ u r ɡ
فاصولياء	f a sˤ u l i j a ʔ
إله	ʔ i l a h
تقدم	t a q a d d u m
عال	ʕ a l i n
طاغوت	tˤ a ɣ u t
إبريسم	ʔ i b r a j s a m
حاك	ħ a k a
نهائي	n i h a ʔ i j j
إسبانيا	ʔ i s b a n i j a
علامة	ʕ a l a m a
نموذج	n a m u ð a d͡ʒ
مضض	m a dˤ a dˤ
عراء	ʕ a r a ʔ
شاء	ʃ a ʔ a
كنف	k a n a f
قسوة	q a s w a
صفة	sˤ i f a
عظيم	ʕ a ðˤ i m
طقس	tˤ a ɡ s
يتوع	j a t t u ʕ
حرف	ħ a r f
قصدير	q a sˤ d i r
تمرين	t a m r i n
وزنة	w a z n a
فلس	f i l s
تمساح	t ɪ m s æ ħ
أسهل	ʔ a s h u l u
حذار	ħ a ð a r i
فظع	f a ðˤ u ʕ a
رقم	r a q m
ماما	m a m a
سميذ	s a m i ð
فوشي	f u ʃ i j j
مزرعة	m a z r a ʕ a
ثقافة	t a q a f a
أشقر	ʔ a ʃ ɡ a r
عظم	ʕ i ðˤ a m
صهب	sˤ a h i b a
باكستان	b a k i s t a n
ليل	l a j l
فجأة	f a d͡ʒ ʔ a t a n
أبلس	ʔ a b l a s a
منير	m u n i r
زمج	z u m m a d͡ʒ
جو	d͡ʒ a w w
أشنان	ʔ u ʃ n a n
نشور	n u ʃ u r
قد	q a d d
زنة	z i n a
كراج	k a r a d͡ʒ
حصن	ħ u sˤ u n
هاته	h a t i h
سيارة	s a j j a r a
طبقات	tˤ a b a q a t
استلزم	i s t a l z a m a
واس	w a s
لجئ	l a d͡ʒ a ʔ a
تحليلي	t a ħ l i l i j j
لهذا	l i h æ ð æ
تنديل	t a n a d i l
مريء	m a r i ʔ
ذهب	ð a h a b
خسوف	x u s u f
وردة	w a r d a
كنز	k a n i z
مثل	m a θ a l a
عصف	ʕ a sˤ f
ثمانية	θ a m a n i j a
عواري	ʕ a w a r i j j
كركم	k u r k u m
استمرار	i s t i m r a r
قيقب	q a j q a b
شمبانيا	ʃ a m p a n j a
مقاس	m a q a s
لن	l a n
برذعة	b a r ð a ʕ a
وديعة	w a d i ʕ a
تدريجي	t a d r i d͡ʒ i j j
جندبادستر	d͡ʒ u n d u b a d a s t a r
أهدى	ʔ a h d a
فرخ	f a r x
تعشيقة	t a ʕ i ʃ i q a
جلنجبين	d͡ʒ u l l a n d͡ʒ u b i n
جبانات	d͡ʒ a b a n a t
شنع	ʃ a n u ʕ a
عزب	ʕ a z a b a
حصاة	ħ a sˤ a h
تفرغ	t a f a r r a ɣ a
تهدل	t a h a d d u l
تراوح	t a r a w u ħ
حدد	ħ a d d a d a
أعطى	ʔ a ʕ tˤ a
سمور	s a m m u r
معلم	m u ʕ l i m
هرة	h i r r a t u n
أكاف	ʔ u k a f
اهتدى	i h t a d a
القنيطرة	a l q u n a j tˤ i r a
انسل	i n s a l l a
نرجيل	n a r d͡ʒ i l
أحد	ʔ a ħ a d
انتقل	i n t a q a l a
تال	t a l i n
مقصر	m u q a sˤ sˤ i r
قسم	q a s m
فم	f a m
احترق	i ħ t a r a q a
مردي	m u r d i j j
قبض	q a b b a dˤ a
ملأك	m a l ʔ a k
قال	ɡ a l
قيطون	q i tˤ u n
قلوي	q a l a w i j j
مقذاف	m i q ð a f
سويسرا	s w i s r a
شلغم	ʃ a l ɣ a m
عمم	ʕ a m m a m a
مفرغ	m u f a r r a ɣ
لثة	l ɪ θ ɘ
انجراف	i n d͡ʒ i r a f
قنطر	q a n tˤ a r a
اقتطف	q a tˤ a f a
بطن	b a tˤ tˤ a n a
عظم	ʕ a ðˤ m
برواز	b a r w a z
برنيق	b a r n i q
منقض	m u n q i dˤ
قلعة	q i l ʕ a
أقرب	ʔ a q r a b a
تنفس	t u n a f f i s
شمع	ʃ a m ʕ
قرحة	q u r ħ a
نساب	n a s s a b
جين	d͡ʒ i n
ضرط	dˤ a r tˤ
أنكر	ʔ a n k a r a
شعير	ʃ a ʕ i r
دعسوقة	d u ʕ s u q a
سوفياتي	s o v j e t i j j
عتب	ʕ a t a b a
توقف	t a w a q q u f
فرنسا	f a r a n s a
تركمانستان	t u r k u m a n i s t a n
صدقة	sˤ a d a q a
طيهوج	tˤ a j h u d͡ʒ
عض	ʕ a dˤ dˤ
مجراف	m i d͡ʒ r a f
لوح	l a w ħ
نفوذ	n u f u ð
صارخ	sˤ ɑ r i x
أسيتون	ʔ a s i t u n
حمضي	ħ a m dˤ i j j
أكاذيب	ʔ a k a ð i b
بدلات	b a d a l a t
عوائد	ʕ a w a ʔ i d
سينثيا	s i n θ i j a
وسخ	w a s a x
ج	d͡ʒ i m
جنطيانا	d͡ʒ u n tˤ a j a n a
اجتنى	i d͡ʒ t a n a
أنت	ʔ a n t i
هريرة	h u r a j r a h
بن	b i n
تلميذ	t i l m i ð
شبوطة	ʃ a b b u tˤ a
اجتماعي	i d͡ʒ t i m a ʕ i j j
مغطس	m i ɣ tˤ a s
رساطون	r u s a tˤ u n
افغانستان	a f ɣ a n i s t a n
ملقن	m u l a q q i n
أخذ	ʔ a x a ð a
شرب	ʃ a r i b a
ورقة	w a r a q a
إلى	ʔ i l a
قبط	q u b tˤ
غلبة	ɣ a l u b b a
يوسف	j u s i f
بؤرة	b u ʔ r a
بتع	b i t ʕ
مبارز	m u b a r i z
أكل	ʔ a k l
صيد	sˤ a j d
نار	n a r
رام	r a m a
أغلب	ʔ a ɣ l i b u
أشم	ʔ a ʃ a m m a
وقع	w a q ʕ
طنطور	tˤ a n tˤ u r
شهلة	ʃ a h l a
خمسة	x a m s a
عنى	ʕ a n a
كوثر	k a w θ a r
إشفى	ʔ i ʃ f a
شنبر	ʃ a n b a r
فسح	f a s s a ħ a
قرطاجي	q a r tˤ a d͡ʒ i j j
هر	h i r r
دخل	d a x a l
خولنجان	x a w l a n d͡ʒ a n
ل	l i
أغلب	ʔ u ɣ a l l a b u
إمبريالي	ʔ i m b i r j a l i j j
قادر	q a d i r
عظم	ʕ a ðˤ ðˤ a m a
أهلا	ʔ a h l a n
جواهري	d͡ʒ a w a h i r i j j
إذ	ʔ i ð
معنى	m a ʕ n a
مكوك	m a k k u k
حمام	ħ i m a m
دماغي	d i m a ɣ i j j
مرحبا	m a r ħ a b a n
نشد	n a ʃ a d a
مئذنة	m i ʔ ð a n a
قليب	q a l i b
هذه	h a ð i h i
سوسة	s u s a
قبع	q a b a ʕ a
أعمدة	ʔ a ʕ m i d a
أتوبوس	ʔ o t o b u s
كرخ	k i r x
توج	t a w w a d͡ʒ a
السفن	a s s u f u n
أطلسي	ʔ a tˤ l a s i j j
سرجين	s i r d͡ʒ i n
زبرجد	z a b a r d͡ʒ a d
برج	b a r i d͡ʒ a
فوارة	f a w w a r a
قطارة	q a tˤ tˤ a r a
مطفأة	m i tˤ f a ʔ a
فولاذ	f u l a ð
قعد	q a ʕ a d a
جام	d͡ʒ a m
زرنب	z a r n a b
دلب	d u l b
كولومبيا	k o l o m b i j a
حقيقة	ħ a q i q a
زمزم	z a m z a m
أنور	ʔ a n w a r
خبز	x a b a z a
استهلك	i s t a h l a k a
صوف	sˤ a w w a f a
أصفاد	ʔ a sˤ f a d
جخى	d͡ʒ a x x a
مارس	m a r a s a
مؤمن	m u ʔ m i n
رضا	r i dˤ a n
سهل	s a h u l a
ظاء	ðˤ a ʔ
ساق	s a q a
قرب	q u r b a
ندى	n a d a
فرقاطة	f r ɡ a tˤ a
تشالة	t a ʃ a ʃ i l
مرتفع	m u r t a f a ʕ
ممسح	m u m a s s a ħ
تلفون	t i l i f u n
هاجم	h a d͡ʒ a m a
أحرج	ʔ a ħ r a d͡ʒ a
يوحنا	j u ħ a n n a
مغناطيسي	m a ɣ n a tˤ i s i j j
هزيز	h a z i z
تنفس	t u n a f f i s a
غادر	ɣ a d a r a
قماش	ɡ u m a ʃ
حرق	ħ a r a q a
أدان	ʔ a d a n a
دارفلفل	d a r f i l f i l
بحر	b a ħ r
مدام	m u d a m
عطاس	ʕ u tˤ a s
حق	ħ a q q a
زمزم	z a m z a m a
استرجع	i s t a r d͡ʒ a ʕ a
لغويات	l u ɣ a w i j j a t
سنت	s a n t
قدم	q a d i m a
فلنجة	f i l i n d͡ʒ a
عود	ʕ u d
مغناطيس	m i ɣ n a tˤ i s
ضائنة	dˤ a ʔ i n a
سموم	s u m u m
هما	h u m a
خبز	x a b z
شهدانج	ʃ a h d a n a d͡ʒ
خير	x a j r
جمعة	d͡ʒ u m ʕ a
تأوه	t a ʔ a w w a h a
فهم	f a h m
مركب	m a r k a b
طين	tˤ i n
بطء	b u tˤ u ʔ
أصفر	ʔ a sˤ f a r
قازاقستان	q a z a q i s t a n
كامل	k a m i l
محافظ	m u ħ a f a ðˤ
أبرز	ʔ a b r u z a
مخرفة	m a x r a f a
جملة	d͡ʒ u m l a
محاور	m u ħ a w i r
قصيبة	q u sˤ a j b a
انفرط	i n f a r a tˤ a
سفاح	s i f a ħ
برجل	b a r d͡ʒ a l
عاين	ʕ a j a n a
بطارقة	b a tˤ a r i q a
عجرم	ʕ u d͡ʒ r u m
مسطرات	m i s tˤ a r a t
ظهر	ðˤ a h h a r a
أولى	ʔ u l a
آل	ʔ a l
أودى	ʔ a w d a
طائرة	tˤ a ʔ i r a
لله	l i l l a h i
فطيسة	f i tˤ tˤ i s a
دلاع	d u l l a ʕ
مشارة	m a ʃ a r a
آية	ʔ a j a
لصق	l a sˤ i q a
حصاد	ħ a sˤ sˤ a d
تسعمائة	t i s ʕ u m i ʔ a
برمائي	b a r m a ʔ i j j
شمسي	ʃ a m s i j j
أرضي	ʔ a r dˤ i j j
مقارنة	m u q a r a n a
أشل	ʔ a ʃ a l l
شقوة	ʃ a q w a
باح	b a ħ a
مزج	m a z a d͡ʒ a
عن	ʕ a n
خباز	x u b b a z
بيض	b a j j a dˤ a
لجوء	l u d͡ʒ u ʔ
حانوت	ħ a w a n i t
كثيرا	k a θ i r a n
رقيق	r a q i q
ضباب	dˤ a b b a b
جلد	d͡ʒ i l d
ذنب	ð a n a b
زرع	z a r ʕ
تنفس	t a n f a s a
فوتنج	f u t a n a d͡ʒ
باب	b a b
قطع	q i tˤ a ʕ
جفن	d͡ʒ a f n
متزاوج	m u t a z a w i d͡ʒ
هاته	h a t i h i
تخم	t u x m
الأندلس	a l ʔ a n d a l u s
حكاية	ħ i k a j a
نيجيريا	n i ɡ i r i j a
عزى	ʕ a z a
جوافة	d͡ʒ a w a f a
إبريز	ʔ i b r i z
تسلط	t a s a l l a tˤ a
عسقلان	ʕ a s q a l a n
أفلاطوني	ʔ a f l a tˤ u n i j j
قلب	q a l l a b a
زربية	z i r b i j j a
لبى	l a b b a
نضو	n i dˤ w
سلسلة	s i l s i l a
دشمة	d u ʃ m a
غيبة	ɣ a j b a
ضواحي	dˤ a w a ħ i
تايلند	t a j l a n d
أولى	ʔ a w l a
زنباعة	z a n b a ʕ a
بلاستيكي	b l a s t i k i j j
محول	m u ħ a w w i l
إقليميا	ʔ i q l i m i j a
سبب	s a b b a b a
شخر	ʃ a x a r a
حبل	ħ a b l
مفروغ	m a f r u ɣ
موسكو	m u s k u
إشبين	ʔ i ʃ b i n
سيجارة	s i d͡ʒ a r a
شلة	ʃ a l l a
نيتروجين	n i t r o d͡ʒ i n
زخة	z a x x a
خشاب	x a ʃ ʃ a b
جمال	d͡ʒ i m a l
ديسمبر	d i s a m b i r
خطف	x a tˤ a f a
تفقد	t a f a q q a d a
أضاع	ʔ a dˤ a ʕ a
اتصل	i t t a sˤ a l a
استفز	i s t a f a z z a
استشرق	i s t a ʃ r a q a
قلب	q u l b
مخدر	m u x a d d i r
عنصر	ʕ u n sˤ u r
حادثة	ħ a d i θ a
ذاق	ð a q a
تسامح	t a s a m a ħ a
دلاعة	d a l l a ʕ a
نجار	n a d͡ʒ d͡ʒ a r
إطرية	ʔ i tˤ r i j a
قتلة	q i t l a h
هم	h i m m
قاتل	ɡ a t a l
إلياس	ʔ i l j a s
أعف	ʔ a ʕ a f f a
شم	ʃ a m m a
إشبيلية	ʔ i ʃ b i l j a
أكل	ʔ u k l
رواقي	r i w a q i j j
أغلب	ʔ a ɣ l i b
رائب	r a ʔ i b
طبيبة	tˤ a b i b a
غرد	ɣ a r a d
صمم	sˤ a m m a m a
يونيو	j u n i j o
أندر	ʔ a n d a r a
صحيح	sˤ a ħ i ħ
أعمى	ʔ a ʕ m a
أوحد	ʔ a w ħ a d
آدب	ʔ a d i b
خبر	x a b u r a
جهاد	d͡ʒ a h a d
ة	r
وبخ	w a b b a x a
عوج	ʕ i w a d͡ʒ
زرافة	z a r a f a
أمس	ʔ u m a s s i
دفلى	d i f l a
مستقيم	m u s t a q i m
بندق	b u n d u q
حصن	ħ i sˤ n
أغرق	ʔ a ɣ r a q a
وفق	w a f f a q a
مستدير	m u s t a d i r
كمثرى	k u m m a θ r a
كثيرا	k a θ i r a
كراني	k a r r a n i j j
لاحق	l a ħ i q
تفريغ	t a f r i ɣ
فراولة	f a r a w l a
قفة	q u f f a
قاعة	q a ʕ a
بيدر	b a j d a r
كوالا	k u w a l a
لمع	l a m m a ʕ a
قذيفة	q a ð i f a
غمامة	ɣ i m a m a
قانون	q a n u n
تحدى	t a ħ a d d a
آذريون	ʔ a ð a r j u n
باقلى	b a q i l l a
صدرية	sˤ i d r i j j a
خلع	x a l a ʕ a
صرصار	sˤ i r sˤ a r
مخيم	m u x a j j a m
أغار	ʔ a ɣ a r a
حرقوص	ħ a r q u sˤ
ترميم	t a r m i m
شراب	ʃ a r r a b
دهشة	d a h ʃ a
بن	b i n n a
إسرائيلي	ʔ i s r a ʔ i l i j j
رطب	r a tˤ i b
صفر	sˤ a f a r
أموي	ʔ u m a w i j j
قسنطينة	q u s a n tˤ i n a
أمي	ʔ u m m i j j
فصولياء	f a sˤ u l i j a ʔ
ثوري	θ u r i
ركل	r a k a l a
شمراخ	ʃ i m r a x
حج	ħ a d͡ʒ d͡ʒ a
عرف	ʕ a r a f a
توضح	t a w a dˤ dˤ a ħ a
عاد	ʕ a d a
جنب	d͡ʒ a n n a b a
هنا	h u n a
ديسمبر	d i s i m b a r
ذهن	ð i h n
تشيكوسلوفاكيا	t ʃ e k o s l o v a k i j a
انحاز	i n ħ a z a
يسار	j u s a r a
معماري	m i ʕ m a r i j j
ثريد	θ a r i d
مدني	m a d a n i j j
خلر	x u l l a r
ريح	r a j j i ħ
حدوة	ħ i d w a
لج	l u d͡ʒ d͡ʒ
سياع	s a j a ʕ
خصوص	x u sˤ u sˤ
ابتذل	i b t a ð a l a
مدفأ	m i d f a ʔ
داخ	d a x a
آمين	ʔ a m i n a
فقري	f i q r i j j
هاء	h a ʔ a
لام	l a m a
عمى	ʕ a m m a
بخت	b a x t
إبريل	ʔ i b r i l
اتجه	i t t a d͡ʒ a h a
اختطف	i x t a tˤ a f a
شيعة	ʃ i ʕ a
تراجم	t a r a d͡ʒ i m
ثقل	θ i q l u n
مشط	m i ʃ tˤ
لوز	l u z
ابنة	i b n a
أبهج	ʔ a b h a d͡ʒ a
شعر	ʃ i ʕ r
مفلفل	m u f a l f a l
مقصر	m u q a sˤ sˤ a r
بليحا	b a l i ħ a
إسبغول	ʔ i s b a ɣ o l
غراب	ɣ u r a b
قسطران	q a s tˤ a r a n
خيالي	x a j a l i j j
تصفح	t a sˤ a f f a ħ a
الصربية	a sˤ sˤ i r b i j j a
محنة	m i ħ n a
حقوقي	ħ u q u q i j j
تفاح	t u f f a ħ
شرعي	ʃ a r ʕ i j j
برق	b a r a q a
هجاء	h a d͡ʒ d͡ʒ a ʔ
شدة	ʃ i d d a
اثنان	i θ n a n
ضرب	dˤ u r i b a
نعال	n i ʕ a l
ذميم	ð a m i m
منطقة	m ə n tˤ ə ɡ ə
صفيحة	sˤ a f i ħ a
كزبرة	k ə z b ə r ə
مدرسة	m u d a r r a s a
أحجم	ʔ a ħ d͡ʒ a m a
رماد	r a m a d
صحى	sˤ a ħ ħ a
حرف	ħ a r r a f a
مختصر	m u x t a sˤ i r
زخات	z a x x a t
ديناميكا	d i n a m i k a
تداع	t a d a ʕ i n
استقبال	s t i q b a l
قدم	q a d a m
فرفحين	f a r f a ħ i n
مكتبة	m a k t a b a
رفاهة	r a f a h a
طاقية	tˤ a q i j j a
منقار	m i n q a r
تجوف	t a d͡ʒ a w w a f a
إعراب	ʔ i ʕ r a b
مقابلة	m u q a b a l a h
موسكو	m o s k u
أبله	ʔ a b l a h
قهوة	ɡ a h w a
هندس	h a n d a s a
إثيوبيا	ʔ i θ j u b i j a
يا	j a
ذكر	ð a k k a r a
كلح	k a l a ħ a
خرطال	x a r tˤ a l
قبول	q a b u l
ضرط	dˤ a r i tˤ a
لأن	l i ʔ a n
بيرق	b a j r a q
إكليل	ʔ i k l i l
إرهاب	ʔ i r h a b
بيض	b i dˤ
بن	b u n n
خز	x a z z
خنشار	x i n ʃ a r
بدر	b a d r
زيت	z a j t
استجمام	i s t i d͡ʒ m a m
ملك	m a l a k
استفرغ	i s t a f r a ɣ a
ذهب	ð a h h a b a
ضيون	dˤ a j w a n
بربري	b a r b a r i j j
سينما	s i n a m a
سوريا	s u r i j a
هبة	h i b a
شاشية	ʃ a ʃ i j j a
تاريخية	t a r i x i j j a
أعز	ʔ a ʕ a z z
امتحان	i m t i ħ a n
ماذا	m a ð a
نجاح	n a d͡ʒ a ħ
لأن	l i ʔ a n n a
أجاب	ʔ a d͡ʒ a b a
هاد	h a d a
عتبة	ʕ a t a b a
النيجر	a n n i d͡ʒ a r
قابلة	ʔ a b l e
برشام	b u r ʃ a m
ضربة	dˤ a r b a
عمان	ʕ a m m a n
إشعاعي	ʔ i ʃ ʕ a ʕ i j j
طقس	tˤ a ʔ ə s
تمسيد	t a m s i d
يونيو	j u n i j u
واحات	w a ħ a t
بطارخ	b u tˤ a r i x
غربالي	ɣ i r b a l i j j
كبة	k i b b a
ضرب	dˤ a r a b
عجلة	ʕ a d͡ʒ a l a
كون	k a w n
متى	m a t a
قاتل	q a t i l
كسيح	k a s i ħ
بلوة	b i l a n
سدارة	s a d a r a
منجى	m a n d͡ʒ a n
استئمارة	i s t i ʔ m a r a
مبتلى	m u b t a l a n
ضرب	dˤ a r i b a
مبشرة	m i b ʃ a r a
فبراير	f i b r a j i r
قنص	q a n sˤ
أمريكي	ʔ a m r i k i j j
لاحم	l a ħ i m
خزف	x a z a f
إذاعة	ʔ i ð a ʕ a
لهي	l a h i j a
ورق	w a r a q
ثمان	θ a m a n i n
عيان	ʕ a j j a n
طعن	tˤ i ʕ n a
اجتماع	i d͡ʒ t i m a ʕ
محافظة	m u ħ a f a ðˤ a
جريدة	d͡ʒ a r i d a
قائمة	q a ʔ i m a
شاورما	ʃ a w a r m a
وقع	w a q a ʕ a
الفاتيكان	a l f a t i k a n
رهج	r a h a d͡ʒ
جوز	d͡ʒ o z
وثق	w a θ i q a
عظ	ʕ i ðˤ
رحمن	r a ħ i m n a
جص	d͡ʒ i sˤ sˤ
سبسب	s a b s a b a
نيويورك	n i j u j o r k
بنت	b i n t a
جائع	d͡ʒ a ʔ i ʕ
مطاف	m a tˤ a f
هال	h a l a
زغاية	z a ɣ a j a
حصاد	ħ i sˤ a d
قاعة	ʔ a ʕ a
امرأ	i m r a ʔ a
جلباب	d͡ʒ i l b a b
كنباث	k i m b a θ
شكري	ʃ u k r i j j
مدفع	m i d f a ʕ
ثمن	θ a m a n
إبريق	ʔ i b r i q
تفسيري	t a f s i r i j j
إفريقيا	ʔ i f r i q j a
مزق	m a z z a q a
شبح	ʃ a b ħ
أم	ʔ u m m
مجن	m i d͡ʒ a n n
فهرس	f ə h r ə s
ردة	r i d d a
وجدة	w a d͡ʒ d a
فرث	f a r θ
تعريف	t a ʕ r i f
ضمير	dˤ a m i r
متسامح	m u t a s a m i ħ
لوط	l u tˤ
تلاش	t a l a ʃ i n
شيراز	ʃ i r a z
فسر	f a s s a r a
علم	ʕ a l l a m a
إهليلجي	ʔ i h l i l a d͡ʒ i j j
مخبأ	m a x b a ʔ
قرنبيط	q a r n a b i tˤ
وليمة	w a l i m a
بثن	b a θ a n
ثقل	θ a q q a l a
إسطبل	ʔ i s tˤ a b l
ضفدع	dˤ u f d a ʕ
صراع	sˤ i r a ʕ
دياقود	d i j a q u d
مجمد	m u d͡ʒ a m m a d
بدوي	b a d a w i j j
حفيدة	ħ a f i d a
صندوق	sˤ u n d u q
وشيك	w a ʃ i k
اعتداء	i ʕ t i d a ʔ
تلميح	t a l m i ħ
انتظام	i n t i ðˤ a m
حريم	ħ a r i m
نقدا	n a q d a n
إسفنط	ʔ i s f a n tˤ
سويسري	s u w i s r i j j
أدبي	ʔ a d d i b i
قماش	q u m a ʃ
قرصان	q u r sˤ a n
قنطرة	q a n tˤ a r a
إبل	ʔ i b i l
لكز	l a k z
فقير	f a q i r
ثرى	θ a r a n
مقلياثا	m a q l i j a θ a
غيور	ɣ a j u r
دابرة	d a b i r a
غسالة	ɣ a s s a l a
حنطة	ħ i n tˤ a
نوح	n u ħ
شكال	ʃ i k a l
دبج	d a b b a d͡ʒ a
مماس	m u m a s s
مشيمة	m a ʃ i m a
فهرس	f i h r i s
عاد	ʕ a d
لصق	l a sˤ sˤ a q a
آمن	ʔ a m a n u
تذاكى	t a ð a k a
ورشان	w a r a ʃ a n
طرفاء	tˤ u r a f a ʔ
شاكرة	ʃ a k i r a
أشرفي	ʔ a ʃ r a f i j j
قديم	ɡ a d i m
دين	d a j j i n
بيطرة	b a j tˤ a r a
مري	m u r i
مشرق	m a ʃ r i q
زأر	z a ʔ a r a
فليفلة	f u l a j f i l a
أنفاق	ʔ u n f a q
كره	k a r r a h a
تحرش	t u ħ a r r i ʃ
حملة	ħ a m l a
رائع	r a ʔ i ʕ
أحور	ʔ a ħ w a r
قطار	q i tˤ a r
زحف	z a ħ a f a
مروض	m u r a w w a dˤ
زملاء	z u m a l a ʔ
إيقاع	ʔ i q a ʕ
برغوث	b u r ɣ u θ
جزيرة	d͡ʒ a z i r a
ابن	i b n i
لاسلكي	l a s i l k i j j
خف	x a f f a
انتبه	i n t a b a h a
أزعج	ʔ a z ʕ a d͡ʒ a
جوي	d͡ʒ a w w i j j
أيل	ʔ a j j a l
ضياع	dˤ a j a ʕ
قبر	ɡ a b a r
درس	d a r a s a
بوصلة	b u sˤ l a
شيم	ʃ a j j a m a
فنجنكشت	f a n d͡ʒ a n k u ʃ t
قال	q a l
زبل	z a b b a l a
قيلولة	q a j l u l a
خرفة	x u r f a
خرج	x a r a d͡ʒ a
تزويد	t a z w i d
مستوقد	m u s t a w q a d
جهة	d͡ʒ i h a
أطاح	ʔ a tˤ a ħ a
صوفي	sˤ u f i j j
مفاجأة	m u f a d͡ʒ a ʔ a
جاب	d͡ʒ a b a
قارن	q a r a n a
مسرح	m a s r a ħ
حفيد	ħ a f i d
ناحية	n a ħ i j a
كنزة	k a n z a
عاب	ʕ a b a
نيلج	n a j l a d͡ʒ
جفن	d͡ʒ i f i n
ركع	r a k a ʕ a
حجرة	ħ u d͡ʒ r a
تفوق	t a f a w w a q a
حلتيت	ħ a l t i t
كم	k u m
براءة	b a r a ʔ a
داخل	d a x a l a
ترياق	t i r j a q
اذلولى	i ð l a w l a
أصفر	ʔ a sˤ f a r a
أنطاكية	ʔ a n tˤ a k i j a
موزمبيق	m o z a m b i q
كمأ	k a m a ʔ
كرسي	k u r s i j j
خدش	x a d d a ʃ a
همزة	h a m z a
تواطؤ	t a w a tˤ u ʔ
شريعة	ʃ a r i ʕ a
توبة	t o b ɐ
حذفي	ħ a ð a f i j j
رغائف	r a ɣ a j i f
خرنباش	x u r a n b a ʃ
مسود	m ɪ s w ɐ d̚
ثآليل	θ a ʔ a l i l
متوسط	m u t a w a s s i tˤ
ديبوذ	d a j a b u ð
أطرش	ʔ a tˤ r a ʃ
مكون	m u k a w w i n
قاقلة	q a q i l l a
أندر	ʔ a n d a r
جدد	d͡ʒ a d d a d a
قريدسة	q u r a j d i s a
قيمة	ɡ i m a
هن	h i n
تقدد	t a q a d d a d a
دلو	d a l w
سميد	s a m i d
جريب	d͡ʒ u r a j b
دمع	d a m ʕ
آ	ʔ a
شقة	ʃ u q q a
لبلاب	l a b l a b
قطعة	q a tˤ a ʕ a
برغي	b u r ɣ i j j
ثيوقراطي	θ i j u q r a tˤ i j j
عوينات	ʕ u w a j n a t
مبتل	m u b t a l i n
ققنوس	q u q n u s
نظارة	n a ðˤ ðˤ a r a
تقويم	t a q w i m
هيا	h a j j a
سرقين	s i r q i n
وقية	w i q i j j a
مقصود	m a q sˤ u d
لوح	l o ħ
حديث	ħ a d i θ
بورندي	b u r u n d i
حظيرة	ħ a ðˤ i r a
بهمن	b a h m a n
وقية	w u q i j j a
مرقاق	m i r q a q
كليل	k a l i l
رومانسي	r u m a n s i j j
سنونوة	s u n u n u w a
رمادي	r a m a d i j j
صرب	sˤ a r a b a
دون	d a w w a n a
ظفر	ðˤ a f i r a
محاصر	m u ħ a sˤ i r
قشر	ɡ i ʃ i r
بطم	b u tˤ m
قرقس	q i r q i s
انتقاض	i n t i q a dˤ
مساومة	m u s a w a m a
تاء	t a ʔ
سبح	s a b a ħ a
مختصر	m u x t a sˤ a r
شرب	ʃ u r b
لقاح	l a q a ħ
تباكى	t a b a k a
اتجاهات	i t t i d͡ʒ a h a t
كاكنج	k a k i n d͡ʒ
بريطاني	b a r i tˤ a n i j j
ناسك	n a s i k
رب	r a b b a
سعي	s u ʕ i j a
دم	d u m
أغلب	ʔ a ɣ l a b u
ل	l
أقضى	ʔ a q dˤ a
زهرة	z u h r a
تبشير	t a b ʃ i r
ملك	m a l l a k a
شيرج	ʃ i r i d͡ʒ
بعيثران	b a ʕ a j θ a r a n
حرق	ħ a r a ɡ
مشكور	m a ʃ k u r
رحب	r a ħ a b
اليونان	a l j u n a n
قرنفل	q a r a n f u l
فسيفساء	f u s a j f i s a ʔ
جارة	d͡ʒ a r a
أخدود	ʔ u x d u d
قابلة	ʔ a b l a
صحا	sˤ a ħ a
وقت	w a ʔ t
براين	b r a j a n
شمس	ʃ a m m a s a
جبل	d͡ʒ a b a l a
استبد	i s t a b a d d a
اجتاز	i d͡ʒ t a z a
قمل	q a m l
قشع	q a ʃ a ʕ a
أن	ʔ a n
أشهد	ʔ a ʃ h a d a
تراب	t u r a b
بنت	b a n a t
كره	k a r i h
إنجلترا	ʔ i n ɡ i l t e r a
خاء	x a ʔ
معين	m u ʕ a j j a n
شاهدانق	ʃ a h d a n a q
تفاوض	t a f a w u dˤ
روبيان	r u b i j a n
غ	ʁ
لبوس	l a b u s
سبتمبر	s i b t i m b i r
عربز	ʕ a r b a z
شتاء	ʃ i t a ʔ
صبر	sˤ a b i r
أغلب	ʔ a ɣ l i b a
أثل	ʔ a θ l
يعقوب	j a ʕ q u b
أسهل	ʔ u s a h h a l a
إنقاض	ʔ i n q a dˤ
ريفي	r i f i j j
دهليز	d i h l i z
ميعاد	m i ʕ a d
نظيف	n a ðˤ i f
تفسير	t a f s i r
شاكوش	ʃ a k u ʃ
سفرجلة	s a f a r d͡ʒ a l a
أيام	ʔ a j j a m
للأسف	l i l ʔ a s a f
نساء	n i s a ʔ
الأوكيناوا	a l ʔ u k i n a w a
لازوردي	l a z u w a r d i j j
متفجرات	m u t a f a d͡ʒ d͡ʒ i r a t
قشد	q a ʃ a d a
مهندس	m u h a n d i s
حمزة	ħ a m z a h
عنصل	ʕ u n sˤ a l
إفرند	ʔ i f r i n d
دبقي	d i b q i j j
امرؤ	u m r u ʔ
ظفر	ðˤ u f r
مطحنة	m a tˤ ħ a n a
وعد	w a ʕ a d a
شاورما	ʃ ɐ w ə r m ə
كشمش	k i ʃ m i ʃ
بخير	b i x a j r
جزيرة	ɡ a z i r a
ولد	w a l l a d a
هزة	h a z z a
صقنقور	sˤ a q a n q u r
وريد	w a r i d
شاور	ʃ a w a r a
خلقي	x i l q i j j
أعمى	ʔ u ʕ a m m a
نعامة	n a ʕ a m a
أوج	ʔ a w d͡ʒ
طاجن	tˤ a d͡ʒ i n
اتضح	i t t a dˤ a ħ a
تدريب	t a d r i b
ثقافة	θ a q a f a
مغطس	m a ɣ tˤ i s
هودج	h a w d a d͡ʒ
قبض	q a b a dˤ a
احتراق	i ħ t i r a q
رائعة	r a ʔ i ʕ a
أوجد	ʔ u d͡ʒ a d a
ناردين	n a r a d i n
موقف	m a w q i f
عجاب	ʕ u d͡ʒ a b
فور	f a w r
إناء	ʔ i n a ʔ
أسفر	ʔ a s f a r a
مبارك	m u b a r a k
أب	ʔ a b
عجب	ʕ u d͡ʒ b
متطرف	m u t a tˤ a r r i f
بيرو	b e r u
رب	r u b b
شاط	ʃ a tˤ a
برقوق	b u r q u q
شكرا	ʃ u k r a n
خلق	x a l q
أنعل	ʔ a n ʕ u l
مفتش	m u f a t t i ʃ
دثر	d a θ r
كمان	k a m a n
كرة	k a r r a
بغي	b a ɣ i j j
فنار	f a n a r
نفخ	n a f x
السعودية	a s s u ʕ u d i j j a
ترفع	t a r a f f a ʕ a
ضحك	dˤ a ħ i k a
حياة	ħ a j a h
قلاووز	q a l a w u z
طيهوج	tˤ i h u d͡ʒ
لاتفيا	l a t v i j a
رباط	r i b a tˤ
زرقون	z a r q u n
توعوي	t a w ʕ a w i j j
كذاب	k a d d a b
سلم	s u l l a m
ر	r a ʔ
فالجي	f a l a d͡ʒ i j j
زائف	z a ʔ i f
توقيف	t a w q i f
برتقالي	b u r t u q a l i j j
ألهى	ʔ a l h a
منهج	m a n h a d͡ʒ
قتل	q a t t a l a
جهد	d͡ʒ a h a d a
نظير	n a ðˤ i r
مست	m a s a t
اقتعد	i q t a ʕ a d a
كستج	k u s t a d͡ʒ
سنبك	s u m b a k
هش	h a ʃ ʃ
أم	ʔ a m m a
دلاع	d a l l a ʕ
مزاد	m a z a d
قداحة	q a d d a ħ a
محادث	m u ħ a d i θ
لحق	l a ħ q
مذكر	m u ð a k k a r
ترعة	t u r ʕ a
فاصولياء	f a sˤ u l i j a ʔ
سيل	s a j l
دعش	d a ʕ ʕ a ʃ a
هندسي	h a n d a s i j j
وزغة	w a z a ɣ a
أيون	ʔ a j o n
بابونج	b a b u n a d͡ʒ
هال	h a l
النمسا	a n n a m s a
حديقة	ħ a d i ɡ a
شيم	ʃ i m
غرق	ɣ a r r a q
ما	m a
قناع	q i n a ʕ
فانيد	f a n i d
ضرب	dˤ a r b
كندوج	k a n d u d͡ʒ
مقبل	m u q b i l
بلادونا	b i l a d u n a
ألم	ʔ a l a m
طاعة	tˤ a ʕ a
زوجة	z a w d͡ʒ a
قشطة	q i ʃ tˤ a
ه	h
ثلاثون	θ a l a θ u n a
طباق	tˤ i b a q
نزعة	n a z ʕ a
ضيق	dˤ i q
تعصر	t a ʕ a sˤ sˤ a r a
مجري	m a d͡ʒ a r i j j
ضيعة	dˤ a j ʕ a
أبريل	ʔ a b r i l
فوار	f a w w a r
أحسن	ʔ a ħ s u n a
حرش	ħ a r a ʃ a
أرز	ʔ a r u z z
مقدونس	m a q d u n i s
توبة	t a w b a
قسم	q i s a m
شعبة	ʃ u ʕ b a
حان	ħ a n a
سويسري	s w i s r i j j
جراد	d͡ʒ a r a d
بلس	b u l u s
منسأة	m i n s a ʔ a
غزاوة	ɣ a z a w a
شيح	ʃ i ħ
رفقة	r u f q a
علقة	ʕ a l a q a
فرغ	f a r i ɣ
أنغولا	ʔ a n ɣ o l a
قاموس	q a m u s
العاصي	a l ʕ a sˤ i
زهرة	z a h r a
مخرج	m u x r i d͡ʒ
إصطبل	ʔ i sˤ tˤ a b l
قداد	q i d d a d
ضمني	dˤ i m n i j j
قطلب	q a tˤ l a b
من	m a n
خابية	x a b i j a
ذراع	ð i r a ʕ
فيج	f u j u d͡ʒ
الثلاثاء	a θ θ u l a θ a ʔ
سعي	s a ʕ j
تصعيد	t a sˤ ʕ i d
كم	k a m
ثيتل	θ a j t a l
كهف	k ə h f
دب	d a b b a
حجن	ħ a d͡ʒ a n a
حوب	ħ u b
كاسيت	k a s i t
إلى	ʔ i l a n
قرطاس	q u r tˤ a s
قشف	q a ʃ i f a
ابتسام	i b t i s a m
حفار	ħ a f f a r
جبل	d͡ʒ a b l
اختط	i x t a tˤ tˤ a
مخاض	m a x a dˤ
جم	d͡ʒ a m m
سوراني	s u r a n i j j
حب	ħ a b b
سبعون	s a b ʕ u n a
أذن	ʔ a ð a n a
كدس	k a d s
قفازات	q u f f a z a t
مناعة	m a n a ʕ a
هامش	h a m i ʃ
حرف	ħ a r a f a
مقدر	m u q a d d a r
مقولة	m a q u l a
مقود	m i q w a d
ضاد	dˤ a d
تمرين	t a m u r r i n a
داخل	d a x i l
نير	n a j j i r
زق	z u q q
أسطوانة	ʔ u s tˤ u w a n a
جنطيانا	d͡ʒ a n tˤ i j a n a
إرادي	ʔ i r a d i j j
تنوير	t a n w i r
بوصلة	b a w sˤ a l a
تغذية	t a ɣ ð i j a
جمل	d͡ʒ a m a l
مومسة	m u m i s a
مجادلة	m u d͡ʒ a d a l a h
محسة	m i ħ a s s a
حاء	ħ a ʔ
مستنقعات	m u s t a n q a ʕ a t
الإسلام	a l ʔ i s l a m
تسلم	t a s a l l a m a
عباء	ʕ a b a ʔ
تسلم	t a s a l l u m
رب	r a b b
أسباب	ʔ a s b a b
ضمن	dˤ i m n a
أغلب	ʔ u ɣ l a b a
اعتقل	i ʕ t a q a l a
هيدروجين	h i d r o ʒ e n
سيئ	s a j j i ʔ
بركة	b a r a k a
لثغة	l u θ ɣ a t u n
نخل	n a x x a l a
السودان	a s s u d a n
عري	ʕ a r i j a
قدوم	q a d u m
عنكبوت	ʕ a n a k i b
لكن	l a k i n n a
عقاري	ʕ a q a r i j j
ضرب	dˤ a r a b a
متراس	m i t r a s
طيرة	tˤ a j r a
أبنوس	ʔ a b a n u s
قلادة	q i l a d a
ق	ʔ
من	m i n
فلان	f u l a n
سوفياتي	s u f j a t i j j
شليل	ʃ a l i l
حميم	ħ a m i m
أعصر	ʔ a ʕ sˤ a r a
نقض	n u q dˤ a
أنزل	ʔ a n z a l a
لكم	l a k a m a
شونة	ʃ u n a
كأن	k a ʔ a n n a
فظع	f a ðˤ i ʕ a
لقمة	l u q m a
تضامني	t a dˤ a m u n i j j
ضمن	dˤ a m m a n a
لون	l a w n
أوروبي	ʔ u r u b b i j j
حلقة	ħ a l q a
ملاك	m u l l a k
انتظم	i n t a ðˤ a m a
أوحال	ʔ a w ħ a l
قلاية	q i l l a j a
سكن	s a k a n
مجسم	m u d͡ʒ a s s a m
مقام	m a ɡ a m
استفتى	i s t a f t a
غزال	ɣ a z a l
تذبذب	t a ð a b ð a b a
كمح	k a m a ħ a
صدق	sˤ a d a q a
بلور	b i l l u r
قام	ɡ a m
انقرض	i n q a r a dˤ a
أصهب	ʔ a sˤ h a b a
ثقة	θ i q a
جامايكا	d͡ʒ a m a j k a
بيلاروسيا	b e l a r u s j a
تبحر	t a b a ħ ħ a r a
اعتزل	i ʕ t a z a l a
دائمي	d a ʔ i m i j j
نوم	n a w w a m a
مخالف	m u x a l i f
حجاب	ħ d͡ʒ ɑ b
رحب	r a ħ i b a
كامبودي	k a m b u d i j j
طرفاء	tˤ a r f a ʔ
الأشهل	a l ʔ a ʃ h a l
لبأ	l i b a ʔ
قرية	q a r i j j a
مديرة	m u d i r a
محمدة	m u ħ a m m a d a
قلائد	q a l a ʔ i d
تحمس	t a ħ a m m u s
خرج	x a r d͡ʒ
فاء	f a ʔ
مستاجر	m u s t a ʔ d͡ʒ i r
الله	a ɫ ɫ a h u
كسحاء	k a s ħ a ʔ
دمية	d u m j a
آمن	ʔ a m a n
غلقة	ɣ i l q a
تهدد	t a h a d d a d a
مثل	m i θ l a
مرشة	m i r a ʃ a
شلال	ʃ a l l a l
خردل	x a r d a l
هايتي	h a i t i
حانوت	ħ a n u t
مخطوطة	m a x tˤ u tˤ a
ضيق	dˤ a j j i q
تماسك	t a m a s u k
أقرع	ʔ a q r a ʕ
سمن	s i m a n
انجذاب	i n d͡ʒ i ð a b
زرقطونا	z a r q a tˤ u n a
قيطون	q a tˤ u n
هش	h a ʃ ʃ a
ظربان	ðˤ a r i b a n
أوضح	ʔ a w dˤ a ħ a
انخفاض	i n x i f a dˤ
عجب	ʕ a d͡ʒ i b a
برباريس	b a r b a r i s
أثث	ʔ a θ θ a θ a
ردع	r a d a ʕ a
قفص	q u f sˤ
قاف	q a f
قدم	q a d d a m a
قابلة	ɡ a b l a
حرش	ħ a r i ʃ
عباية	ʕ a b a j a
ليرة	l a j r a
أولئك	ʔ u l a ʔ i k a
فراغ	f a r a ɣ
صواع	sˤ u w a ʕ
مقاود	m a q a w i d
سعة	s a ʕ a
عرف	ʕ u r f
ميدان	m a j d a n
منار	m a n a r
بستان	b u s t a n
طخش	tˤ a x ʃ
استحم	i s t a ħ a m m a
ياء	j a ʔ
قاء	q a ʔ a
جوافة	d͡ʒ u w a f a
ألوهية	ʔ u l u h i j j a
سركنجبين	s i r k a n d͡ʒ a b i n
أعتاب	ʔ a ʕ t a b
فؤاد	f u ʔ a d
إدحية	ʔ i d ħ i j a
مروض	m u r a w w i dˤ
تهذيب	t a h ð i b
تسلل	t a s a l l a l a
جميل	d͡ʒ a m i l
محاكمة	m u ħ a k a m a
أمسك	ʔ a m s a k a
ركلة	r a k l a
وبال	w a b a l
بنت	b i n t u
جذمور	d͡ʒ u ð m u r
ناغش	n a ɣ i ʃ a
نموذجي	n a m u ð a d͡ʒ i j j
تين	t i n
دمنة	d i m n a
فاصوليا	f a sˤ u l i j a
زحافة	z a ħ ħ a f a
حكمة	ħ i k m a
رف	r a f f
أدبي	ʔ a d a b i j j
اليابان	a l j a b a n
وأى	w a ʔ a
فحم	f a ħ m
رصفان	r u sˤ f a n
فن	f a n n
قلقطار	q a l q a tˤ a r
بربخ	b a r b a x
سمن	s i m n a
شريطة	ʃ a r i tˤ a
قطع	q a tˤ a ʕ a
صغير	sˤ a ɣ i r
أمس	ʔ a m a s s a
زخ	z a x x a
أوقية	ʔ u q i j j a
قرميدة	q i r m i d a
حادث	ħ a d i θ
عمة	ʕ a m m a
اتحاد	i t t i ħ a d
بوصلة	b u sˤ u l a
علي	ʕ a l i
عماد	ʕ i m a d
قهوة	ʔ a h w ɛ
ورس	w u r u s
تحرش	t u ħ r a ʃ
أشوس	ʔ a ʃ w a s
ممسح	m u m a s s i ħ
أبها	ʔ a b h a
ذنب	ð a n n a b a
صحة	sˤ i ħ ħ a
مفروشات	m a f r u ʃ a t
خمسون	x a m s u n a
كروياء	k a r a w j a ʔ
لعل	l a ʕ l
شمع	ʃ a m a ʕ
ض	dˤ a d
جمع	d͡ʒ a m a ʕ a
غسق	ɣ a s a q
درس	d a r s
بغرير	b a ɣ r i r
أسهل	ʔ a s h u l a
حلال	ħ a l a l
ذرة	ð u r a
تناقض	t a n a q a dˤ a
فكرة	f i k r a
ترنج	t r i n d͡ʒ
سميت	s a m i t
هو	w a h u w a
دراسي	d i r a s i j j
مردقوش	m a r d a q u ʃ
رعد	r a ʕ d
أنت	ʔ a n t
تكدس	t u k a d d i s u
مستقبل	m u s t a q b a l
عيادة	ʕ i j a d a
ب	b a ʔ
مدع	m u d d a ʕ i n
غانا	ɣ a n a
بندر	b a n d a r
باكستاني	b a k i s t a n i j j
أوراق	ʔ a w r a q
مسلخ	m a s l a x
مسار	m a s a r
شهر	ʃ a h a r a
مداد	m i d a d
قصار	ɡ u sˤ a r
باقلاء	b a q i l l a ʔ
قبعة	q u b b a ʕ a
لصاق	l i sˤ a q
فيروز	f a j r u z
فوري	f a w r i j j
شبقي	ʃ a b a q i j j
الخمس	a l x u m s
ثمانون	θ a m a n u n a
موز	m a w z
مساحة	m i s a ħ a
شدد	ʃ a d d a d a
أعرج	ʔ a ʕ r a d͡ʒ
أذن	ʔ a ð i n a
غير	ɣ u j u r
مثقال	m i θ q a l
لقاح	l i q a ħ
البرازيل	a l b a r a z i l
شراب	ʃ u r r a b
أصفهان	ʔ a sˤ f a h a n
محدلة	m i ħ d a l a
صدغ	sˤ a d ɣ
أنيسون	ʔ a n i s u n
جلي	d͡ʒ a l i j j
قشلة	q a ʃ l a
لزج	l a z i d͡ʒ a
قراد	q u r a d
لبنان	l u b n a n
رستاق	r u s t a q
أفعى	ʔ a f ʕ a n
زامبيا	z a m b i j a
غ	ɣ a j n
عدو	ʕ a d u w w
صداقة	sˤ a d a q a
ماميثا	m a m i θ a
إمضاء	ʔ i m dˤ a ʔ
عقل	ʕ a q l
تنازع	t a n a z a ʕ a
عتيرة	ʕ a t i r a
فوفل	f a w f a l
غضب	ɣ a dˤ a b
مدينة	m a d i n a
وجود	w u ʒ u d
أعجوبة	ʔ u ʕ d͡ʒ u b a
إسكاف	ʔ i s k a f
تحذير	t a ħ ð i r
صدر	sˤ a d r
عدمية	ʕ a d a m i j j a
مجرد	m u d͡ʒ a r r a d
شلاق	ʃ a l l a q
فيتنام	v i j e t n a m
ضائن	dˤ a ʔ i n
عقدة	ʕ u q d a
صنان	sˤ u n a n
هنغاري	h a n ɣ a r i j j
ركض	r a k dˤ
سلحفاة	s u l a ħ f a h
لهجة	l a h ɡ a
ماسورة	m a s u r a
نسوان	n u s w a n
مقدمة	m u q a d d i m a
لحظ	l a ħ ðˤ
وقت	w a ɡ t
ف	f
شخص	ʃ a x a sˤ a
كوز	k u z
سدل	s a d a l a
إنفحة	ʔ i n f a ħ a
راوند	r a w a n d
لزج	l a z i d͡ʒ
ققنس	q u q n u s
أعجمي	ʔ a ʕ d͡ʒ i m i
ه	h a ʔ
ل	ɫ
هزل	h a z l
مخفر	m a x f a r
دوليا	d u w a l i j j a n
صغر	sˤ a ɣ a r a
هم	h a m m
القطيف	ɪ l q ə t i f
رحب	r u ħ b
ناسفة	n a s i f a
مارس	m a r i s
توفيق	t a w f i q
علا	ʕ a l a
بنجنكشت	b a n d͡ʒ a n k u ʃ t
امرأ	i m r a ʔ
أمازيغ	ʔ a m a z i ɣ
قيتار	q i t a r
نارجيل	n a r a d͡ʒ i l
كراث	k u r r a θ
اعتقادية	i ʕ t i q a d i j j a
صلعمي	sˤ a l ʕ a m i j j
قضائي	q a dˤ a ʔ i
شمام	ʃ a m m a m
بكارة	b a k a r a
جورب	d͡ʒ a w r a b
لم	l u m
ترجم	t a r d ʒ a m a
ز	z a j
ناخوذة	n a w a x i ð a
جنوب	d͡ʒ a n u b
ملاط	m i l a tˤ
موسى	m u s a n
أوجد	ʔ u d͡ʒ a d
سيد	s a j j i d
كتب	k i t a b
وثق	w a θ θ a q a
باليه	b a l e h
والله	w a ‿ ɫ ɫ a h i
صفر	sˤ i f r
بغل	b a ɣ l
حق	ħ u q q
جبان	d͡ʒ a b b a n
بيعة	b a j ʕ a
رجل	r a d͡ʒ d͡ʒ a l a
اشتد	i ʃ t a d d a
سوريا	s u r i j j a
مرزبة	m i r z a b b a
القطيف	a l q a t i f
صيف	sˤ a j f
مرتعب	m u r t a ʕ i b
خوذة	x u ð a
تزامن	t a z a m a n a
غمامة	ɣ a m a m a
متزوج	m u t a z a w w i d͡ʒ
بوصلة	b u sˤ i l a
دوش	d u ʃ
سهلا	s a h l a n
هيدروجين	h a j d r o d͡ʒ i n
أوساكا	ʔ u s a k a
خادم	x a d i m
حنفية	ħ a n a f i j j a
إلكترونيات	ʔ i l i k t r u n i j j a t
جميز	d͡ʒ u m m a j z
ركلات	r a k a l a t
مصابحة	m u sˤ a b a ħ a
لبان	l u b a n
قاقلة	q a q u l l a
أولي	ʔ a w w a l i j j
هي	h i j a
محدث	m u ħ a d d i θ
ضاع	dˤ a ʕ a
تكدس	t u k a d d i s
شوحة	ʃ u ħ a
أنبوبة	ʔ u n b u b a
شلجم	ʃ a l d͡ʒ a m
نضب	n a dˤ a b a
إبراهيم	ʔ i b r a h i m
طود	tˤ a w d
خبر	x a b a r
طحلب	tˤ u ħ l u b
عناية	ʕ i n a j a
جمهورية	d͡ʒ u m h u r i j j a
باطية	b a tˤ i j a
مصل	m a sˤ l
أغلب	ʔ u ɣ a l l a b a
قز	q a z z
شرعي	ʃ a r r i ʕ i
محاسبة	m u ħ a s a b a
قتل	q i t l
مثل	m a θ θ a l a
عطن	ʕ a tˤ a n
منتظر	m u n t a ðˤ a r
غلب	ɣ a l l a b a
راب	r a b a
فقوسة	f a q q u s a
أحب	ʔ a ħ a b b
غرب	ɣ u r b
أو	ʔ a w
أرجان	ʔ a r d͡ʒ a n
تنفس	t u n a f f a s
كيلوغرام	k i l u ɡ r a m
السبت	a s s a b t
وجبة	w a d͡ʒ b a
أعض	ʔ a ʕ a dˤ dˤ a
فلس	f u l s
انتقد	i n t a q a d a
فرأ	f a r a ʔ
قام	q a m a
قيصوم	q a j sˤ u m
شيخ	ʃ a j x
خبط	x a b b a tˤ a
مستفرغ	m u s t a f r i ɣ
أنزع	ʔ a n z a ʕ a
غرامة	ɣ a r a m a
صفة	sˤ u f f a
أطل	ʔ a tˤ a l l a
قرميد	q i r m i d
اشترى	i ʃ t a r a
تراخوما	t i r a x u m a
كوسوفو	k u s u f u
جزمازج	d͡ʒ a z m a z a d͡ʒ
دب	d u b b
بوان	b i w a n
ثقل	θ a q u l a
يرقة	j a r a ɡ a
مصنع	m a sˤ n a ʕ u n
اصطاد	i sˤ tˤ a d a
أممي	ʔ a m m i m i
قتل	q a t l
مرفأ	m a r f a ʔ
ترنجان	t u r u n d͡ʒ a n
يسار	j u s a r r u
عنصرية	ʕ u n sˤ u r i j j a
جنينة	d͡ʒ u n a j n a
كره	k a r i h a
نون	n u n
أيل	ʔ a j j i l
ألا	ʔ a l a
ممسح	m i m s a ħ
ماسح	m a s i ħ
تنديل	t a n d i l i j j a
ليلك	l i l a k
قضم	q a dˤ m
حالة	ħ a l a t a
جندية	d͡ʒ u n d i j j a
أدهش	ʔ a d h i ʃ
خيرة	x i j a r a
تايلندي	t a j l a n d i j j
شعبية	ʃ a ʕ b i j j a
دسار	d i s a r
إريس	ʔ i r r i s
غضب	ɣ u dˤ i b a
نقض	n a q a dˤ a
فروغ	f u r u ɣ
شحرور	ʃ u ħ r u r
انخرط	i n x a r a tˤ a
احتضن	i ħ t a dˤ a n a
شراب	ʃ a r a b
فصيلة	f a sˤ i l a
قلية	q i l l i j j a
تقرح	t a q a r r a ħ a
مضاربة	m u dˤ a r a b a
عطن	ʕ a tˤ i n a
عشرون	ʕ i ʃ r u n
شام	ʃ a m a
تينة	t i n a
أغضب	ʔ a ɣ dˤ a b a
ولاية	w i l a j a
بلاذر	b a l a ð i r
هو	h u
هدس	h a d a s
علج	ʕ i l d͡ʒ
بطانة	b i tˤ a n a
رسداق	r u s d a q
صحافي	sˤ i ħ a f i j j
أمستردام	ʔ a m s t i r d a m
إيران	ʔ i r a n
فران	f a r r a n
بازار	b a z a r
متلوث	m u t a l a w w i θ
منبه	m u n a b b i h
رتيلة	r u t a j l a
أن	ʔ a n n
مخصصات	m u x a sˤ sˤ a sˤ a t
أنقض	ʔ a n q a dˤ i
غني	ɣ a n n i
اعتلى	i ʕ t a l a
حصل	ħ a sˤ a l a
إربيان	ʔ i r b i j a n
أكتوبر	ʔ u k t u b a r
ورس	w a r s
زنخ	z a n i x a
تفاوض	t a f a w a dˤ a
خيط	x a j tˤ
تصغير	t a sˤ ɣ i r
جريب	d͡ʒ a r i b
حرق	ħ a r r a q a
إبليس	ʔ i b l i s
قذارة	q a ð a r a
مثل	m a θ a l
ذوب	ð a w w a b a
مغناطيسية	m i ɣ n a tˤ i s i j j a
زكام	z u k a m
اعتل	i ʕ t a l l a
زرزر	z u r z u r
غرفة	ɣ u r f a
زجاجة	z a d͡ʒ a d͡ʒ a
تقديم	t a q d i m
موسكو	m o s k o
مثل	m i θ l i
هدف	h a d a f
صناب	sˤ i n a b
بطارخ	b a tˤ a r i x
جاء	d͡ʒ a ʔ a
فريق	f a r i q
مالقة	m a l a q a
بليحاء	b a l i ħ a ʔ
دم	d i m m
طالما	tˤ a l a m a
سن	s i n n
لكن	l a k i n
انفرث	i n f a r a θ a
ناردين	n a r d i n
جرافة	d͡ʒ a r r a f a
جنب	d͡ʒ u n i b a
فرند	f i r i n d
سيدا	s i d a
تحرش	t u ħ a r r a ʃ a
دينار	d i n a r
جرجير	d͡ʒ i r d͡ʒ i r
سنة	s u n n a
شمالي	ʃ a m a l i j j
صبر	sˤ a b r
صك	sˤ a k k a
عض	ʕ i dˤ dˤ
ناقض	n a q a dˤ a
شرد	ʃ a r a d a
عجول	ʕ a d͡ʒ u l
نوح	n a w ħ
ؤ	ʔ
إمهال	ʔ i m h a l
رب	r a b b i
تنوب	t a n n u b
أنطاليا	ʔ a n tˤ a l i j a
إما	ʔ i m m a
زبل	z i b l
كتب	k u t u b
صواع	sˤ i w a ʕ
فعلا	f i ʕ l a n
بعيد	b a ʕ i d
هيبة	h a j b a
مستشرق	m u s t a ʃ r i q
أسود	ʔ u s u d
شاخ	ʃ a x a
انتظر	i n t a ðˤ a r a
بارز	b a r a z a
فسا	f a s a
عبد	ʕ a b a d a
بطؤ	b a tˤ u ʔ a
في	f i
قوم	q a w m
غائر	ɣ a ʔ i r
فراسيون	f a r a s i j u n
سيرج	s i r i d͡ʒ
بغلة	b a ɣ l a
قدوم	q a j d u m
هناك	h u n a k a
توقف	t a w a q q a f a
صعب	sˤ a ʕ b
سكرجة	s u k r u d͡ʒ a
فتق	f a t q
عتيق	ʕ a t i q
تزحلق	t a z a ħ l u q
بح	b a ħ ħ a
تصنيف	t a sˤ n i f
رضيع	r a dˤ i ʕ
عرقي	ʕ i r q i j j
مبارك	m u b a r i k
إياك	ʔ i j j a k a
رئيسي	r a ʔ i s i j j
غالب	ɣ a l i b
صاقور	sˤ a q u r
قديم	q a d i m
قسطاس	q u s tˤ a s
فاوض	f a w a dˤ a
قيثارة	q i θ a r a
تحريضي	t a ħ r i dˤ i j j
عضلة	ʕ a dˤ a l a
لو	l a w
بلور	b i l l a w r
ساهور	s a h u r
البهاما	a l b a h a m a
أوروغواي	ʔ u r u ɣ u w a j
برذون	b i r ð a w n
سمن	s a m m a n a
طل	tˤ u l
شيمة	ʃ i m a
بالوعات	b a l u ʕ a t
شاهدانج	ʃ a h d a n a d͡ʒ
علل	ʕ a l l a l a
معقود	m a ʕ q u d
سمع	s a m ʕ
جامعة	d͡ʒ a m i ʕ a
اكتسب	i k t a s a b a
سيكران	s a j k a r a n
صراط	sˤ i r a tˤ
نوفمبر	n u f i m b i r
آدمي	ʔ a d a m i j j
صربيا	sˤ i r b i j a
عبقري	ʕ a b q a r i j j
مطار	m a tˤ a r
جدوار	d͡ʒ a d w a r
قهوة	ɡ h a w a
طباخ	tˤ a b b a x
أخرس	ʔ a x r a s
أسارون	ʔ a s a r u n
عظم	ʕ a ðˤ u m a
طعن	tˤ a ʕ a n a
شاي	ʃ a j
أكتوبر	ʔ u k t u b i r
مؤتمر	m u ʔ t a m a r
متنوع	m u t a n a w w i ʕ
هو	h u w a
درياق	d i r j a q
أرز	ʔ u r u z z
بذرقطونا	b a ð r a q a tˤ u n a
أيلول	ʔ a j l u l
فضي	f i dˤ dˤ i j j
جناح	d͡ʒ a n a ħ
تجدد	t a d͡ʒ a d d a d a
شلة	ʃ i l l a
صاخب	sˤ a x i b
شهادة	ʃ a h a d a
تعفج	t a ʕ a f f a d͡ʒ a
ساج	s a d͡ʒ
وجيز	w a d͡ʒ i z
قرطاس	q i r tˤ a s
تساوى	t a s a w a
فقوس	f a q q u s
صلصال	sˤ a l sˤ a l
غد	ɣ a d
مذاق	m a ð a q
قيطون	ɡ a tˤ u n
قيراط	q i r a tˤ
فرفيري	f i r f i r i j j
طاح	tˤ a ħ a
حكومي	ħ u k u m i j j
تضرر	t a dˤ a r r u r
مساحة	m a s s a ħ a
قلوي	q i l w i j j
بس	b a s s a
إنما	ʔ i n n a m a
أعياد	ʔ a ʕ j a d
مفتش	m u f a t t a ʃ
صيني	sˤ i n i j j
نظر	n i ðˤ r
نيكاراغوا	n i k a r a ɣ u w a
إ	ʔ i
ق	q
هويات	h u w i j j a t
ثقيل	θ a q i l
تنفس	t a n f u s a
عبوة	ʕ u b u w w a h
مارس	m a r s
ساط	s a tˤ a
واعد	w a ʕ a d a
قبر	ɡ a b u r
قسيس	q i s s i s
هراوى	h a r a w a
كراوية	k a r a w i j a
أذن	ʔ a ð n
دائخ	d a ʔ i x
تشنج	t a ʃ a n n u d͡ʒ
أذن	ʔ u ð u n
إنبيق	ʔ i n b i q
اعتاد	i ʕ t a d a
رسول	r a s u l
اختبأ	i x t a b a ʔ
سكن	s a k a n a
طربوش	tˤ a r b u ʃ
فارغ	f a r i ɣ
لهجة	l a h d͡ʒ a
قوت	q u t
جميل	ɡ a m i l
محلي	m u ħ a l l i
بقية	b a q i j j a
أدار	ʔ a d a r a
أعل	ʔ a ʕ a l l a
مسطرة	m i s tˤ a r a
شدة	ʃ a d d a
فريسة	f a r i s a
تعذب	t a ʕ a ð ð a b a
تنامى	t a n a m a
ودج	ʔ a w d a d͡ʒ
مدرك	m u d r i k
سوس	s a w w a s a
برعم	b u r ʕ u m
ولد	w a l a d a
عيد	ʕ i d
قوض	q a w w a dˤ a
جمل	ɡ æ m ɛ l
ثعبان	t u ʕ b a n
أحاط	ʔ u ħ a tˤ a
كتاب	k u t t a b
أله	ʔ a l l a h a
صغر	sˤ i ɣ a r
ضاحية	dˤ a ħ i j a
جعفر	d͡ʒ a ʕ f a r
حسنا	ħ a s a n a n
مربى	m u r a b b a
بارزذ	b a r z a ð
مونتريال	m u n t r i j a l
أربعون	ʔ a r b a ʕ u n a
زها	z a h a
انقلاب	i n q i l a b
إسكتلندي	ʔ i s k u t l a n d i j j
عميق	ʕ a m i q
تقيأ	t a q a j j a ʔ a
فرث	f a r i θ a
رجل	r i d͡ʒ l
ڤ	v
جمعة	d͡ʒ u m u ʕ a
موضوع	m a w dˤ u ʕ
نجار	n u d͡ʒ a r
سنور	s i n n a w r
بعلبك	b ʕ a l b a k
ندوة	n u d u w w a
بكى	b a k a
شهل	ʃ u h l
استل	i s t a l l a
سمع	s a m m a ʕ a
كراج	ɡ a r a d͡ʒ
ضرب	dˤ a r u b a
قبر	ɡ u b b a r
قوقع	q a w q a ʕ
تطبب	t a tˤ a b b a b a
سماد	s a m a d
زود	z a w w a d a
مليار	m i l j a r
أنا	ʔ a n a
فيديو	v i d i j o
أشخص	ʔ a ʃ x a sˤ a
خيزران	x a j z u r a n
سبتمبر	s i b t i m b a r
أسهل	ʔ u s a h h i l a
كراز	k u r r a z
حبق	ħ a b a q a
كهرباء	k a h r a b a ʔ
جمعة	d͡ʒ u m a ʕ a
قافلة	q a f i l a
طوب	tˤ u b
هذى	h a ð a
مات	m ō t
حورية	ħ u r i j j a
معير	m u ʕ i r
هو	h u w a h
ذبابة	ð u b a b a
غباوة	ɣ a b a w a
شبع	ʃ a b i ʕ a
أوركسترا	ʔ o r k e s t r a
غضب	ɣ a dˤ i b
منام	m a n a m
منطقي	m a n tˤ i q i j j
شيطاني	ʃ a j tˤ a n i j j
أمس	ʔ a m s
نسيئة	n a s i ʔ a
حوراء	ħ a w r a ʔ
طقس	tˤ a q i sˤ
أشم	ʔ a ʃ a m m
دجاجة	d a d͡ʒ a d͡ʒ a
استحوذ	i s t a ħ w a ð a
تزدان	t a z d a n u
أجوف	ʔ a d͡ʒ w a f
طير	tˤ a j r
دب	d a b b
سحلية	s i ħ l i j j a
قرر	ɡ a r r a r
شرطة	ʃ a r tˤ a
فهم	f a h i m a
قد	q a d d a
تنرفز	t a n a r f a z a
ساسم	s a s a m
وجهة	w i d͡ʒ h a
مغنم	m a ɣ n a m
انبغى	i n b a ɣ a
بولندا	b o l a n d a
تنقض	t a n q a dˤ i
جسامة	d͡ʒ a s a m a
ها	h a
أتوبيس	ʔ o t o b i s
مصراع	m i sˤ r a ʕ
بليلة	b a l i l a
قصبة	q a sˤ a b a
زق	z a q q
غضب	ɣ a dˤ i b a
زربطانة	z a r b a tˤ a n a
وسخ	w a s i x
تنور	t a n a w w a r a
منشفة	m i n ʃ a f a
جحر	d͡ʒ u ħ r
مشهور	m a ʃ h u r
تدرج	t a d a r r a d͡ʒ a
كيول	k a j j u l
جلوز	d͡ʒ i l l a w z
قلاووظ	q a l a w u ðˤ
ضفدع	dˤ u f d u ʕ
حكومة	ħ u k u m a
سن	s a n n
ش	ʃ
جهنم	d͡ʒ a h a n n a m
أكيد	ʔ a k i d
ظ	ðˤ
انقد	i n q a d d a
شوكولاتة	ʃ o k o l a t a
طلع	tˤ a l i ʕ a
مائدة	m a ʔ i d a
لهيب	l a h i b
ألفبائي	ʔ a l i f b a ʔ i j j
ط	tˤ a ʔ
نشيد	n a ʃ i d
جذوع	d͡ʒ u ð u ʕ
مفلس	m u f l i s
رفأ	r a f a ʔ a
إكاف	ʔ i k a f
منتصف	m u n t a sˤ a f
تكدس	t u k a d d a s u
سكافة	s i k a f a
نور	n a w w a r a
عيان	ʕ i j a n
يورو	j u r o
غرب	ɣ a r a b a
آخن	ʔ a x a n
أحبك	ʔ u ħ i b b u k i
تشخيصي	t a ʃ x i sˤ i j j
سن	s a n n a
غرين	ɣ a r i n
خبز	x u b z
تكدس	t u k a d d a s a
قسر	q a s a r a
قلب	q u l l a b
لندني	l a n d a n i j j
رباعيات	r u b a ʕ i j j a t
معدوم	m a ʕ d u m
جدا	d͡ʒ i d d a n
عمان	ʕ u m a n
دخل	d a x l
شجو	ʃ a d͡ʒ w
سريش	s a r i ʃ
الإمارات	a l ʔ i m a r a t
أفسنتين	ʔ a f s i n t i n
ممتلكات	m u m t a l a k a t
متفرغ	m u t a f a r r i ɣ
موظفة	m u w a ðˤ ðˤ a f a
ثقبة	θ u q b a
المكسيك	a l m a k s i k
جنوب	ɡ a n u b
سيكران	s a j k u r a n
وفق	w a f i q a
جنح	d͡ʒ u n ħ
محمدة	m a ħ m a d a
سلامتك	s a l a m t a k
أتون	ʔ a t t u n
إيانا	ʔ i j j a n a
حلبة	ħ u l b a
بوابة	b a w w a b a
سربال	s i r b a l
أرثوذكسي	ʔ u r θ u ð u k s i j j
قدوم	q a d d u m
بثرات	b a θ a r a t
بلغاريا	b a l ɣ a r i j a
وجد	w a d͡ʒ d
نساء	n a s a ʔ
فلاديمير	f l a d i m i r
رحب	r a ħ b
بردقوش	b a r d a q u ʃ
ساذج	s a ð a d͡ʒ
تنفس	t a n a f f u s
طالب	tˤ a l i b
سجا	s a d͡ʒ a
رقابة	r a q a b a
شمسية	ʃ a m s i j j a
فاجأ	f a d͡ʒ a ʔ a
شاورما	ʃ a w i r m a
قرن	q a r n
مكياج	m ɪ k j ɑ d͡ʒ
غلب	ɣ a l a b
وتيرة	w a t i r a
ليموني	l a j m u n i j j
ر	r
تحرش	t u ħ a r r a ʃ
تراوح	t a r a w a ħ a
صمغ	sˤ a m ɣ
عناية	ʕ a n a j a
قيمة	q i m a
ثقافي	θ a q a f i j j
تلفون	t u l f u n a
بلجيكا	b e l d͡ʒ i k a
طبعة	tˤ a b ʕ a
عناب	ʕ u n n a b
مبرة	m ə b ə r ə
نتف	n a t a f
استعمار	i s t i ʕ m a r
جولق	d͡ʒ a w l a q
دهس	d a h s
بشملة	b a ʃ m a l a
شخص	ʃ a x sˤ
شجيع	ʃ a d͡ʒ i ʕ
ثداء	θ u d d a ʔ
قرصعنة	q u r sˤ a ʕ a n n a
ملك	m u l l a k
نبات	n a b a t
مخيط	m i x j a tˤ
زميلات	z a m i l a t
مسيح	m a s i ħ
مؤمن	m u ʔ m a n
مصباح	m i sˤ b a ħ
تجدد	t a d͡ʒ a d d u d
رحب	r a ħ u b a
قرن	q a r a n a
تنور	t a n n u r
قرد	q a r d
مغنيسيوم	m a ɣ n i s i j u m
جثمان	d͡ʒ u θ m a n
خيبة	x a j b a
تصميم	t a sˤ m i m
مسلم	m u s a l l a m
بعر	b a ʕ a r a
طاقم	tˤ a q i m
قدم	q a d a m a
معدة	m i ʕ d a
دمي	d a m i j a
الأحد	a l ʔ a ħ a d
تقبض	t a q a b b a dˤ a
أسهل	ʔ u s a h h a l u
زق	z a q q a
عميد	ʕ a m i d
قارب	q a r i b
زاي	z a j
فاسد	f a s i d
مشعاع	m i ʃ ʕ a ʕ
زيار	z i j a r
ريح	r i ħ a
ندبة	n u d b a
أشقر	ʔ a ʃ q a r
أجنبي	ʔ a d͡ʒ n a b i j j
بزق	b a z q
ضمن	dˤ i m n
فلم	f i l m
جربوع	d͡ʒ a r b u ʕ
عاشوراء	ʕ a ʃ u r a ʔ
إستديو	ʔ i s t i d j o
قنص	q a n a sˤ a
مضمون	m a dˤ m u n
ويكي	w i k i
محرك	m u ħ a r r i k
فسح	f a s a ħ a
جنك	d͡ʒ a n k
فلنجة	f a l a n d͡ʒ a
مثنان	m i θ n a n
يوم	j a w m
رجع	r a d͡ʒ ʕ
حسنا	ħ a s s a n n a
ذرة	d u r a
جورجي	d͡ʒ u r d͡ʒ i j j
سرة	s u r r a
تماسك	t a m a s a k a
سائمة	s a ʔ i m a
قراص	q u r r a sˤ
بنت	b i n t i
عيد	ʕ i j a d
مدة	m a d d a
إيارج	ʔ i j a r a d͡ʒ
سيادة	s i j a d a
عصف	ʕ a sˤ a f a
خسئ	x a s i ʔ a
كيلومتر	k i l o m i t e r
كتاب	k i t a b
هن	h a n n a
يرقة	j a r a ʔ a
وصاية	w i sˤ a j a
نضيج	n a dˤ i d͡ʒ
قرص	q u r sˤ
خوخة	x a w x a
فجور	f u d͡ʒ u r
سوس	s u s
بابور	b a b u r
شعري	ʃ i ʕ r i j j
أوكرانيا	ʔ u k r a n i j a
خجول	x a d͡ʒ u l
تكلم	t a k a l l u m
غنيمة	ɣ a n i m a
حق	ħ u q q a
كادس	k a d i s
قطف	q a tˤ a f a
أممي	ʔ u m a m i j j
تعطى	t u ʕ tˤ a
أمي	ʔ u m m i
برتقال	b u r t u q a l
بوذا	b u ð a
جماعة	d͡ʒ a m a ʕ a
قضم	q a dˤ a m
حمل	ħ a m m a l a
جدد	d͡ʒ a d a d
ضمخ	dˤ a m a x a
آذى	ʔ a ð a
بدهي	b a d a h i j j
استوضح	i s t a w dˤ a ħ a
سفينة	s a f i n a
فرن	f u r n
كاكنج	k a k a n d͡ʒ
الحارث	a l ħ a r i θ
مئبر	m i ʔ b a r
غزير	ɣ a z i r
محطة	m a ħ a tˤ tˤ a
قلم	ɡ a l a m
فص	f a sˤ sˤ
حلبوب	ħ u l b u b
ساوم	s a w a m a
أرقان	ʔ a r q a n
صراخة	sˤ a r r a x a
حاد	ħ a d d
فوج	ʔ a f w a d͡ʒ
الأردن	a l ʔ u r d u n n
عقاقير	ʕ a q a q i r
غوشنة	ɣ a w ʃ a n a
و	w ɪ
اعوج	i ʕ w a d͡ʒ d͡ʒ a
ديماس	d a j m a s
طما	tˤ a m a
آسفي	ʔ a s a f i
حندقوق	ħ a n d a q u q
مشأمة	m a ʃ ʔ a m a h
خيمة	x a j m a
طوافة	tˤ a w w a f a
طار	tˤ a r a
عزيمة	ʕ a z i m a
قبة	q u b b a
فلسطين	f i l a s tˤ i n
عندما	ʕ i n d a m a
أذن	ʔ a ð ð a n a
ولى	w a l l a
ترمس	t i r m i s
تأثير	t a ʔ θ i r
كمء	k a m ʔ
لام	l a m
مختلف	m u x t a l i f
سكنجبين	s i k a n d͡ʒ a b i n
أسهل	ʔ u s a h h i l u
عنبر	ʕ a n b a r
ضعيف	dˤ a ʕ i f
علف	ʕ æ l æ f
بليج	b a l l i d͡ʒ
غباء	ɣ a b a ʔ
خروف	x a r u f
فوج	f a w d͡ʒ
مكمل	m u k a m m i l
متجر	m a t d͡ʒ a r
لهى	l a h h a
مقالة	m a q a l a
بصق	b a sˤ a q a
الخميس	a l x a m i s
كرباج	k u r b a d͡ʒ
هراوات	h i r a w a t
خوخ	x a w x
مجسمة	m u d͡ʒ a s s a m a
حيصل	ħ a j sˤ a l
بطاطس	b a tˤ a tˤ i s
نظام	n i ðˤ a m
حش	ħ a ʃ ʃ a
شامبو	ʃ a m b u
حصوة	ħ a sˤ w a
ذخيرة	ð a x i r a
مأساة	m a ʔ s a h
فرقاطة	f u r q a tˤ a
مستقبلي	m u s t a q b a l i j j
حقد	ħ a q a d a
تمرد	t a m a r r u d
قرش	q a r a ʃ a
كثير	k a θ i r
براعة	b a r a ʕ a
لامبالاة	l a m u b a l a h
افترى	i f t a r a
رجع	r a d͡ʒ d͡ʒ a ʕ a
محقق	m ʊ ħ ɐ q q ɪ q
خطف	x a tˤ f
مولدوفا	m o l d o f a
أمس	ʔ a m a s s u
لاحق	l a ħ a q a
أبدية	ʔ a b a d i j j a
مداخل	m u d a x a l
مرحلة	m a r ħ a l a
إبريق	ʔ i b r i ɡ
مناقض	m u n a q i dˤ
استمسك	i s t a m s a k a
بناية	b i n a j a
كرى	k a r a
فطيسة	f a tˤ i s a
كلب	k a l b
مطعم	m a tˤ ʕ a m
فلان	f l ɑ n
مهاجر	m u h a d͡ʒ i r
صدم	sˤ a d a m a
سذاجة	s a ð a d͡ʒ a
أخطبوط	ʔ u x tˤ u b u tˤ
حرج	ħ a r i d͡ʒ a
لكمة	l a k m a
وردة	w u r d a
سكسكة	s a k s a k a
فتاة	f a t a h
مطحنة	m i tˤ ħ a n a
حمل	ħ i m l
بارزد	b a r z a d
خشخاش	x a ʃ x a ʃ
سياسة	s i j a s a
عيسى	ʕ i s a
ماه	m a h a
لغة	l ʊ ʁ ə
وابور	w a b u r
تعزب	t a ʕ a z z a b a
هجليج	h i d͡ʒ l i d͡ʒ
فلاديمير	v l a d i m i r
مجلس	m a d͡ʒ l i s
جيد	d͡ʒ i d
أورانيوم	ʔ u r a n j u m
هم	h a m m a
شافانج	ʃ a f a n a d͡ʒ
بدنة	b a d a n a
معتزلة	m u ʕ t a z i l a
طبي	tˤ i b b i j j
جربندية	d͡ʒ a r a b a n d i j j a
ناووس	n a w u s
ب	b
قبر	ɡ a b i r
طلح	tˤ a l ħ
تكدس	t u k d a s
سمن	s u m n a
رفس	r a f a s a
استضاف	i s t a dˤ a f a
ضريبة	dˤ a r i b a
قسم	q a s s a m a
حب	ħ a b b a
حرشف	ħ a r ʃ a f
خرنق	x i r n i q
مصلى	m u sˤ a l l a n
أشار	ʔ a ʃ a r a
السويد	a s s u w a j d
ترقوة	t a r q u w a
طاعون	tˤ a ʕ u n
مزدهر	m ʊ z d æ h ɪ r
ترنج	t u r u n d͡ʒ
خرج	x u r d͡ʒ
ضحك	dˤ a ħ ħ a k a
زجاجة	z u d͡ʒ a d͡ʒ a
موسيقا	m u s i q a
بعير	b a ʕ i r
جدوى	d͡ʒ a d w a
حوار	ħ i w a r
بحر	b a ħ a r
حبرج	ħ u b r u d͡ʒ
استثمار	i s t i θ m a r
تواقف	t a w a q u f
سليل	s a l i l
شهر	ʃ a h r
معجزات	m u ʕ d͡ʒ i z a t
مغلوب	m a ɣ l u b
عطارد	ʕ u tˤ a r i d
رغف	r u ɣ u f
أمامي	ʔ a m a m i j j
اكتفاء	i k t i f a ʔ
شريان	ʃ i r j a n
معاداة	m u ʕ a d a h
ذكر	ð a k a r
بذلة	b i ð l a
ملاكمة	m u l a k a m a
عكاز	ʕ u k k a z
عيد	ʕ i d a
جدد	d͡ʒ u d a d
أين	ʔ a j n
بروناي	b r u n a j
حجاب	ħ i ʒ a b
صوف	sˤ u f
أكل	ʔ u k u l
أفرغ	ʔ a f r a ɣ a
غرلة	ɣ u r l a
رح	r u ħ
هنغاري	h i n ɣ a r i j j
الفرات	a l f u r a t
تبغ	t i b ɣ
صندوق	sˤ a n d u q
ورى	w ɐ r ə
أريكة	ʔ a r i k a
براني	b a r r a n i j j
سرداب	s i r d æ b
جذر	d͡ʒ a ð ð a r a
واجهة	w a d͡ʒ i h a
حسنا	ħ a s u n n a
منصب	m a n sˤ i b
عراك	ʕ i r a k
ملوكية	m u l u k i j j a
إزميل	ʔ i z m i l
ملعقة	m i l ʕ a q a
أنتم	ʔ a n t u m
ج	d͡ʒ
ميثاق	m i θ a q
إنتاج	ʔ i n t a d͡ʒ
خرنباش	x a r a n b a ʃ
تلك	t i l k a
قطران	q a tˤ r a n
مغن	m u ɣ a n n i n
تحرش	t u ħ a r r i ʃ a
حوجلة	ħ a w d͡ʒ a l a
ربما	r u b b a m a
باحث	b a ħ i θ
نصاب	n a sˤ sˤ a b
فلس	f a l a s a
خبر	x a b b a r a
حادث	ħ a d a θ a
سليخة	s a l i x a
كيف	k a j j a f a
هنغاريا	h a n ɣ a r i j a
عيني	ʕ a j n i j j
شبعان	ʃ a b ʕ a n
نحن	n a ħ n u
نشل	n a ʃ l
ث	θ a ʔ
رد	r i d
مذيع	m u ð i ʕ
بقي	b i ɡ i
نفوذ	n a f u ð
بوذية	b u ð i j j a
مشط	m u ʃ tˤ
سافانا	s a f a n a
كسرة	k a s r a
أجاب	ʔ u d͡ʒ a b u
أحاط	ʔ u ħ a tˤ u
قريب	q a r i b
جراحة	d͡ʒ i r a ħ a
أوجد	ʔ a w d͡ʒ a d a
بقس	b a q s
مبكر	m u b a k k i r
مكان	m a k a n
دين	d i n
بيلادونا	b i l a d u n a
بضاعة	b i dˤ a ʕ a
بزق	b a z a q a
نشادر	n u ʃ a d i r
قهوة	ɡ a h w ɛ
رقبة	r a q a b a
رقم	r a ɡ i m
خبط	x a b tˤ
مصطار	m u sˤ tˤ a r
ذكر	ð i k r
دشداشة	d i ʃ d a ʃ a
قرمزي	q i r m i z i j j
تايوان	t a j w a n
فسح	f a s ħ
حلقوم	ħ u l q u m
ملك	m a l k
شوى	ʃ a w a
باقة	b a q a
معطف	m i ʕ tˤ a f
شابانك	ʃ a b a n a k
حصرم	ħ i sˤ r i m
درجة	d a r a d͡ʒ a
آخرة	ʔ a x i r a
دين	d i n a
هود	h a w w a d a
جسماني	d͡ʒ u s m a n i j j
بحريني	b a ħ r a j n i j j
استنفاد	i s t i n f a d
ليبيا	l i b i j a
إردب	ʔ a r d a b b
مكتب	m a k t a b
ارتقب	i r t a q a b a
مفك	m i f a k k
عاطف	ʕ a tˤ i f
لواء	l i w a ʔ
تحكيم	t a ħ k i m
منطقة	m i n tˤ a q a
جنة	d͡ʒ a n n a
اشهل	i ʃ h a l l a
أسطول	ʔ u s tˤ u l
بصير	b a sˤ i r
تنفس	t u n f a s a
متشكر	m u t a ʃ a k k i r
منقار	m i n ɡ a r
استبحر	i s t a b ħ a r a
هزيمة	h a z i m a
سوق	s a w w a q a
وقود	w a q u d
كوريا	k o r i j a
بري	b a r r i
ملاقاة	m u l a q a h
كرك	k u r k
غضاضة	ɣ a dˤ a dˤ a
فارع	f æ r i ʕ
اصطك	i sˤ tˤ a k k a
قلب	q a l b
سنبوسق	s a m b u s a q
جنيه	ɡ u n e h
أي	ʔ a j j
أشكل	ʔ a ʃ k a l
ض	ɮˤ
ثم	θ a m m a
كفات	k i f a t
الاثنين	ʔ a l i θ n a j n i
خواتم	x a w a t i m
فدن	f a d a n
وضح	w a dˤ a ħ a
كنز	k a n z
ذليل	ð a l i l
يوجوسلافيا	j u ɡ o s l a v i j a
رخخة	r i x a x a
كافر	k a f i r
مرتفع	m u r t a f i ʕ
تأوه	t a ʔ a w w u h
دم	d a m
لها	l a h a
فوطة	f u tˤ a
جدر	d͡ʒ a d u r a
نقحر	n a q ħ a r a
ربوة	r u b w a
كرها	k a r h a n
نمط	n a m a tˤ
قوقعة	q a w q a ʕ a
دائرة	d a ʔ i r a h
مخطوب	m a x tˤ u b
عبودية	ʕ u b u d i j j a h
شريان	ʃ a r j a n
تنفس	t u n a f f i s u
أيهقان	ʔ a j h u q a n
هذا	h a d a
نورس	n a w r a s
مشاية	m a ʃ ʃ a j a
صاد	sˤ a d a
ثانوي	θ a n a w i j j
سكرتير	s i k r i t i r
تسعون	t a s ʕ a w n a
سينمائي	s i j n a m a ʔ i j j
واقعي	w a q i ʕ i j j
لك	l a k k
ناقض	n a q i dˤ
أوزبكستان	ʔ u z b a k i s t a n
ي	j a ʔ
بطالة	b a tˤ a l a
طومار	tˤ u m a r
ريوند	r i w a n d
عادة	ʕ a d a
لله	l i l l a h
ألمانيا	ʔ a l m a n i j a
فلسطين	f a l a s tˤ i n
سنونية	s u n u n i j a
معجزة	m ʊ ʕ d͡ʒ ɪ z a
سروال	s i r w a l
رساطون	r a s a tˤ u n
طلا	tˤ a l a n
خزانة	x i z a n a
حرامي	ħ a r a m i j j
بقس	b u q s
قاض	q a dˤ a
دومان	d u m a n
ظبي	ðˤ a b j
تعلة	t a ʕ i l l a
قاسم	q a s i m
استدعى	i s t a d ʕ a
تفاحة	t u f f a ħ a
أصهب	ʔ a sˤ h a b
تحالف	t a ħ a l u f
حرير	ħ ɑ r i r
سليقة	s a l i q a
صابح	sˤ a b a ħ a
جمجمة	d͡ʒ u m d͡ʒ u m a
سحاب	s a ħ a b
كيف	k a j f
إبرة	ʔ i b r a
خارجي	x a r i d͡ʒ i j j
صنعة	sˤ a n ʕ a
طائر	tˤ a ʔ i r
حمل	ħ a m l
نرويجية	n u r w i d͡ʒ i j j a
رياضة	r i j a dˤ a
أمراء	ʔ u m a r a ʔ
مجلة	m a d͡ʒ a l l a
لحظ	l a ħ a ðˤ a
سكين	s i k k i n
مضمار	m i dˤ m a r
هدهد	h a d h a d a
قشر	ɡ a ʃ ʃ a r
شبوط	ʃ a b b u tˤ
ديسق	d i s a q
مشربة	m a ʃ r a b a
تنزانيا	t a n z a n j a
تحت	t a ħ t u
طعام	tˤ a ʕ a m
فاثور	f a θ u r
بعثران	b a ʕ θ a r a n
تكدس	t a k d i s
رمى	r a m a
دولي	d a w l i j j
يسار	j u s a r r a
تدخين	t a d x i n
طرمبة	tˤ r o m b a
محام	m u ħ a m i n
سريع	s a r i ʕ
دقيق	d a ɡ i ɡ
تالي	t a l i
مصفاة	m i sˤ f a h
سيء	s i ʔ a
سنونو	s u n u n u
أ	ʔ u
ثوم	θ u m
بلجيكي	b i l d͡ʒ i k i j j
قداد	q i d a d
حمزة	ħ a m z a
قرانيا	q a r a n i j a
توجو	t o ɡ o
مسعور	m a s ʕ u r
رجل	r a d͡ʒ i l
أشل	ʔ a ʃ a l l a
أشترغار	ʔ u ʃ t u r ɣ a r
كوسا	k u s a
قاتم	q a t i m
مجرم	m u d͡ʒ r i m
عجب	ʕ a d͡ʒ d͡ʒ a b a
خراب	x a r a b
أزدرخت	ʔ a z d a r x a t
أفرع	ʔ a f r u ʕ
علني	ʕ a l a n i j j
لسان	l i s a n
ثلاثة	θ a l a θ a h
زكريا	z a k a r i j j a
أسياخ	ʔ a s j a x
طوارئ	tˤ a w a r i ʔ
شيطان	ʃ a j tˤ a n
أنبيق	ʔ a n b i q
ز	z
ناصور	n a sˤ u r
غرق	ɣ a r a ɡ
محاضرة	m u ħ a dˤ i r a
خالف	x a l a f a
سفرة	s u f r a
نفض	n a f a dˤ a
سحابة	s a ħ a b a
صودا	sˤ o d a
حجفة	ħ a d͡ʒ a f a
سكرجة	s u k u r r u d͡ʒ a
توأم	t a w ʔ a m
طلمبة	tˤ u l u m b a
غرابيل	ɣ a r a b i l
شاطئ	ʃ a tˤ i ʔ
نخل	n a x l
فيديو	f i d i j u
تنحى	t a n a ħ ħ a
طرطور	tˤ a r tˤ u r
فيلم	f i l m
فلس	f a l s
ا	ʔ a l i f
طويل	tˤ a w i l
محاور	m a ħ a w i r
غلب	ɣ a l i b a
ماهاراجا	m a h a r a d͡ʒ a
ثم	θ u m m a
وسام	w i s a m
شقة	ʃ a q q a
كراز	k u r a z
شدياق	ʃ i d j a q
لله	l a ɫ ɫ a h
سيخي	s i x i j j
إيجاد	ʔ i d͡ʒ a d
مجنون	m a d͡ʒ n u n
عقيق	ʕ a q i q
بدلة	b a d l a
دوى	d a w a n
مؤشر	m u ʔ a ʃ ʃ i r
روح	r a w ħ
أرقان	ʔ a r ɡ a n
قطران	q a tˤ a r a n
تكفيري	t a k f i r i j j
مؤلف	m u ʔ a l l a f
اصطلاح	i sˤ tˤ i l a ħ
امرأ	i m r a ʔ a n
مهاجم	m u h a d͡ʒ i m
لألأ	l a ʔ l a ʔ a
أخلاط	ʔ a x l a tˤ
قطعة	q i tˤ ʕ a
مربوط	m a r b u tˤ
هجليج	h a d͡ʒ l i d͡ʒ
اقتاد	i q t a d a
طموح	tˤ u m u ħ
زواج	z a w a d͡ʒ
أردمون	ʔ a r d a m u n
سحم	s a ħ a m
جرابي	d͡ʒ i r a b i j j
نعوظ	n u ʕ u ðˤ
قطع	q a tˤ tˤ a ʕ a
إجاص	ʔ i d͡ʒ d͡ʒ a sˤ
دزينة	d a z z i n a
ضمان	dˤ a m a n
وراثة	w i r a θ a
وظف	w u ðˤ u f
إباحي	ʔ i b a ħ i j j
بريمة	b a r r i m a
تاجورة	t a d͡ʒ u r a
صدرية	sˤ a d r i j j a
تأسف	t a ʔ a s s a f a
سمك	s a m a k
الأرثوذكسية	a l ʔ u r θ u ð u k s i j j a
طبيب	tˤ a b i b
معدات	m u ʕ a d d a t
عل	ʕ a l l a
شمندورة	ʃ a m a n d u r a
جاف	d͡ʒ a f f
تعالم	t a ʕ a l a m a
رقبة	r a ɡ a b a
مجاور	m u d͡ʒ a w i r
دستور	d u s t u r
فضح	f a dˤ a ħ a
جبت	d͡ʒ i b t
أ	ʔ
و	o
درونج	d a r a w n i d͡ʒ
دوغ	d u ɣ
بسبب	b i s a b a b i
طاق	tˤ a q a
كهرمان	k a h r a m a n
لئلا	l i ʔ a l l a
هو	w a h w a
فيديو	v i d j u
زرشك	z a r r a ʃ k
ترك	t u r k
كابلي	k a b u l i j j
زغلول	z a ɣ l u l
سبعة	s a b ʕ a
بورما	b u r m a
ذاب	ð a b a
جفنة	d͡ʒ a f n a
رقف	r a q a f
عرعر	ʕ a r ʕ a r
سلطوية	s u l tˤ a w i j j a
هن	h u n n a
كوب	k u b
برعم	b a r ʕ a m a
مجمر	m i d͡ʒ m a r
المرء	a l m a r ʔ
عجور	ʕ a d͡ʒ d͡ʒ u r
نخاع	n u x a ʕ
أغسطس	ʔ a ɣ u s tˤ u s
يبروح	j a b r u ħ
ذريع	ð a r i ʕ
متعة	m u t ʕ a
فراغ	f u r r a ɣ
بحيرة	b u ħ a j r a
فركس	f i r k i s
حرص	ħ a r a sˤ a
جبل	d͡ʒ a b a l
محمد	m a ħ m i d
قرص	q a r sˤ
طرز	tˤ a r r a z a
شمعة	ʃ a m a ʕ a
مري	m u r r i j j
ضحك	dˤ a ħ k
مسرحي	m a s r a ħ i j j
اندلع	i n d a l a ʕ a
بيعة	b i ʕ a
منفاخ	m i n f a x
كراز	k a r r a z
مدغشقر	m a d a ɣ a ʃ q a r
محايد	m u ħ a j i d
بطريركية	b a tˤ r i j a r k i j j a
بساط	ʔ a b s i tˤ a
سؤال	s u ʔ ʔ a l
غواتيمالا	ɣ w a t i m a l a
أفك	ʔ a f a k a
نظف	n a ðˤ ðˤ a f a
ديماس	d i m a s
نخروبي	n u x r u b i j j
أين	ʔ a j n a
تجنب	t a d͡ʒ a n n u b
إمناء	ʔ i m n a ʔ
معلم	m u ʕ a l l i m
شيء	ʃ a j ʔ
أفرغ	ʔ a f r a ɣ
خرمال	x u r m a l
مسدس	m u s a d d a s
الصومال	a sˤ sˤ u m a l
ضوأ	dˤ a w w a ʔ a
معتقل	m u ʕ t a q a l
إتاوة	ʔ i t a w a
القرآن	a l q u r ʔ a n
عاطفي	ʕ a tˤ i f i j j
خاف	x a f a
وجب	w a d͡ʒ d͡ʒ a b a
غربة	ʁ ʊ r b ɐ
تم	t a m m a
محاضر	m u ħ a dˤ a r
أنجدان	ʔ a n d͡ʒ u d a n
دنيا	d u n j a
أضمر	ʔ a dˤ m a r
نظر	n a ðˤ a r a
دكتور	d u k t u r
بظر	b ɑ ðˤ r
ديسق	d a j s a q
ميمنة	m a j m a n a
قسطاس	q i s tˤ a s
أخامص	ʔ a x a m i sˤ
جشاء	d͡ʒ u ʃ a ʔ
دجاج	d a d͡ʒ a d͡ʒ
أسفراج	ʔ a s f a r a d͡ʒ
أدكن	ʔ a d k a n
عقال	ʕ u q q a l
هل	h a l
فصح	f a sˤ u ħ a
مجدد	m u d͡ʒ a d d i d
لذلك	l i ð a l i k a
متأخرا	m u t a ʔ a x x i r a n
مقع	m a q a ʕ a
سبتمبر	s i b t a m b i r
تقدم	t a q a d d a m a
فرمل	f a r m a l a
عار	ʕ a r a
مرآة	m i r ʔ a h
أساس	ʔ a s a s
هجرة	h i d͡ʒ r a
مخصوص	m a x sˤ u sˤ
انبثق	i n b a θ a q a
إذا	ʔ i ð a
سليلة	s a l i l a
بطاء	b i tˤ a ʔ
قفص	q a f a sˤ
فسافس	f a s a f i s
غرد	ɣ a r r a d a
لهجة	l a h ʒ a
حاز	ħ a z a
تطوان	t a tˤ w a n
سرقسطة	s a r a q u s tˤ a
تسعة	t i s ʕ a
تساوى	t u s a w a
معدة	m a ʕ d a
يربوز	j a r b u z
عزى	ʕ a z z a
قبو	q a b w
أحول	ʔ a ħ w a l
اطرد	i tˤ tˤ a r a d a
قندهار	q u n d u h a r
سيف	s a j f
تونس	t u n u s
مثل	m u θ u l
دخس	d u x a s
حقبة	ħ i q b a
قشدة	q i ʃ d a
ادعى	i d d a ʕ a
مصطلح	m u sˤ tˤ a l a ħ
كره	k a r h
أوشك	ʔ a w ʃ a k a
غامض	ɣ a m i dˤ
وصفة	w a sˤ f a
سماوي	s a m a w i j j
تناوم	t a n a w a m a
أسف	ʔ a s i f a
أبرز	ʔ a b r u z
صولجان	sˤ a w l a d͡ʒ a n
جلاد	d͡ʒ a l l a d
السلفادور	a s s a l f a d u r
تومان	t u m a n
دعا	d a ʕ a
قاوونة	q a w u n a
قهوة	q a h w a
شجا	ʃ a d͡ʒ a
ديسمبر	d i s i m b i r
حقل	ħ a q l
همزة	h u m a z a
فستان	f u s t a n
النرويج	a n n u r w i d͡ʒ
شار	ʃ a r i n
أقضى	ʔ u q dˤ a
إسماعيل	ʔ i s m a ʕ i l
استغنى	i s t a ɣ n a
مغسلة	m a ɣ s a l a
معهد	m a ʕ h a d
كوج	k u d͡ʒ
مرماخور	m a r m a x u r
تاج	t a d͡ʒ
الجمعة	a l d͡ʒ u m ʕ a
شمس	ʃ a m s
إبليز	ʔ i b l i z
ليت	l a j t a
انشقاق	i n ʃ i q a q
معدة	m a ʕ i d a
يسار	j u s a r u
دخان	d u x a n
نصراني	n a sˤ r a n i j
ترانزستور	t r a n z i s t u r
واقع	w ɑ q i ʕ
كوشاد	k u ʃ a d
قنينة	q i n n i n a
مرجل	m i r d͡ʒ a l
ثمن	θ u m u n
صدر	sˤ u d i r a
طلع	tˤ a l a ʕ a
شعبة	ʃ i ʕ b a
طيارة	tˤ a j j a r a
الصويرة	a sˤ sˤ a w i r a
شحاذ	ʃ a ħ ħ a ð
عجيب	ʕ a d͡ʒ i b
حصرم	ħ u sˤ r u m
حمام	ħ a m a m
استدل	i s t a d a l l a
الأربعاء	a l ʔ a r b i ʕ a ʔ
ذروة	ð u r w a
مغرور	m a ɣ r u r
زربية	z a r b i j j a
قاسم	ɡ a s i m
شاشة	ʃ a ʃ a
قنديل	q a n d i l
تنديل	t i n d i l
إنجليزي	ʔ i n d͡ʒ i l i z i j j
ولد	w a l a d
و	w a w
خرقة	x i r q a
قهوة	ʔ a h w a
كنار	k a n a r
زفر	z a f a r a
عضوية	ʕ u dˤ w i j j a
بنما	b a n a m a
دوري	d a w r i j j
رأي	r a ʔ j
جاد	d͡ʒ a d a
مثل	m i θ l u
قد	q u d
أعزب	ʔ a ʕ z a b
فيروزي	f a j r u z i j j
أثل	ʔ a θ l a
دردي	d u r d i j j
قائف	q a ʔ i f
بساط	b u s u tˤ
دورة	d a w r a
شوفان	ʃ u f a n
الصين	a sˤ sˤ i n
صفد	sˤ a f a d a
إسرائيل	ʔ i s r a ʔ i l
أطفال	ʔ a tˤ f a l
أخت	ʔ u x t
بليج	b i l l i d͡ʒ
قيافة	q i j a f a
أنموذج	ʔ u n m u ð a d͡ʒ
مرفوع	m a r f u ʕ
عوار	ʕ a w a r
أفريقيا	ʔ a f r i q j a
المغرب	a l m a ɣ r i b
غضب	a l ɣ a dˤ a b
عرناس	ʕ a r n a s
ممارسة	m u m a r a s a
كرواتيا	k u r u w a t i j a
إزاء	ʔ i z a ʔ a
تجنى	t a d͡ʒ a n n a
ترك	t a r k
زنباع	z a n b a ʕ
منيرة	m u n i r a
ائتلف	i ʔ t a l a f a
منافس	m u n a f i s
و	w ə
غلاء	ɣ a l a ʔ
منهج	m i n h a d͡ʒ
لاهور	l a h u r
خصوبة	x u sˤ u b a
الأندلس	a l ʔ a n d u l u s
مدرسة	m u d a r r i s a
أن	ʔ a n n a
سنوت	s a n n u t
أسهل	ʔ a s h u l
شدا	ʃ a d a
إصقنقور	ʔ i sˤ q a n q u r
رادف	r a d a f a
نستعليق	n a s t a ʕ l i q
قلنسوة	q a l a n s u w a
قبيلة	q b i l a
أعجمي	ʔ a ʕ d͡ʒ a m i j j
زنبوع	z a n b u ʕ
جمادى	d͡ʒ u m a d a
دورق	d a w r a q
لسان	l s a n
كسوف	k u s u f
استدعاء	i s t i d ʕ a ʔ
تمنى	t a m a n a
جزئي	d͡ʒ u z ʔ i j j
هدد	h a d d a d a
ساء	s a ʔ a
سيناء	s a j n a ʔ
شنبر	ʃ a m b a r
تشرفنا	t a ʃ a r r a f n a
نافورة	n a f u r a
ملك	m a l a k a
مخض	m a x a dˤ a
اهتز	i h t a z z a
جنب	d͡ʒ a n a b a
لؤلؤ	l a w l u ʔ
سكر	s u k k a r
مرزبة	m a r z a b a
زعط	z a ʕ a tˤ a
أعظ	ʔ a ʕ a ðˤ ðˤ a
شمروخ	ʃ u m r u x
تعصب	t a ʕ a sˤ sˤ a b a
تفرغ	t a f a r r u ɣ
جبروت	d͡ʒ a b a r u t
فاحش	f a ħ a ʃ a
تفوق	t a f a w w u q
مازريون	m a z a r j u n
اعتنى	i ʕ t a n a
هائل	h a ʔ i l
تعشق	t a ʕ a ʃ ʃ a q a
طيفورية	tˤ a j f u r i j j a
مسلم	m u s l i m
تجرد	t a d͡ʒ a r r a d a
كبريت	k i b r i t
كيلوغرام	k i l u ɣ r a m
قطمة	q a tˤ m a
صفا	sˤ a f a
هندسة	h a n d a s a
مسمار	m i s m a r
مجموع	m a d͡ʒ m u ʕ
مؤسسة	m u ʔ a s s i s a
سطع	s a tˤ a ʕ a
عنصل	ʕ u n sˤ u l
قاس	q a s i n
جنائي	d͡ʒ i n a ʔ i j j
إنكار	ʔ i n k a r
برمج	b a r m a d͡ʒ a
يرقة	j a r a q a
مخلص	m u x l i sˤ
ابتهج	i b t a h a d͡ʒ a
معدونس	m a ʕ d u n i s
م	m
خبيئة	x a b i ʔ a
بلس	b a l a s
إكسينون	ʔ i k s i n o n
غلقة	ɣ a l q a
أكشف	ʔ a k ʃ a f a
زكوة	z a k a h
نيلي	n i l i j j
عنكبوت	ʕ a n k a b u t
طعن	tˤ a ʕ n
نعل	n a ʕ a l
قريبا	q a r i b a n
زانية	z a n i j a
مدحلة	m i d ħ a l a
تزدان	t a z d a n a
مصعد	m i sˤ ʕ a d
تلقى	t a l a q q a
خلية	x a l i j j a
ساعد	s a ʕ i d
نخاسة	n i x a s a
غمام	ɣ a m a m a
بحر	b a ħ ħ a r a
قسم	q i s m
سيراليون	s i r a l i j u n
خالد	x a l i d
ساعة	s a ʕ a
فنجان	f i n d͡ʒ a n
سخاب	s i x a b
إنترنت	ɪ n t ə r n ə t
هيبة	h i b a
دير	d a j r
فكة	f a k k a
إعلامي	ʔ i ʕ l a m i j j
ثؤلول	θ u ʔ l u l
رحيم	r a ħ i m
قلقاسة	q u l q a s a
شرق	ʃ a r ɡ
كوكبة	k a w k a b a
استنفد	i s t a n f a d a
بيدق	b a j d a q
مرقص	m a r q a sˤ
أكمة	ʔ a k a m a h
خبر	x u b r
ولو	w a l a w
تمسيح	t a m s i ħ
أولمبي	ʔ u l i m b i j j
كان	k a n a
أسى	ʔ a s a n
نخلة	n a x l a
بينما	b a j n a m a
لبن	l a b a n
ميزان	m i z a n
سحم	s a ħ ħ a m a
تكية	t a k i j j a
كتب	k a t t a b a
أستاذ	ʔ u s t a ð
كالون	k a l u n
أضمر	ʔ a dˤ m a r a
كتان	k a t t a n
زوراء	z a w r a ʔ
أريحا	ʔ a r i ħ a
اتهام	i t t i h a m
سلطة	s a l a tˤ a
أديب	ʔ a d i b
سوق	s a w q
فك	f a k k a
طيون	tˤ a j j u n
بلغم	b a l ɣ a m
أدهش	ʔ u d h i ʃ u
رمضان	r a m a dˤ a n
نص	n a sˤ sˤ
و	u
وضب	w a dˤ dˤ a b a
حفر	ħ a f r
مخلص	m u x a l l i sˤ
مسعى	m a s ʕ a n
نحل	n a ħ l
ض	dˤ
حرز	ħ i r z
بواليع	b a w a l i ʕ
أنواع	ʔ a n w a ʕ
هاء	h a ʔ
وضاح	w a dˤ dˤ a ħ
ترسة	t i r s a
هارون	h a r u n
غواصة	ɣ a w w a sˤ a
لائحة	l a ʔ i ħ a
معتبر	m u ʕ t a b i r
تنفس	t u n a f f a s u
رشفة	r a ʃ f a
مرسم	m a r s a m
غربة	ɣ u r b a
هاته	h a t i h i
إمامة	ʔ i m a m a
نشل	n a ʃ a l
منزل	m a n z i l
هندباء	h i n d i b a ʔ
شبابة	ʃ a b b a b a
سلجم	s a l d͡ʒ a m
شاء	ʃ a ʔ
تطبيق	t a tˤ b i q
أتى	ʔ a t a
ماجور	m a d͡ʒ u r
مفرغ	m u f a r r i ɣ
مجلخة	m i d͡ʒ l a x a
ديانات	d i j a n a t
أردف	ʔ a r d a f a
امرأة	i m r a ʔ a
شبح	ʃ u b i ħ a
ارتاح	i r t a ħ a
كرز	k a r a z
تناسق	t a n a s u q
كاشف	k a ʃ i f
عتاب	ʕ i t a b
ديك	d i k
لاهوتي	l a h u t i j j
داليا	d a l i j a
هجوم	h u d͡ʒ u m
غفر	ɣ a f a r a
بكين	b i k i n
ميمون	m a j m u n
علس	ʕ a l a s
لهاث	l u h a θ
معصم	m i ʕ sˤ a m
رومانيا	r u m a n i j a
شهدانق	ʃ a h d a n a q
زيارة	z i j a r a
ء	ʔ
ملك	m a l i k
حمل	ħ a m a l
مالديفز	m a l d i f z
بئس	b a ʔ i s a
سوفياتي	s o v j e t i j j
نعل	n a ʕ a l a
بلاذر	b a l a ð u r
آمن	ʔ a m u n
تحوز	t a ħ a w w a z a
فيديو	v i d j o
الحسيمة	a l ħ u s a j m a
حلتيث	ħ i l t i θ
أرصفة	ʔ a r sˤ i f a
توفى	t a w a f f a
عفريت	ʕ i f r i t
عنق	ʕ u n a q
كوع	k u ʕ
لم	l i m a
متانة	m a t a n a
فيلم	f i l m
أشنة	ʔ u ʃ n a
وظيفة	w a ðˤ i f a
محبس	m a ħ b a s
مقاس	m a ɡ a s
خطئ	x a tˤ i ʔ a
سيماء	s i m a ʔ
استيقظ	i s t a j q a ðˤ a
برج	b u r d͡ʒ
زنزانة	z i n z a n a
أبنوس	ʔ a b n u s
امتعض	i m t a ʕ a dˤ a
أناخ	ʔ a n a x a
أكل	ʔ a k k a l a
رواقية	r i w a q i j j a
فوضى	f a w dˤ a
مدفع	m a d f a ʕ
كتلة	k u t l a
شحاذة	ʃ i ħ a ð a
خيرة	x i r a
بطن	b a tˤ a n a
قرسطون	q a r a s tˤ u n
جرعة	d͡ʒ u r ʕ a
قدم	q a d u m a
كاف	k a f
محب	m u ħ a b b
أفيون	ʔ a f j u n
استخرج	i s t a x r a d͡ʒ a
نذير	n a ð i r
مهرجان	m i h r a d͡ʒ a n
مهلة	m u h l a
شقاء	ʃ a q a ʔ
فلفل	f i l f i l
أناقة	ʔ a n a q a
أغلب	ʔ u ɣ l a b
مدير	m u d i r
عفونة	ʕ u f u n a
موقف	m a w ɡ i f
أفطس	ʔ a f tˤ a s
قرصعنة	q a r sˤ a ʕ a n n a
لمع	l a m a ʕ a
بس	b a s s
أنتما	ʔ a n t u m a
لاسلطوي	l a s u l tˤ a w i j j
زرجون	z a r d͡ʒ u n
راع	r a ʕ a
استفراغ	i s t i f r a ɣ
ميثرة	m i θ a r a
كثيراء	k a θ i r a ʔ
جمهور	d͡ʒ u m h u r
ظاهري	ðˤ a h i r i j j
صفع	sˤ a f a ʕ a
غلط	ɣ a l a tˤ
غرامي	ɣ a r a m i j j
أدحية	ʔ u d ħ i j a
أبان	b a n a
سكون	s u k u n
مظلة	m a ðˤ a l l a
إي	ʔ i
قيطون	ɡ i tˤ o n
حماسة	ħ a m a s a
دكتور	d o k t o r
ح	ħ a ʔ
كمبيوتر	k a m b j u t a r
جبان	d͡ʒ a b a n
جنك	d͡ʒ u n k
حلقوص	ħ a l q u sˤ
رجع	r u d͡ʒ u ʕ
سمبوسة	s a m b u s a
عازب	ʕ a z i b
مبرة	m a b a r r a
انتقم	i n t a q a m a
أمغر	ʔ a m ɣ a r a
أوعية	ʔ a w ʕ i j a
مثلجات	m u θ a l l a d͡ʒ a t
متفرق	m u t a f a r r i q
أسرة	ʔ a s i r r a
ي	i
عاشب	ʕ a ʃ i b
فربيون	f a r b i j u n
سدر	s i d r
سفرجل	s a f a r d͡ʒ a l
أخصائي	ʔ a x i sˤ sˤ a ʔ i j j
ضيع	dˤ a j j a ʕ a
سموم	s a m u m
معمودية	m a ʕ m u d i j j a
دافئ	d a f i ʔ
مرزبان	m a r z u b a n
إياك	ʔ i j j a k i
كيلوغرام	k i l u ɣ r a m
تنفس	t a n f u s u
آيسلندا	ʔ a j s l a n d a
مولى	m a w l a n
رسالة	r i s a l a
كحلاء	k a ħ l a ʔ
مداخل	m a d a x i l
رابط	r a b i tˤ
أدهش	ʔ u d h a ʃ
ماعونة	m a ʕ u n a
تحرير	t æ ħ r i r
صلى	sˤ a l l a
سلح	s a l l a ħ a
نسيم	n a s i m
ذئبة	ð i ʔ b a
قذة	q u ð ð a
هاون	h a w u n
بوصير	b u sˤ i r
كينيا	k i n i j a
ضمران	dˤ a m r a n
ترك	t a r r a k a
خفر	x a f a r a
رب	r u b b a
محادثة	m u ħ a d a θ a
هباء	h a b a ʔ
خصوصي	x u sˤ u sˤ i j j
أثناء	ʔ a θ n a ʔ a
أبرز	ʔ a b r a z
علي	ʕ a l j
بحث	b a ħ a θ a
يقين	j a q i n
سيرك	s i r k
مضيق	m a dˤ i q
مزبلة	m a z b a l a
ك	k ɑ f
حصرم	ħ a sˤ r a m a
بوليس	b u l i s
استكشاف	i s t i k ʃ a f
ل	l a m
غلط	ɣ a l i tˤ a
فوز	f a w z
يسوع	j a s u ʕ
سكنجبين	s i k a n d͡ʒ u b i n
تكدس	t u k a d d i s a
محراب	m a ħ a r i b
جريد	d͡ʒ a r i d
ولكن	w a l a k ɪ n a
أعاجيب	ʔ a ʕ a d͡ʒ i b
إنموذج	ʔ i n m u ð a d͡ʒ
قاف	q a f a
من	m a n n
تلاشى	t a l a ʃ a
حرش	ħ a r r a ʃ a
العراق	a l ʕ i r a q
وعاء	w i ʕ a ʔ
هن	h i n n a
فاض	f a dˤ a
دب	d i b b
جناح	d͡ʒ u n a ħ
زخ	z a x x
سميط	s a m i tˤ
أمضى	ʔ a m dˤ a
شره	ʃ a r i h a
خطام	x i tˤ a m
فقس	f a q a s a
شكوهج	ʃ i k u h a d͡ʒ
سلطوي	s u l tˤ a w i j j
وسع	w a s i ʕ a
رمضان	r a m dˤ a n
خزينة	x a z i n a
الأردن	a l ʔ u r d u n
أشهل	ʔ a ʃ h a l
كذاب	k a z z a b
قبر	q u b b a r
صبي	sˤ a b i j j
بازهر	b a z a h r
أطبة	ʔ a tˤ i b b a
ثعبان	θ u ʕ b a n
واجه	w a d͡ʒ a h a
زمام	z i m a m
تربة	t u r b a
تنفس	t u n f a s
ث	θ
دونم	d u n u m
موكب	m a w k i b
أنا	ʔ a n a
سبطانة	s a b a tˤ a n a
مايو	m a j u
بطن	b a tˤ n
حشيش	ħ a ʃ i ʃ
دقيق	d a q i q
وظف	w a ðˤ ðˤ a f a
عوارية	ʕ a w a r i j j a
الفلبين	a l f i l i b b i n
حصل	ħ a sˤ sˤ a l a
غرق	ɣ i r i ɡ
نشيدة	n a ʃ i d a
و	u
تذبذب	t a ð a b ð u b
إذا	ʔ i ð a n
مبالغة	m u b a l a ɣ a
ستون	s i t t u n a
أطلع	ʔ a tˤ l a ʕ a
أربعة	ʔ a r b i ʕ a
رد	r a d d a
عجرم	ʕ i d͡ʒ r i m
شيك	ʃ e k
رصفاء	r u sˤ a f a ʔ
مسد	m a s s a d a
تغيير	t a ɣ j i r
سلامتك	s a l a m t i k
قشر	q a ʃ ʃ a r a
تدليك	t a d l i k
استمتع	i s t a m t a ʕ a
عسال	ʕ a s s a l
مدخن	m u d a x x i n
خبر	x a b a r a
انشق	i n ʃ a q q a
تكدس	t a k a d d u s
سوس	s a w i s a
هود	h a w d
بلغاريا	b u l ɣ a r i j a
قرمل	q a r m a l
راقص	r a q i sˤ
انبث	i m b a θ θ a
كاف	k a f i n
بند	b a n d
تحرش	t a ħ a r r a ʃ a
طاقم	tˤ a q a m
أدهش	ʔ u d h a ʃ a
أحسن	ʔ u ħ a s s a n a
صعيد	sˤ a ʕ i d
لون	l a w w a n a
كروية	k u r a w i j j a
مزرع	m a z r a ʕ
أغلب	ʔ u ɣ l a b u
صفد	sˤ a f f a d a
شي	ʃ a j j
كثافة	k a θ a f a
عطلة	ʕ u tˤ l a
وقت	w a q a t
مراسل	m u r a s i l
زمزريق	z a m z a r i q
المسيح	a l m a s i ħ
مستفرغ	m u s t a f r a ɣ
أخشن	ʔ a x ʃ a n
تواضع	t a w a dˤ a ʕ a
فرعون	f i r ʕ a w n
مال	m a l
اللهم	ʔ a ɫ ɫ a h u m m a
واسع	w a s i ʕ
شهق	ʃ a h a q a
ص	sˤ a d
عم	ʕ a m m
مراجع	m u r a d͡ʒ a ʕ
فلاح	f a l l a ħ
عانى	ʕ a n a
قام	q ō m
أهبة	ʔ u h b a
سنبوسك	s a m b u s a k
عتمة	ʕ a t a m a
كستيج	k u s t i d͡ʒ
ثدييات	θ a d j i j j a t
شمال	ʃ a m a l
سلوفينيا	s l o v e n i j a
خرقة	x i r ɡ a
موزامبيق	m u z a m b i q
أكل	ʔ a k a l a
شمشار	ʃ a m ʃ a r
كستج	k a s t a d͡ʒ
منقض	m u n q a dˤ
ظفر	ðˤ i f r
قرصن	q a r sˤ a n a
حرقدة	ħ a r q a d a
بطرك	b a tˤ r a k
إنسان	ʔ i n s a n
مكناس	m a k n a s
ميانمار	m i j a n m a r
فلو	f u l u w w
فرغ	f a r a ɣ a
دواسة	d a w w a s a
إن	ʔ i n
عصا	ʕ a sˤ a
شرق	ʃ a r q
صبر	sˤ a b b a r a
عبادة	ʕ i b a d a
قالب	q a l a b
حبق	ħ a b a q
إسحاق	ʔ i s ħ a q
ك	k
قال	ʔ a l
جيش	ɡ e ʃ
مناخي	m a n a x i j j
نظرية	n a ðˤ a r i j j a
نعس	n a ʕ a s a
مرة	m a r r a t a n
شرموطة	ʃ a r m u tˤ a
منتظم	m u n t a ðˤ a m
باص	b a sˤ
تأمرك	t a ʔ a m r a k a
أحب	ʔ a ħ a b b a
خلاص	x a l a sˤ
تحت	t a ħ t a
توراة	a t t a w r a h
محمدة	m a ħ m i d a
عصيان	ʕ i sˤ j a n
كبر	k a b u r a
مصدوم	m a sˤ d u m
ممحوق	m a m ħ u q
فرقاطة	f u r ɡ a tˤ a
غزلي	ɣ a z a l i j j
هاون	h a w a n a
كمر	k a m a r
جارية	d͡ʒ a r i j a
إرهابي	ʔ i r h a b i j j
فوضوية	f a w dˤ a w i j j a
إعياء	ʔ i ʕ j a ʔ
عصب	ʕ a sˤ sˤ a b a
طه	tˤ a h a
نهر	n a h r
قطران	q a tˤ i r a n
كوم	k o m
أحمر	ʔ a ħ m a r
هو	f a h w a
أنوق	ʔ a n u q
كاشف	k a ʃ a f a
عجورة	ʕ a d͡ʒ d͡ʒ u r a
شعب	ʃ u ʕ a b
تفاجأ	t a f a d͡ʒ a ʔ a
رطب	r u tˤ a b
دقيقة	d a ɡ i ɡ a
تقضب	t a q a dˤ dˤ a b a
رابع	r a b i ʕ
مشمش	m i ʃ m i ʃ
فراولة	f a r a w i l a
افتراع	i f t i r a ʕ
كون	k a w w a n a
عالي	ʕ a l i
غبن	ɣ a b n
صدغ	sˤ u d ɣ
ريباس	r i b a s
استعان	i s t a ʕ a n a
صقاع	sˤ i q a ʕ
ديباج	d i b a d͡ʒ
أريكا	ʔ a r i k a
عبودية	ʕ ʊ b u d ɛ j ə
سراويل	s a r a w i l
حطاب	ħ a tˤ tˤ a b
أجذاع	ʔ a d͡ʒ ð a ʕ
مخروطي	m a x r u tˤ i j j
ي	j
أبكم	ʔ a b k a m
فني	f a n i j a
أعقد	ʔ a ʕ ɡ a d
حوول	ħ u w i l a
حجامة	ħ a d͡ʒ a m a
جزمازق	d͡ʒ a z m a z a q
مستهلك	m u s t a h l i k
زمان	z a m a n
ساحلي	s a ħ i l i j j
سجادة	s i d͡ʒ a d a
نملة	n a m l a
مذاق	m a d a q
رقم	r a ɡ a m
هدى	h a d a
تعزم	t a ʕ a z z a m a
شمشير	ʃ a m ʃ i r
جهادي	d͡ʒ i h a d i j j
ساكف	s a k i f
نفخ	n a f a x a
نعم	n a ʕ a m
اعتمد	i ʕ t a m a d a
شمال	ʃ i m a l
رغيفة	r a ɣ i f a
لاءم	l a ʔ a m a
حرف	ħ u r f
مسطار	m i s tˤ a r
شؤبوب	ʃ u ʔ b u b
متصل	m u t t a sˤ i l
زار	z a r a
خارج	x a r i d͡ʒ
حبس	ħ a b b a s a
ألبانيا	ʔ a l b a n i j a
تمرد	t a m a r r a d a
منافق	m u n a f i q
أريج	ʔ a r i d͡ʒ
هوادة	h a w a d a
مخنث	m u x a n n a θ
سابق	s a b i q
عود	ʕ a w d
هذا	h a ð a
تقرأ	t a q a r r a ʔ a
طمى	tˤ a m a
أقط	ʔ a q a tˤ a
فاتحة	f a t i ħ a
فيديو	f i d i j u
فرقاطة	f i r ɡ a tˤ a
باريس	b a r i s
ليلة	l a j l a
تايلاند	t a j l a n d
كزمازق	k a z m a z a q
جميع	d͡ʒ a m i ʕ
شامة	ʃ a m a
مغسلة	m a ɣ s i l a
و	w a
بورصة	b u r sˤ a
العبرية	a l ʕ i b r i j j a
اقتصر	i q t a sˤ a r a
حافة	ħ a f a
عشاء	ʕ i ʃ a ʔ
تماما	t a m a m a n
صورة	sˤ u r a
مفرد	m u f r a d
أدب	ʔ a d a b
انسلخ	i n s a l a x a
أدحوة	ʔ u d ħ u w w a
أبيدجان	ʔ a b i d d͡ʒ a n
فرغ	f a r r a ɣ a
قاتل	ɡ a t i l
مخلوقات	m a x l u q a t
قرار	q a r a r
عمامة	ʕ i m a m a
فاعل	f a ʕ i l
مشاعر	m a ʃ a ʕ i r
عربية	ʕ a r a b i j j a
أحسن	ʔ a ħ s a n a
بردعة	b a r d a ʕ a
مفتاح	m i f t a ħ
حجة	ħ u d͡ʒ d͡ʒ a
غسول	ɣ a s u l
أخمص	ʔ a x m u sˤ
انقراض	i n q i r a dˤ
فلو	f a l u w w
قضم	q a dˤ i m a
أحسن	ʔ u ħ a s s a n
قيطون	ɡ e tˤ o n
شعر	ʃ a ʕ a r a
رحمن	r a ħ m a n
إسبانية	ʔ i s b a n i j a
يونس	j u n u s
مقطعية	m a q tˤ a ʕ i j j a
إياهما	ʔ i j j a h u m a
زبدة	z u b d a
سنجاب	s i n d ʒ a b
حافلات	ħ a f i l a t
أكسح	ʔ a k s a ħ
شكوس	ʃ a k w a s
فجل	f a d͡ʒ d͡ʒ a l a
ضحك	dˤ i ħ k
صاحب	sˤ a ħ i b
مرسين	m a r s i n
قرص	q a r a sˤ a
صلوة	sˤ a l a h
حبل	ħ a b i l a
عنق	ʕ a n a q
مدفأة	m i d f a ʔ a
رحمن	r u ħ ħ i m n a
ملاك	m a l a k
نظف	n a ðˤ u f a
وصيف	w a sˤ i f
عتب	ʕ a t a b
اعتبر	i ʕ t a b a r a
غلا	ɣ a l a
طارق	tˤ a r i q
أميركي	ʔ a m e r i k i j j
أغلب	ʔ u ɣ a l l i b
جواد	d͡ʒ a w a d
تسامح	t a s a m u ħ
مسلسل	m u s a l s i l
خسأ	x a s a ʔ a
أضاف	ʔ a dˤ a f a
قتل	q a t a l a
لهث	l a h i θ a
فنلندا	f i n l a n d a
حلبوب	ħ a l b u b
نسأ	n a s a ʔ a
سلعة	s i l ʕ a
مالطا	m a l tˤ a
موقع	m u w a q q i ʕ
حامول	ħ a m u l
بالتوفيق	b i t t a w f i q i
تركيا	t u r k i j j a
حاسوب	ħ a s u b
قال	q a l a
قرطم	q u r tˤ u m
منغوليا	m u n ɣ u l i j a
فلفل	f u l f u l
مخمل	m u x m a l
ملحمي	m a l ħ a m i j j
وعدة	w a ʕ d a
إقامة	ʔ i q a m a
سرير	s ɪ r i r
مشط	m a ʃ ʃ a tˤ a
أسوة	ʔ u s w a
اسم	i s m
سدر	s a d i r a
اعتدال	i ʕ t i d a l
قضيب	q ɑ dˤ i b
أرضة	ʔ a r a dˤ a
فصح	f u sˤ u ħ
قرب	q a r u b a
إباحية	ʔ i b a ħ i j j a
خداج	x i d a d͡ʒ
زرافة	z u r a f a
حريش	ħ a r i ʃ
قطع	q u tˤ a ʕ
رجع	r a d͡ʒ a ʕ a
خليقة	x a l i q a
عفوا	ʕ a f w a n
إحصائي	ʔ i ħ sˤ a ʔ i j j
سلة	s u l l a
ظهر	ðˤ a h a r a
كهف	k a h f
انتقال	i n t i q a l
مرزبة	m a r z a b b a
زق	z i q q
شهل	ʃ a h i l a
نظامي	n a ðˤ ðˤ a m i j j
طحال	tˤ i ħ a l
تباطأ	t a b a tˤ a ʔ a
ميراث	m a w a r i θ
تصوير	t a sˤ w i r
عنصري	ʕ u n sˤ u r i j j
جمعي	d͡ʒ a m ʕ i j j
سابيائي	s a b i j a ʔ i j j
سمبوسك	s a m b u s a k
قنطار	q a n tˤ a r
جاوشير	d͡ʒ a w a ʃ i r
معنى	m a ʕ n a n
عريش	ʕ a r i ʃ
أحبك	ʔ u ħ i b b u k a
عنزروت	ʕ a n z a r u t
مشعل	m i ʃ ʕ a l
أجرب	ʔ a d͡ʒ r a b
ابتغى	i b t a ɣ a
جدول	d͡ʒ a d w a l
محادثة	m u ħ a d i θ a
برلمان	b a r l a m a n
معاصر	m u ʕ a sˤ i r
د	d
قابلة	q æ b l æ
الأرجنتين	a l ʔ a r d͡ʒ a n t i n
تلا	t a l a
ضوء	dˤ a w ʔ
مرش	m a r ʃ
سيطر	s a j tˤ a r a
شوح	ʃ u ħ
دفيء	d a f i ʔ
شكوش	ʃ a k u ʃ
كزبرة	k u z b a r a
ممتلئ	m u m t a l i ʔ
كوسى	k u s a
عصعص	ʕ u sˤ ʕ u sˤ
عطف	ʕ a tˤ a f a
تسع	t i s ʕ
سلوفاكيا	s l o v a k i j a
يانصيب	j a n a sˤ i b
بزاز	b a z z a z
ملل	m a l l a l a
منطقة	m ə n tˤ ə q ə
ملك	m i l k
زندقة	z a n d a q a
نيجيريا	n i d͡ʒ e r i j a
فوض	f a w w a dˤ a
رضائع	r a dˤ a ʔ i ʕ
مخاط	m u x a tˤ
و	w
كارى	k a r a
فندق	f u n d u q
شارع	ʃ a r i ʕ
عما	ʕ a m m a
نقض	n a q q a dˤ a
قدم	q i d a m
كنارة	k i n n a r a
علي	ʕ u l i j a
كبد	k a b i d
مقطر	m u q a tˤ tˤ i r
يخت	j a x t
سمن	s a m n
طفل	tˤ i f l
باقلاء	b a q i l a ʔ
مغناطيسي	m i ɣ n a tˤ i s i j j
اختار	i x t a r a
تونس	t u n i s
نشرة	n a ʃ r a
غبن	ɣ a b a n a
نهب	n a h a b a
عاقبة	ʕ a q i b a
عقرب	ʕ a ɡ r a b
هنيهة	h u n a j h a
نعل	n a ʕ l
كردون	k u r d u n
قمح	q a m ħ
محمد	m u ħ a m m a d
لهجة	l ə h d͡ʒ ə
أسطرلاب	ʔ a s tˤ u r l a b
تقدمي	t a q a d d u m i j j
بوري	b u r i
سوء	s a w ʔ
شهواني	ʃ a h w a n i j j
لواط	l i w a tˤ
ق	ɡ
نوه	n a w w a h a
قارب	ʔ a r e b
خزاف	x a z z a f
تمييز	t a m j i z
انخفض	i n x a f a dˤ a
نضي	n a dˤ i j j
انقطع	i n q a tˤ a ʕ a
هدار	h a d d a r
فلكي	f a l a k i j j
ساق	s a q
اتحادي	i t t i ħ a d i j j
أغلف	ʔ a ɣ l a f
ركبة	r u k b a
تكلم	t a k a l l a m a
ذهب	ð a h a b a
شهر	ʃ a h h a r a
دال	d a l
رجل	r a d͡ʒ i l a
هن	h a n
معمل	m a ʕ m a l
وحل	w a ħ l
صفعة	sˤ a f ʕ a
دونمة	d u n m a
الكنية	a l k u n j a
اشتياق	i ʃ t i j a q
كوستاريكا	k o s t a r i k a
نسخ	n a s a x a
خبا	x a b a
مغناطيس	m a ɣ n a tˤ i s
إسرنج	ʔ i s r i n d͡ʒ
ساعد	s a ʕ a d a
باصور	b a sˤ u r
مسلسل	m u s a l s a l
مرش	m a r a ʃ a
لا	l a
عجلة	ʕ i d͡ʒ a l a
دماغ	d i m a ɣ
قبض	q a b dˤ
نسبوية	n i s b a w i j j a
مغلف	m u ɣ a l l a f
مثلث	m u θ a l l a θ
أهدب	ʔ a h d a b a
جمع	d͡ʒ a m m a ʕ a
حلتيت	ħ i l t i t
نبراس	n i b r a s
ظ	ðˤ a ʔ
زيزفون	z a j z a f u n
معلم	m a ʕ l a m
تنبول	t a m b u l
مي	m a j j
كليب	k l i b
حدق	ħ a d a q a
طل	tˤ a l l a
أزلي	ʔ a z a l i j j
قنبيط	q u n n a b i tˤ
مدة	m u d d a
عادة	ʕ a d a t a n
احترف	i ħ t a r a f a
ظفر	ðˤ a f f a r a
تنور	t a n a w w u r
الجديدة	a l d͡ʒ a d i d a
أشعل	ʔ a ʃ ʕ a l a
إيا	ʔ i j j a
عكازة	ʕ u k k a z a
أمريكا	ʔ a m r i k a
سرو	s a r w
إدهاش	ʔ i d h a ʃ
رفيق	r a f i q
حمل	ħ a m a l a
منتقض	m u n t a q i dˤ
متخصص	m u t a x a sˤ sˤ i sˤ
أسبوع	ʔ u s b u ʕ
طبقة	tˤ a b a q a
غلبة	ɣ u l u b b a
اتعد	i t t a ʕ a d a
أباجور	ʔ a b a ʒ u r
قشدي	q i ʃ d i j j
مساهمة	m u s a h a m a
سادة	s a d a
نسخة	n u s x a
ثعلب	θ a ʕ l a b
نوفمبر	n u f i m b a r
تشنج	t a ʃ a n n a d͡ʒ a
حجاب	ħ i ɡ æ b
سويسرا	s u w i s r a
تكدس	t u k d a s u
سمعي	s a m ʕ i j j
مصيبة	m u sˤ i b a
عليون	ʕ i l l i j j u n
جمل	d͡ʒ u m a l
ا	ʔ
ويسكي	w i s k i
موزامبيق	m o z a m b i q
عطن	ʕ a tˤ n
بنفسج	b a n a f s a d͡ʒ
رقم	r a ʔ a m
صك	sˤ a k k
أديبة	ʔ a d i b a
أثل	ʔ u θ u l
كره	k u r h
صحي	sˤ i ħ ħ i j j
فتوى	f a t w a
سرط	s a r a tˤ a
نفاد	n a f a d
ملبس	m a l b a s
بيروقراطي	b i r u q r a tˤ i j j
معمار	m i ʕ m a r
ثلة	θ u l l a
أيش	ʔ a j ʃ i n
ك	k a f
مجرب	m u d͡ʒ a r r i b
أهيف	ʔ a h j a f
دولار	d o l a r
غبار	ɣ u b a r
عيد	ʕ a j j a d a
ينع	j a n a ʕ a
غلبة	ɣ a l a b a
مشحذ	m i ʃ ħ a ð
رجينة	r a d͡ʒ i n a
منفضة	m i n f a dˤ a
سلطة	s u l tˤ a
لجأ	l a d͡ʒ a ʔ a
بقص	b a q sˤ
رم	r a m m a
سمن	s u m m a n
حرذون	ħ a r ð u n
قيطون	ɡ i tˤ u n
نعيم	n a ʕ i m
بعل	b a ʕ l
وسط	w a s a tˤ
وقت	w a k t
تخفيف	t a x f i f
طمث	tˤ a m θ
المحمدية	a l m u ħ a m m a d i j j a
داخل	d a x i l a
شقة	ʃ i ɡ ɡ a
متعلم	m u t a ʕ a l l i m
رهبوت	r a h a b u t
وعي	w a ʕ j
أجمع	ʔ a d͡ʒ m a ʕ
أونسة	ʔ u n s a
ردى	r a d d a
فرع	f a r a ʕ a
فرقاطة	f i r q a tˤ a
بوسة	b o s ə
يقظة	j a q a ðˤ a
لعل	l a ʕ a l l a
إملاء	ʔ i m l a ʔ
خربش	x a r b a ʃ a
أرغان	ʔ a r ɣ a n
سميع	s a m i ʕ
أجلح	ʔ a d͡ʒ l a ħ
إقناع	ʔ i q n a ʕ
وثيقة	w a θ i q a
بندق	b u n d u ɡ
رغفان	r u ɣ f a n
شطر	ʃ a tˤ r
جما	d͡ʒ a m m a n
مجفل	m u d͡ʒ a f f i l
غاز	ɣ a z
زغلول	z u ɣ l u l
سهل	s a h l
كاراتيه	k a r a t e
ملحن	m u l a ħ ħ i n
نواخذة	n a w a x i ð a
الإسكندرية	a l ʔ i s k a n d a r i j j a
أرهب	ʔ a r h a b a
ناسور	n a s u r
جميزة	d͡ʒ u m m a j z
قضيبي	q a dˤ i b i j j
حيوة	ħ a j a h
أملج	ʔ a m l a d͡ʒ
سفافيد	s a f a f i d
صحراء	sˤ a ħ r a ʔ
جبس	d͡ʒ i b s
كزمازج	k a z m a z a d͡ʒ
كم	k a m m
عبيثران	ʕ u b a j θ a r a n
قرصنة	q a r sˤ a n a
كبد	k a b b a d a
زنبور	z a m b u r
شنع	ʃ a n n a ʕ a
بذلة	b a ð l a
متلوث	m ʊ t ə l ə w ɪ θ
قد	q a d
آل	ʔ a l u
جاورس	d͡ʒ a w a r s
حينئذ	ħ i n a ʔ i ð i n
تنفيذ	t a n f i ð
حاجز	ħ a d͡ʒ i z
أنتن	ʔ a n t u n n a
عار	ʕ a r i n
ترنيم	t a r n i m
ركض	r a k a dˤ a
لبلابي	l a b l a b i j j
أوجد	ʔ u d͡ʒ a d u
قنطار	q i n tˤ a r
شفر	ʃ a f r
أسهل	ʔ a s h a l
جليد	d͡ʒ a l i d
شيء	ʃ i ʔ a
وقف	w a q a f a
فتة	f a t t a
تحرش	t a ħ r i ʃ u
قاوق	q a w u q
ركف	r a k a f
أخاديد	ʔ a x a d i d
ثور	θ a w r
تألف	t a ʔ a l l a f a
مشترك	m u ʃ t a r a k
سجين	s a d͡ʒ i n
تعليق	t a ʕ l i q
إشبينة	ʔ i ʃ b i n a
شمس	ʃ a m a s
سماء	s a m a ʔ
وسع	w a s u ʕ a
صنارة	sˤ i n n a r a
قاد	q a d a
سبسب	s a b s a b
ربيع	r a b i ʕ
عنق	ʕ u n u q
فصيل	f a sˤ i l
فدائي	f i d a ʔ i j j
حجامة	ħ i d͡ʒ a m a
كثيب	k a θ i b
عار	ʕ a r
بسملة	b a s m a l a
مص	m a sˤ sˤ
مربض	m a r b i dˤ
ناصع	n a sˤ i ʕ
تعصب	t a ʕ a sˤ sˤ u b
أخذ	ʔ a x x a ð a
فراشة	f a r a ʃ a
ن	n
أهدب	ʔ a h d a b
قوش	q u ʃ
أعزل	ʔ a ʕ z a l
حينذاك	ħ i n a ð a k a
صنارة	sˤ i n a r a
تعالى	t a ʕ a l a
فسقية	f i s q i j j a
شعبي	ʃ a ʕ b i j j
رحمة	r a ħ m a
طراح	tˤ i r a ħ
حوذان	ħ a w ð a n
شين	ʃ i n
حيوان	ħ a j a w a n
سنبل	s u n b u l
دساتير	d a s a t i r
اضطهاد	i dˤ tˤ i h a d
كندا	k a n a d a
كتابخانة	k i t a b x a n a
عجول	ʕ u d͡ʒ u l
هنغاريا	h i n ɣ a r i j a
بودابست	b u d a b i s t
إمبراطوري	ʔ i m b a r a tˤ u r i j j
ألباني	ʔ a l b a n i j j
أوغندا	ʔ u ɣ a n d a
رأس	r a ʔ a s a
سورينام	s u r i n a m
غار	ɣ a r a
شعر	ʃ a ʕ a r
شمبانيا	ʃ a m b a n j a
شقة	ʃ i q q a
خرافي	x u r a f i j j
حب	ħ u b b
استمنى	i s t a m n a
ضباب	dˤ i b a b
تكفير	t a k f i r
عرنسية	ʕ a r a n s i j j a
طحن	tˤ a ħ a n a
استمارة	i s t i m a r a
فجل	f a d͡ʒ a l
غ	ʁ a j n
سمع	s a m i ʕ a
حيواني	ħ a j a w a n i j j
لاوس	l a w s
عنب	ʕ u n a b
كزمازك	k a z m a z a k
أثل	ʔ a θ a l a t
مقشرة	m i q ʃ a r a
نحلة	n a ħ l a
سياع	s i j a ʕ
ملجأ	m a l d͡ʒ a ʔ
مغبن	m a ɣ b a n
جردل	d͡ʒ a r d a l
سنغافورة	s i n ɣ a f u r a
دغموس	d a ɣ m u s
روض	r a w w a dˤ a
سقم	s a q a m
تطوان	t i tˤ w a n
أغلب	ʔ u ɣ a l l i b u
يانسون	j a n a s u n
تعسفي	t a ʕ a s s u f i j j
حديقة	ħ a d i q a
صوم	sˤ a w m
حرذون	ħ i r ð a w n
خصص	x a sˤ sˤ a sˤ a
متحمس	m u t ħ a m i s
شرشيري	ʃ a r ʃ i r i j j
مقشدة	m i q ʃ a d a
مسجد	m a s d͡ʒ i d
لعبة	l a ʕ b a
زنار	z u n n a r
حقد	ħ i q d
تهدل	t a h a d d a l a
إثمد	ʔ i θ m i d
عافية	ʕ a f i j a
شاف	ʃ a f a
أخلاقي	ʔ a x l a q i j j
تامول	t a m u l
عنيف	ʕ a n i f
مزر	m i z r
كوثل	k a w θ a l
أثاث	ʔ a θ a θ
النمسا	a n n i m s a
تقضى	t u q dˤ a
رمش	r a m a ʃ a
داود	d a w u d
أسود	ʔ a s w a d
خلفي	x a l f i j j
توراة	t ə w r ɑ t
مفرغ	m u f r i ɣ
مقام	m a q a m
علقم	ʕ a l q a m
س	s i n
محافظة	m u ħ a f i ðˤ a
لاث	l a θ a
رياضي	r i j a dˤ i j j
بليحة	b a l i ħ a
أمس	ʔ u m a s s a
رحمن	r a ħ ħ a m n a
مرقشيتا	m a r q a ʃ i t a
وزع	w a z z a ʕ a
أغلب	ʔ a ɣ l a b
مات	m a t a
زفن	z a f a n a
ساهم	s a h a m a
قرأ	q a r a ʔ a
جزمازك	d͡ʒ a z m a z a k
هنالك	h u n a l i k a
صومعة	sˤ a w m a ʕ a
لعبة	l u ʕ b a
باء	b a ʔ
وغل	w a ɣ a l a
كاراطي	k a r a tˤ i
دولي	d u w a l i j j
زهرية	z a h r i j j a
اجتنب	i d͡ʒ t a n a b a
درك	d a r a k
أفرط	ʔ a f r a tˤ a
سيخية	s i x i j j a
قبطان	q u b tˤ a n
جحفل	d͡ʒ ħ f a l a
ظليم	ðˤ a l i m
زم	z a m m a
كنيسة	k a n i s a
سكرجة	s u k u r r a d͡ʒ a
أكتوبر	ʔ a k t u b a r
مرقشيثا	m a r q a ʃ i θ a
معروف	m a ʕ r u f
سنة	s i n a
ألقى	ʔ a l q a
متى	m a t t a
خرسانة	x a r a s a n a
محبس	m i ħ b a s
اقترح	i q t a r a ħ a
زراعي	z i r a ʕ i j j
مركب	m u r a k k a b
فعل	f a ʕ l
نضار	n u dˤ a r
كرح	k i r ħ
سلاطين	s a l ɑ t i n
بطاطا	b a tˤ a tˤ a
نبأ	n a b a ʔ
خالق	x a l i q
مجوهرات	m u d͡ʒ a w h a r a t
ميراث	m i r a θ
سقم	s u q m
تجنب	t a d͡ʒ a n n a b a
كلوتة	k a l l u t a
أنبوب	ʔ u n b u b
بامية	b a m i j a
ماء	m a ʔ
نفض	n a f f a dˤ a
وسمة	w a s m a
كمثراة	k u m m a θ r a h
مكافح	m u k a f i ħ
ريحان	r a j ħ a n
حرنكش	ħ a r a n k a ʃ
قبرة	q u b b a r a
أزرق	ʔ a z r a ɡ
الفاتيكان	a l v a t i k a n
ينسون	j a n s u n
جلنجبين	d͡ʒ u l l a n d͡ʒ a b i n
كوة	k a w w a
طاف	tˤ a f a
قتلة	q a t l a h
يوسف	j u s u f
بلغمي	b a l ɣ a m i j j
ناشف	n a ʃ i f
خريطة	x a r i tˤ a
مجنون	m æ ɡ n u n
جسمان	d͡ʒ u s m a n
محراث	m i ħ r a θ
إندونيسيا	ʔ i n d u n i s i j a
حصرم	ħ a sˤ r a m
هيف	h a j f
قصير	q a sˤ i r
شخشخ	ʃ a x ʃ a x a
فنزويلا	f e n z u w e l a
استحصل	i s t a ħ sˤ a l a
حصل	ħ a sˤ a l
كنز	k a n a z a
بعثي	b a ʕ θ i j j
فز	f a z z a
قيظ	q a j ðˤ
تنديل	t a n d i l
عبيثران	ʕ a b a j θ a r a n
حفر	ħ a f a r a
لغة	l u ɣ a
غدة	ɣ u d d a
أيوبي	ʔ a j j u b i j j
قلعة	q a l ʕ a
مجنون	m e ɪ j n u n
فلانة	f l ɑ n ɐ
حساسي	ħ a s s a s i j j
أشوه	ʔ a ʃ w a h
سوق	s u ʔ
نهر	n a h a r
سهل	s a h h a l a
جواب	d͡ʒ a w a b
أقرب	ʔ a q r a b
حنبل	ħ a n b a l
غبط	ɣ a b a tˤ a
قيطون	ɡ i tˤ u n
مقدونيا	m a q d u n i j a
خطة	x u tˤ tˤ a
باطس	b a tˤ u s
فعل	f a ʕ ʕ a l a
ضفدع	dˤ i f d a ʕ
تنبول	t u m b u l
ضيق	dˤ a j q
حنظلة	ħ a n ðˤ a l a
بنطال	b a n tˤ a l
تنقض	t a n a q q u dˤ
بعر	b a ʕ r
غطس	ɣ a tˤ a s a
مقص	m i q a sˤ sˤ
طاعم	tˤ a ʕ a m a
سرخس	s a r x a s
مستنقع	m u s t a n q a ʕ
جزدان	d͡ʒ u z d a n
صبر	sˤ a b a r a
إذخر	ʔ i ð x i r
تجذير	t a d͡ʒ ð i r
عامل	ʕ a m a l a
فيديو	f i d j u
وصيد	w a sˤ i d
وقت	w a q q a t a
زنبوج	z a n b u d͡ʒ
قفير	q a f i r
أسري	ʔ u s r i j j
أسفاراج	ʔ a s f a r a d͡ʒ
تنفس	t a n f u s
صمام	sˤ i m a m
أقدر	ʔ a q d a r a
حامض	ħ a m i dˤ
قرش	q i r ʃ
صفيراء	sˤ u f a j r a ʔ
بوصلة	b o sˤ l a
صالح	sˤ a l i ħ
مدة	m u d d a t a
فتح	f a t ħ
خرشوف	x u r ʃ u f
الله	a ɫ ɫ a h
خلقي	x a l l i q i
بلان	b a l l a n
جنب	d͡ʒ a n a b
انصرف	i n sˤ a r a f a
بعض	b a ʕ dˤ
وارث	w a r i θ
حاضرة	ħ a dˤ i r a
إدريس	ʔ i d r i s
مكنسة	m i k n a s a
مكسرات	m u k a s s a r a t
دين	d a j n
ثمن	t a m a n
مغفل	m u ɣ a f f a l
بوصلة	b u sˤ l e
قابلة	q a b l a
دويبة	d u w a j b b a h
راجمة	r a d͡ʒ i m a
منسأة	m a n s a ʔ a
كراميل	k a r a m i l
تلفون	t a l i f o n
فانوس	f a n u s
قشف	q a ʃ ʃ a f a
اللات	a l l a t
جوذاب	d͡ʒ u ð a b
محراب	m i ħ r a b
أباريق	ʔ a b a r i q
فورا	f a w r a n
عبرة	ʕ i b r a
قفاز	q u f a z
معجون	m a ʕ d͡ʒ u n
بائع	b a ʔ i ʕ
محجم	m i ħ d͡ʒ a m
أستاذ	ʔ u s t a z
عدد	ʕ a d a d
ساد	s a d a
صلابة	sˤ a l a b a
آمن	ʔ a m i n
كبيرة	k a b i r a h
ات	a t
راقص	r a q a sˤ a
رند	r a n d
لكنة	l u k n a
علم	ʕ a l a m
نافذة	n a f i ð a
تبريز	t a b r i z
مهدد	m u h a d d a d
عجج	ʕ a d͡ʒ d͡ʒ a d͡ʒ a
عطس	ʕ a tˤ a s a
برن	b i r n
أرض	ʔ a r dˤ
غفلة	ɣ a f l a
جمع	d͡ʒ a m ʕ
زنديق	z i n d i q
شندقورة	ʃ a n d ɡ u r a
كبريت	k a b r i t
ناعور	n a ʕ u r
مكدس	m u k a d d a s
جنيف	d͡ʒ i n i f
لندني	l u n d u n i j j
ماجور	m a ɡ u r
أعلى	ʔ u ʕ l a
تحرش	t a ħ r i ʃ a
ساجور	s a d͡ʒ u r
شاهترج	ʃ a h t a r a d͡ʒ
أشيب	ʔ a ʃ j a b
تشاعر	t a ʃ a ʕ a r a
توارى	t a w a r a
هاتف	h a t i f
شحن	ʃ a ħ a n a
فرث	f a r a θ a
مشط	m a ʃ a tˤ a
بوروندي	b u r u n d i
كبيس	k a b i s
واق	w a q i n
مساطر	m a s a tˤ i r
رقيب	r a q i b
ائتلاف	i ʔ t i l a f
أزب	ʔ a z a b b
مغرفة	m i ɣ r a f a
حطب	ħ a tˤ a b
مو	m u
قلب	q a l a b a
واجهات	w a d͡ʒ i h a t
تراجم	t a r a d͡ʒ a m a
أغبر	ʔ a ɣ b a r
سنت	s a n n a t
ناقوس	n a q u s
بزاق	b u z a q
إحسان	ʔ i ħ s a n
سمن	s a m i n a
أكاف	ʔ u k k a f
أسمر	ʔ a s m a r
طيفور	tˤ a j f u r
صفصاف	sˤ a f sˤ a f
ظالم	ðˤ a l i m
كرنب	k u r u n b
سريلانكا	s i r i l a n k a
أولو	ʔ u l u
ساحة	s a ħ a
شم	ʃ a m m
خنزير	x i n z i r
رمضان	r u m dˤ a n
إبطاء	ʔ i b tˤ a ʔ
لقح	l a q a ħ a
أدهش	ʔ a d h a ʃ a
أنقض	ʔ a n q a dˤ a
قريدس	q u r a j d i s
روسيا	r u s j a
غابة	ɣ a b a
تغوط	t a ɣ a w w a tˤ a
أرغفة	ʔ a r ɣ i f a
مثنان	m a θ n a n
القدس	a l q u d s
أقرأ	ʔ a q r a ʔ a
مريم	m a r j a m
طابور	tˤ a b u r
غرق	ɣ a r i q a
انجرف	i n d͡ʒ a r a f a
توعية	t a w ʕ i j a
خرافة	x u r a f a
خدش	x a d a ʃ a
أيوب	ʔ a j j u b
خ	x a ʔ
غويانا	ɣ u j a n a
ناخوذة	n a x u ð a
عيدية	ʕ i d i j j a
برز	b a r a z a
أنثوي	ʔ u n θ a w i j j
همجي	h a m a d͡ʒ i j j
مصدق	m u sˤ a d d a q
سكي	s a k k i j j
صدق	sˤ a d a q a
ساذج	s a ð i d͡ʒ
برئ	b a r i ʔ a
مؤسس	m u ʔ a s s i s
تخم	t a x m
رج	r a d͡ʒ d͡ʒ a
ووفق	w u f i q a
تحرش	t u ħ a r r i ʃ u
سيرج	s i r a d͡ʒ
سجادة	s a d͡ʒ d͡ʒ a d a
وارث	w ɑ r ɪ θ
لبسة	l i b s a
شاكر	ʃ a k i r
زمرد	z u m u r r u d
نهضة	n a h dˤ a
بلوة	b i l a
ت	t
أثناء	ʔ a θ n a ʔ
مقولة	m ɐ q u l ə
مضيف	m u dˤ i f
موت	m a w t
راحة	r a ħ a
فأس	f a ʔ s
بارز	b a r i z
كندس	k u n d u s
ضبط	dˤ a b a tˤ a
قصعين	q a sˤ ʕ i n
قلعي	q a l ʕ i j j
تكدس	t a k a d d a s a
أعرن	ʔ a ʕ r a n a
حليب	ħ a l i b
ديسم	d a j s a m
برتقال	b ʊ r t ə q ɑ l
فسقية	f a s q i j j a
جاهز	d͡ʒ a h i z
عبوة	ʕ u b u w a h
لج	l a d͡ʒ d͡ʒ a
آشوري	ʔ a ʃ u r i j j
قوة	q u w w a
سيراء	s i r a ʔ
عضوي	ʕ u dˤ w i j j
نيلج	n i l a d͡ʒ
مدهش	m u d h i ʃ
لاسلطوية	l a s u l tˤ a w i j j a
أسطورة	ʔ u s tˤ u r a
مؤسسة	m u ʔ a s s a s a
جربوز	d͡ʒ a r b u z
المجر	a l m a d͡ʒ a r
مجفل	m u d͡ʒ a f f a l
أخدر	ʔ a x d a r
عنوان	ʕ u n w a n
سيخ	s i x
أترج	ʔ u t r u d͡ʒ d͡ʒ
صحوة	sˤ a ħ w a
محسن	m u ħ a s s a n
مالطي	m a l tˤ i j j
باز	b a z
سلة	s a l l a
زوفا	z u f a
اصهاب	i sˤ h a b b a
أفغاني	ʔ a f ɣ a n i j j
صاع	sˤ a ʕ
عرناس	ʕ i r n a s
مقدونيا	m a q d o n i j a
سلا	s a l a
فضة	f i dˤ a
قرصة	q a r sˤ a
سميك	s a m i k
ذكر	ð a k a r a
خطيئة	x a tˤ i ʔ a
لوز	l a w z
سركنجبين	s i r k a n d͡ʒ u b i n
هراوة	h i r a w a
ليث	l a j θ
بلجيكا	b a l d͡ʒ i k a
بعوض	b a ʕ u dˤ
مرجان	m a r d͡ʒ a n
بنجر	b a n d͡ʒ a r
حنظل	ħ a n ðˤ a l
بسكرة	b i s k a r a
رزداق	r u z d a q
غرب	ɣ a r b
أرز	ʔ a r z
كراث	k a r r a θ
قملة	q a m l a
فتة	f a t t a t
متكلم	m u t a k a l l i m
يلب	j a l a b
طمي	tˤ a m j
ابتلى	i b t a l a
عنقاد	ʕ i n q a d
متين	m a t i n
أدهش	ʔ u d h i ʃ a
آنك	ʔ a n u k
جنيه	d͡ʒ u n a j h
مع	m a ʕ a
معادلة	m u ʕ a d a l a
إطريفل	ʔ i tˤ r i f a l
فيديو	v i d j o
أحسن	ʔ a ħ s a n
كهرباء	k a h r u b a ʔ
راء	r a ʔ
سكار	s u k k a r
استفسار	i s t i f s a r
زنبور	z u m b u r
ثرب	θ a r b
شاة	ʃ a h
زوجة	z o d͡ʒ a
أعفر	ʔ a ʕ f a r
ملكوت	m a l a k u t
جد	d͡ʒ i d d
جبة	d͡ʒ u b b a
شن	ʃ a n n a
رزتاق	r u z t a q
مؤنث	m u ʔ a n n a θ
جز	d͡ʒ a z z a
أستاذ	ʔ u s t a d
كبير	k b i r
غريب	ɣ a r i b
طنجة	tˤ a n d͡ʒ a
تكدس	t a k d i s a
تهديد	t a h d i d
باسور	b a s u r
إحدى	ʔ i ħ d a
أغلب	ʔ u ɣ a l l a b
بغاء	b i ɣ a ʔ
داء	d a ʔ
عرين	ʕ a r i n
صفحة	sˤ a f ħ a
معركة	m a ʕ r a k a
رضعاء	r u dˤ a ʕ a ʔ
أرجواني	ʔ a r d͡ʒ u w a n i j j
جبناء	d͡ʒ u b a n a ʔ
بقرة	b a q a r a
دهنج	d a h n a d͡ʒ
مرحاض	m i r ħ a dˤ
أمازيغي	ʔ a m a z i ɣ i j j
اليسع	a l j a s a ʕ
حدا	ħ a d a
رطوبة	r u tˤ u b a
غزة	ɣ a z z a
اكترى	i k t a r a
غ	ɣ
لدغ	l a d a ɣ a
وقار	w a q a r
أدهش	ʔ u d h a ʃ u
تكميلي	t a k m i l i j j
مقدار	m i ɡ d a r
سعد	s u ʕ d
صنج	sˤ a n d͡ʒ
دقيقة	d a q i q a
أدمن	ʔ a d m a n a
سنبك	s u m b u k
حج	ħ a ʒ ʒ
بيت	b i t a
مرزبان	m a r z a b a n
قداد	q a d a d
بلجيكا	b i l d͡ʒ i k a
ذنب	ð a n b
كلمة	k a l i m a
ذ	ð
لثم	l a θ a m a
خدش	x a d ʃ
التشيك	a t t ʃ i k
اسكتلندي	i s k u t l a n d i j j
دكتور	d u k t o r
أوتوماتيكي	ʔ u t u m a t i k i j j
زفيزف	z u f a j z a f
أشابة	ʔ u ʃ a b a
فور	f a w r a
مزورة	m u z a w w a r a
زميل	z a m i l
انتفاضة	i n t i f a dˤ a
قشف	q a ʃ u f a
أبدى	ʔ a b d a
كاذب	k a ð i b
رحيق	r a ħ i q
حر	ħ a r r
جهاد	d͡ʒ i h a d
مسى	m a s a
نحال	n a ħ ħ a l
شفنين	ʃ i f n i n
بلس	b i l i s
مدرك	m u d r a k
استأنف	i s t a ʔ n a f a
سندس	s u n d u s
محاصر	m u ħ a sˤ a r
بكين	p i k i n
نعاس	n u ʕ a s
سذاب	s a ð a b
فاكهة	f a k i h a
نفاذ	n a f a ð
تحريض	t a ħ r i dˤ
قلاية	q a l l a j a
جمعي	d͡ʒ a m m i ʕ i
عجلة	ʕ a d͡ʒ i l a
وزراء	w u z a r a ʔ
حسل	ħ i s l
إسلام	ʔ i s l a m
دم	d a m m
تشيلي	t ʃ i l i
فتاحة	f a t t a ħ a
أم	ʔ a m m
بكى	b u k a n
بصل	b a sˤ a l
زحمة	z a ħ m a
تجوف	t a d͡ʒ a w w u f
نخشوش	n a x ʃ u ʃ
غشيم	ɣ a ʃ i m
خريف	x a r i f
محيط	m u ħ i tˤ
حربة	ħ a r b a
زحف	z a ħ f
مأوى	m a ʔ w a n
استشراق	i s t i ʃ r a q
رأسي	r a ʔ s i j j
ميناء	m i n a ʔ
قرر	q a r r a r
شمس	ʃ a m a s a
لاوس	l a w o s
ضرب	dˤ a r r a b a
بركة	b u r k a
بلاستيك	b l a s t i k
سرنديب	s a r a n d i b
رحمن	r u ħ i m n a
صغار	sˤ u ɣ a r
تدريج	t a d r i d͡ʒ
وجهة	w u d͡ʒ h a
إكوادور	ʔ i k w a d o r
نيجيريا	n i d͡ʒ i r i j a
أمكن	ʔ a m k a n a
عجان	ʕ i d͡ʒ a n
أدحية	ʔ u d ħ i j j a
هواء	h a w a ʔ
بحري	b a ħ r i j j
ثفروق	θ u f r u q
محجمة	m i ħ d͡ʒ a m a
غلب	ɣ a l b
قيثار	q i θ a r
مقداد	m i q d æ d
راء	r a ʔ i n
كروية	k a r a w j a
ران	r a n a
بحار	b a ħ ħ a r
هذر	h a ð a r a
رأى	r a ʔ a
فتحة	f a t ħ a
نور	n u r
عرف	ʕ a r f
جرارة	d͡ʒ a r r a r a
بربرية	b a r b a r i j j a
اعتدى	i ʕ t a d a
وروار	w a r w a r
ليزر	l e z a r
ليس	l a j i s a
فطيس	f i tˤ tˤ i s
ضحك	dˤ a ħ i k
جوهري	d͡ʒ a w h a r i j j
ديسمبر	d i s a m b a r
إيمان	ʔ i m a n
زعتر	z a ʕ t a r
سيف	s i f
بلاهة	b a l a h a
استطار	i s t a tˤ a r a
تغريدة	t a ɣ r i d a
آنسة	ʔ a n i s a h
صدق	sˤ i d q
تحرش	t a ħ a r r u ʃ
معير	m u ʕ a j j i r
هم	h i m
رأل	r a ʔ l
إسقنقور	ʔ i s q a n q u r
فراطة	f u r a tˤ a
إطفائي	ʔ i tˤ f a ʔ i j j
اطرد	u tˤ r u d
قطران	q i tˤ r a n
حبل	ħ a b a l
عشية	ʕ a ʃ i j j a
مكاء	m u k k a ʔ
قلم	q ə l ə m
قنبلة	q u n b u l a
داعش	d a ʕ i ʃ
رجل	r a d͡ʒ l
تقضى	t a q a dˤ dˤ a
لزاق	l i z a q
دارجة	d a r i d͡ʒ a
شكوهج	ʃ a k u h a d͡ʒ
بطرخ	b a tˤ r a x
لؤلؤ	l u ʔ l u ʔ
قصار	q i sˤ a r
كمأة	k a m ʔ a
مهارة	m a h a r a
أجهد	ʔ a d͡ʒ h a d a
ليس	l a j s a
ولاعة	w a l l a ʕ a
غبن	ɣ u b n
قاعدة	q a ʕ i d a
شعب	ʃ a ʕ b
علم	ʕ a l i m a
حرص	ħ i r sˤ
قشر	q a ʃ a r a
مغلق	m i ɣ l a q
طرق	tˤ a r r a q a
تاكسي	t a k s i
دمقس	d i m a q s
أكرى	ʔ a k r a
نزلة	n a z l a
رتينج	r a t i n a d͡ʒ
تنفس	t a n a f f a s a
قلم	q a l m
أيل	ʔ u j j a l
تزحلق	t a z a ħ l a q a
أسوأ	ʔ a s w a ʔ
أجزاء	ʔ a d͡ʒ z a ʔ
تاب	t a b a
رداء	r i d a ʔ
تحرش	t u ħ r a ʃ u
ركن	r u k n
صغر	sˤ a ɣ u r a
صفن	sˤ a f a n
مبكرا	m u b a k k i r a n
مسود	m u s w a d d
انتهى	i n t a h a
بنين	b i n i n
وعليكم	w æ ʕ æ l æ j k u m
قبلا	q a b l a n
قيتارة	q i t a r a
ملح	m u l ħ a
سكن	s a k k a n a
كلخ	k a l x
رد	r a d d
شرعية	ʃ a r ʕ i j j a
ذوق	ð a w q
سجنجل	s a d͡ʒ a n d͡ʒ a l
سفيه	s a f i h
ن	n u n
فيج	f a j d͡ʒ
أمغر	ʔ a m ɣ a r
وهمي	w a h m i j j
دفاع	d i f a ʕ
بنان	b a n a n
قطع	q a tˤ a ʕ
بركار	b i r k a r
بغداد	b a ɣ d a d
نحن	n a ħ n i
قفص	ɡ a f a sˤ
دليل	d a l i l
نافلة	n a f i l a
بزرقطونا	b a z r a q a tˤ u n a
جامع	d͡ʒ a m i ʕ
عشب	ʕ u ʃ b
أنت	ʔ a n t a
رهينة	r a h i n a
طاق	tˤ a q
مخرج	m u x r a d͡ʒ
راجل	r a d͡ʒ i l
غبيراء	ɣ u b a j r a ʔ
لحاق	l a ħ a q
أونصة	ʔ u n sˤ a
بديهي	b a d i h i j j
خ	x
ضرط	dˤ a r a tˤ a
زورق	z a w r a q
تنفس	t u n f a s u
آمن	ʔ a m u n a
انتمى	i n t a m a
سبب	s a b a b
غرور	ɣ u r u r
صدر	sˤ a d a r a
قد	q u d d
متناول	m u t a n a w i l
موقع	m a w q i ʕ
تل	t a l l
سياج	s i j a d͡ʒ
طابق	tˤ a b a q
طموحات	tˤ u m u ħ a t
عام	ʕ a m m
مخبول	m a x b u l
مهرجان	m a h r a d͡ʒ a n
بلغاريا	b a l ɣ a r j a
اشتهى	i ʃ t a h a
دابر	d a b i r
إبيقوري	ʔ i b i q u r i j j
مستوصف	m u s t a w sˤ a f
ظمئ	ðˤ a m i ʔ a
مرصد	m a r sˤ a d
مغامر	m u ɣ a m i r
موسمي	m a w s i m i j j
خلنجان	x a l a n d͡ʒ a n
ذاكرة	ð a k i r a
الحبشة	a l ħ a b a ʃ a
جسماني	d͡ʒ i s m a n i j j
فتح	f a t a ħ a
دقنيش	d a q n i ʃ
حائط	ħ a ʔ i tˤ
قفقف	q a f q a f a
صغار	sˤ i ɣ a r
صقر	sˤ a q r
كسوة	k u s w a
عمودي	ʕ a m u d i j j
سقنقور	s a q a n q u r
مؤامرة	m u ʔ a m a r a
غاسول	ɣ a s u l
مدهش	m u d h a ʃ
ملاحظ	m u l a ħ a ðˤ
قشر	q i ʃ r
قدم	q a d m
كذاب	k a ð ð a b
ثلج	θ a l d͡ʒ
لسع	l a s a ʕ a
سخبر	s a x b a r
برقوق	b a r q u q
بادية	b a d i j a
استغرق	i s t a ɣ r a q a
طرشي	tˤ u r ʃ i j j
أنفق	ʔ a n f a q a
بوط	b u tˤ
شوبك	ʃ a w b a k
صابح	sˤ a b i ħ
مذي	m a ð i
بالون	b a l u n
معاينة	m u ʕ a j a n a
كثيف	k a θ i f
اعتزام	i ʕ t i z a m
أغلب	ʔ a ɣ l a b a
خلاعي	x a l a ʕ i j j
راع	r a ʕ i n
تكشف	t a k a ʃ ʃ a f a
ذنب	ð a n a b a
رحمن	r a ħ ħ i m n a
ضاد	dˤ a d d a
بواب	b a w w a b
منارة	m a n a r a
كدس	k a d d a s a
كشوت	k u ʃ u θ
قنبر	ɡ ə m b r i
أجمع	ʔ a d͡ʒ m a ʕ a
زقوم	z a q q u m
حلقوس	ħ a l q u s
ناطف	n a tˤ i f
أعقد	ʔ a ʕ q a d
وتدي	w a t a d i j j
طاولة	tˤ a w i l a
شرطة	ʃ u r tˤ a
عربة	ʕ a r a b a
أخدر	ʔ a x d a r a
طاء	tˤ a ʔ
رتيلاء	r u t a j l a ʔ
منذ	m u n ð u
مشعل	m a ʃ ʕ a l
خثي	x i θ j
هبة	h i b b a
بحر	b a ħ a r a
راسخت	r a s u x t
ق	q a f
روسيا	r u s i j a
علة	ʕ i l l a
لمى	l a m a
هذيان	h a ð a j a n
معى	m i ʕ a n
كوخ	k u x
شيخوخة	ʃ a j x u x a
رفقة	r i f q a
أسترالي	ʔ u s t u r a l i j j
طيارة	tˤ i j j a r a
أحاط	ʔ a ħ a tˤ a
سبتمبر	s a b t a m b a r
وفاء	w æ f æ ʔ
ركبة	r a k a b a
شياف	ʃ i j a f
غبي	ɣ a b i j a
إنجليزي	ʔ i n d͡ʒ l i z i j j
خطف	x a tˤ i f a
كره	k a r u h a
دكان	d u k k a n
مسن	m u s i n n
سلاف	s u l a f
رئيس	r a ʔ i s
تساءل	t a s a ʔ a l a
شوكي	ʃ a w k i j j
تراجيديا	t r a d͡ʒ i d j a
يؤيؤ	j u ʔ j u ʔ
حنة	ħ i n n a
مشتريات	m u ʃ t a r a j a t
أساسي	ʔ a s a s i j j
سكة	s i k k a
وقت	w a q t
ملاحظ	m u l a ħ i ðˤ
بولندا	p o l a n d a
حجة	ħ i d͡ʒ d͡ʒ a
لاح	l a ħ a
استقدم	i s t a q d a m a
محافظ	m a ħ a f i ðˤ
يحيى	j a ħ j a
سنت	s u n n a t
راعدة	r a ʕ i d a
استقل	i s t a q a l l a
شفاف	ʃ a f f a f
ض	ðˤ
موريتانيا	m u r i t a n i j a
واحة	w a ħ a
صوت	sˤ a w t
عجب	ʕ a d͡ʒ a b
وقف	w a q q a f a
اغتصب	i ɣ t a sˤ a b a
نسبي	n i s b i j j
أكثرية	ʔ a k θ a r i j j a
فعل	f a ʕ a l a
غني	ɣ a n i j j
كدس	k a d a s a
عباءة	ʕ a b a ʔ a
حالة	ħ a l a
أسرة	ʔ u s r a
أعذب	ʔ a ʕ ð a b a
عاصف	ʕ a sˤ i f
شابانج	ʃ a b a n a d͡ʒ
يد	j a d
هوندوراس	h o n d u r a s
تعادل	t a ʕ a d a l a
ورى	w a r a
مزمن	m u z m i n
قرش	q a r ʃ
فرشاة	f u r ʃ a h
زوج	z a w d͡ʒ
عسجد	ʕ a s d͡ʒ a d
دستوري	d u s t u r i j j
شطر	ʃ a tˤ a r a
أولى	ʔ u l a
أنفحة	ʔ a n f i ħ a
منغوليا	m o n ɣ o l i j a
جزدان	d͡ʒ i z d a n
مكالمة	m u k a l a m a
نهض	n a h dˤ
بعيثران	b u ʕ a j θ a r a n
صحيفة	sˤ a ħ i f a
باطني	b a tˤ i n i j j
مالك	m a l i k
هميان	h i m j a n
فأر	f a ʔ r
وزغ	w a z a ɣ
أخ	ʔ a x
أشعل	ʔ a ʃ ʕ a l
لم	l a m
جلنار	d͡ʒ u l l a n a r
استنتاج	i s t i n t a d͡ʒ
محيل	m u ħ i l
فوذنج	f u ð a n a d͡ʒ
لوطي	l u tˤ i
إدارة	ʔ i d a r a
حنجري	ħ a n d͡ʒ a r i j j
حرمل	ħ a r m a l
طقس	tˤ a ʔ s
طقس	tˤ a q s
تدرب	t a d a r r u b
غير	ɣ a j j a r a
إنترنت	ʔ i n t a r n a t
تعزل	t a ʕ a z z a l a
شمشاد	ʃ a m ʃ a d
قنجة	q a n d͡ʒ a
شب	ʃ a b b a
حقق	ħ u q a q
قبج	q a b a d͡ʒ
أصغى	ʔ a sˤ ɣ a
سئم	s a ʔ i m a
آخر	ʔ a x a r
مشواة	m i ʃ w a h
أرجواني	ʔ u r d͡ʒ u w a n i j j
درس	d a r r a s a
علي	ʕ a l i j a
أراد	ʔ a r a d a
توزيع	t a w z i ʕ
دين	d a j j a n a
نسكي	n u s u k i j j
استجهل	i s t a d͡ʒ h a l a
كهنوت	k a h a n u t
سكران	s a k r a n
ط	tˤ
تغريد	t a ɣ r i d
جذع	d͡ʒ a ð a ʕ
بثور	b u θ u r
زنجبيل	z a n d͡ʒ a b i l
بطروخ	b a tˤ r u x
أخلاقية	ʔ a x l a q i j j a
اصهب	i sˤ h a b b a
أعتن	ʔ a ʕ t a n a
ترجمة	t a r d͡ʒ a m a
رمل	r a m l
تدرج	t a d a r r u d͡ʒ
القسطنطينية	a l q u s tˤ a n tˤ i n i j j a
ؤ	ʔ u
