ㅇㅚㅎㅏㄹㅁㅓㄴㅣ	weɦaɭmʌni
ㅁㅣㄹㄹㅏㅂ	miɭɭap̚
ㅅㅏㄹㅏㅇㅎㅏㄷㅏ	sʰaɾaŋɦada
ㅇㅣㄱㅛ	iɡjo
ㅂㅗㄱㄹㅣ	poŋni
ㄷㅓㅅㄱㅡㄹ	tʌt̚kɯɭ
ㄴㅏㄹ	naɭ
ㅋㅏㅁㅔㄹㅜㄴ	kʰameɾun
ㅇㅜㄱㅏㄴㄷㅏ	uɡanda
ㄱㅓㄱㅈㅓㅇㅎㅏㄷㅏ	kʌk̚t͡ɕʌŋɦada
ㄱㅏㄱㅂㅗㄴ	kak̚pon
ㅁㅜㄴㅇㅓ	munʌ
ㅂㅗㄴㄸㅡㄷㅏ	pontɯda
ㅌㅡㄱㅅㅜ	tʰɯksu
ㄱㅠㅊㅣㄱㅈㅓㄱ	kjut͡ɕʰik̚t͡ɕʌk̚
ㅁㅗㄷㅡㅁ	modɯm
ㅈㅓㅂㅅㅗㄱ	t͡ɕʌpsok̚
ㅈㅜㅈㅓㅇ	t͡ɕud͡ʑʌŋ
ㅅㅣㅇㄱㅓㅂㄷㅏ	ɕʰiŋɡʌp̚ta
ㅂㅜㄱㄱㅚ	puk̚kwe
ㅁㅔㅌㅗㄲㅣ	metʰoki
ㅎㅘㅅㅏㄴㅎㅏㄱ	ɸwasʰanɦak̚
ㄴㅓㅁㅜ	nʌmu
ㄸㅔㄴㄴㅗ	tenno
ㅇㅏㅎㅡㄹㅔ	aɣɯɾe
ㅁㅐㅇㅅㅔ	mɛŋsʰe
ㅁㅣㄹㄷㅏ	miɭda
ㄱㅘㄴㄴㅕㅁ	kwanɲjʌm
ㅅㅜㄴㄱㅛ	sʰunɡjo
ㄱㅘㅎㅏㄱㅈㅏ	kwaɦak̚t͡ɕa
ㅂㅏㄱㅇㅣ	paɡi
ㅈㅏㅂㅅㅜㅅㅣㄷㅏ	t͡ɕapsuɕʰida
ㅎㅗㄴㅈㅏ	ɸʷoɲd͡ʑa
ㄴㅚ	nwe
ㄹㅏㅂㅗㄲㅇㅣ	ɾaboki
ㅇㅣㄱㅅㅏㄹ	iksaɭ
ㄷㅜㅅㅔㅅ	tusʰet̚
ㄱㅡㄹㅔㅇㅣㅌㅡㅂㅡㄹㅣㅌㅡㄴ	kɯɾeitʰɯbɯɾitʰɯn
ㅇㅣㄱㅣㅈㅜㅇㅢ	iɡid͡ʑuɰi
ㅁㅕㄹㅈㅗㅇ	mjʌʎt͡ɕoŋ
ㅇㅗㄱㅈㅏㅁㅎㅘ	ok̚t͡ɕamβwa
ㅇㅓㅂㄷㅜㅇㅇㅣ	ʌp̚tuŋi
ㅇㅠㄹㅣ	juɾi
ㅁㅗㄱㅈㅓㄱㄹㅗㄴ	mok̚t͡ɕʌŋnon
ㅈㅓㄹㄷㅏ	t͡ɕɘɭda
ㄷㅐㄹㅣㅅㅓㄱ	tɛɾisʰʌk̚
ㅎㅏㄴㄲㅓㅂㅓㄴㅇㅔ	hankʌbʌne
ㅌㅡㄱㄱㅝㄴ	tʰɯk̚kwʌn
ㅍㅡㄹㄹㅜㅌㅗㄴㅠㅁ	pʰɯɭɭutʰoɲjum
ㄱㅘㄴㄹㅕㄴㅎㅏㄷㅏ	kwaʎʎjʌnɦada
ㄴㅗㅇㄱㅕㅇ	noŋɡjʌŋ
ㅍㅜㄹㅇㅗㅂㅓ	pʰuɾobʌ
ㅍㅔㅅㅑㅇㅘㄹㅡ	pʰeɕʰawaɾɯ
ㅅㅡㅂㄷㅗ	sʰɯp̚to
ㅁㅏㅇㅛㄴㅔㅈㅡ	majoned͡ʑɯ
ㅁㅜㅈㅜㅇㄹㅕㄱ	mud͡ʑuŋɲjʌk̚
ㄴㅜㄴㄷㅜㄷㅓㅇ	nundudʌŋ
ㅂㅕㄴㅇㅏㅂㄱㅣ	pjʌnap̚ki
ㄱㅣㄹㅡㅁ	kiɾɯm
ㅇㅚㄱㅜㄱㅇㅓ	weɡuɡʌ
ㅍㅡㄹㄹㅏㅅㅡㅁㅏ	pʰɯɭɭasʰɯma
ㅂㅡㄹㅔㅇㅣㅋㅡ	pɯɾeikxɯ
ㅎㅘㄹㄷㅗㅇㅈㅓㄱ	ɸwaɭtoŋd͡ʑʌk̚
ㅋㅏㄷㅣㄱㅓㄴ	kʰadiɡʌn
ㄱㅏㄱㅗㅇㅎㅏㄷㅏ	kaɡoŋɦada
ㅁㅜㅅㅏㄷㅗ	musʰado
ㄱㅣㄹㅡㅁㅅㅏㅌㅏㅇ	kiɾɯmsʰatʰaŋ
ㄴㅏㅅㅗ	nasʰo
ㅅㅣㄹㅈㅔㄹㅗ	ɕʰiʎt͡ɕeɾo
ㅊㅓㅂㅏㅇㅈㅓㄴ	t͡ɕʰɘbaŋd͡ʑʌn
ㅂㅗㄹ	poɭ
ㄷㅗㄲㅛ	tokjo
ㅌㅗㅇㅅㅏㄹㅣ	tʰoŋsʰaɾi
ㅈㅏㅍㅖㅈㅡㅇ	t͡ɕapʰjet͡ɕɯŋ
ㅊㅓㅁ	t͡ɕʰʌm
ㅂㅜㅈㅗㄱ	pud͡ʑok̚
ㅈㅓㄹ	t͡ɕʌɭ
ㄷㅏㅇㄹㅠ	taŋɲju
ㅍㅡㅌㅔㄹㅣㄷㅣㄴ	pʰɯtʰeɾidin
ㄷㅗㄷㅜㄱ	toduk̚
ㅇㅜㄹ	uɭ
ㅇㅔㅁㅣ	emi
ㅁㅗㄷㅠㄹ	modjuɭ
ㅅㅠㅇㅣㄴ	ɕʰuin
ㅅㅡㅇㅞㄷㅔㄴ	sʰɯweden
ㄱㅜㄱㅁㅜㄹ	kuŋmuɭ
ㅆㅏㅇㄲㅓㅍㅜㄹ	saŋkʌpʰuɭ
ㅇㅣㄹㅡㅋㅜㅊㅡㅋㅡ	iɾɯkʰut͡ɕʰɯkxɯ
ㅇㅏㅇㅑ	aja
ㅂㅗㅅㅏㄹㅍㅣㄷㅏ	posʰaɭpʰida
ㅁㅏㄴㅇㅕㅂㅈㅣㅂ	maɲjʌp̚t͡ɕip̚
ㅉㅣㄴ	t͡ɕin
ㅇㅕㄴㄹㅏㄱㅎㅏㄷㅏ	jʌɭɭakʰada
ㅇㅓㄴㅈㅔ	ɘɲd͡ʑe
ㅅㅣㄱㅖ	ɕʰiɡje
ㅁㅏㅋㅔㄷㅗㄴㅣㅇㅏㅇㅓ	makʰedoniaʌ
ㄱㅏㅌㄷㅏ	kat̚ta
ㅇㅣㄴㅈㅡㅇㅎㅏㄷㅏ	iɲd͡ʑɯŋɦada
ㄸㅏㄱㄷㅏㄱㅡㄹㅡㄹㅡㄸㅏㄱㄷㅏㄱㅡㄹㅡㄹㅡㅎㅏㄷㅏ	tak̚taɡɯɾɯɾɯtak̚taɡɯɾɯɾɯɦada
ㄱㅗㅇㅅㅡㅂ	koŋsʰɯp̚
ㄴㅏㅁㅇㅝㄹ	namwʌɭ
ㄱㅟㅇㅕㅁㄷㅜㅇㅇㅣ	kɥijʌmduŋi
ㅁㅜㅈㅣㄴ	mud͡ʑin
ㅅㅣㅁㅎㅏㄷㅏ	ɕʰimɦada
ㅇㅗㅀㅇㅏ	oɾa
ㅅㅏㄴㅂㅜㄹ	sʰanbuɭ
ㅌㅡㄴㅌㅡㄴㅎㅏㄷㅏ	tʰɯntʰɯnɦada
ㄱㅗㄴㄹㅏㄴㅎㅏㄷㅏ	koɭɭanɦada
ㅅㅓㅇㅈㅣㄹ	sʰɘŋd͡ʑiɭ
ㄱㅜㅊㅟ	kut͡ɕʰɥi
ㅁㅏㄱㅜㄱㅏㄴ	maɡukan
ㅇㅔㅁㅔㄹㅁㅜㅈㅣㄹㅗ	emeɭmud͡ʑiɾo
ㄷㅡㄹㅇㅓㅇㅗㄷㅏ	tɯɾʌoda
ㅅㅏㅁㅏㅇ	sʰamaŋ
ㅍㅣㄹㅇㅛㅅㅓㅇ	pʰiɾjosʌŋ
ㅌㅗㅇㄴㅏㅁㅜ	tʰoŋnamu
ㅋㅡㄹㄹㅣㅌㅗㄹㅣㅅㅡ	kxɯʎʎitʰoɾisʰɯ
ㅇㅏㄴㅇㅘ	anwa
ㄱㅗㅇㄹㅣ	koŋni
ㅎㅔㅇㅏㄹㅣㄷㅏ	heaɾida
ㅋㅜㅇㅎㅜ	kʰuŋβu
ㄱㅡㅁㅂㅏㄹ	kɯmbaɭ
ㅇㅕㄴㄱㅣㅈㅏ	jɘnɡid͡ʑa
ㄷㅗㄹㄷㅡ	toɭdɯ
ㄷㅏㅁㄷㅏㅇㅎㅏㄷㅏ	tamdaŋɦada
ㄲㅜㄷㅏ	kuda
ㅂㅣㅂㅣㄷㅏ	pibida
ㅇㅏㄱㅟ	aɡɥi
ㄹㅗㅆㅣㅇㅑ	ɾoɕija
ㅅㅓㅇㅈㅏㅇㅎㅏㄷㅏ	sʰʌŋd͡ʑaŋɦada
ㅂㅜㄸㅜㅁㅏㄱ	putumak̚
ㅇㅏㅁㅅㅡㅌㅔㄹㅡㄷㅏㅁ	amsʰɯtʰeɾɯdam
ㄷㅐㅈㅜㄱㅛ	tɛd͡ʑuɡjo
ㄴㅜㄴㅂㅣㅊ	nunpit̚
ㄱㅗㄱㅜㅁㅏ	koɡuma
ㄴㅜㄴㅇㅏㅍ	nunap̚
ㅁㅏㄹㅆㅓㅇㄲㅜㄹㅓㄱㅣ	maɭsʌŋkuɾʌɡi
ㅍㅔㄹㅜ	pʰeɾu
ㅂㅓㄷㅡㄹㅊㅣ	pʌdɯʎt͡ɕʰi
ㄱㅘㄴㄱㅘㅇ	kwanɡwaŋ
ㅎㅏㄴㅁㅜㄴ	hanmun
ㅇㅣ	i
ㄲㅗㄹㅣ	koɾi
ㄱㅜㅎㅗㄴ	kuβon
ㅎㅡㄴㄷㅡㄹㄷㅏ	xɯndɯɭda
ㅂㅏㅁ	pam
ㅈㅓㅇㅇㅡㅁ	t͡ɕʌŋɯm
ㄷㅗㅊㅏㄱㅎㅏㄷㅏ	tot͡ɕʰakʰada
ㅂㅜㄴㅅㅓㄱㅎㅏㄷㅏ	punsʰʌkʰada
ㅊㅏㅁㅅㅜㄹㅣ	t͡ɕʰamsʰuɾi
ㅎㅏㅁㅅㅜ	hamsu
ㅈㅔㅂㅗ	t͡ɕebo
ㄴㅓㄹㅃㅏㄴㅈㅣ	nɘɭpaɲd͡ʑi
ㅍㅗㅇㅗㅇㅎㅏㄷㅏ	pʰooŋɦada
ㅇㅓㄸㅓㅎㄷㅏ	ʌtʌtʰa
ㅅㅔㄱㅅㅡ	seksɯ
ㅊㅚㅁㅕㄴㅅㅜㄹ	t͡ɕʰwemjʌnsʰuɭ
ㅅㅣㅂㄱㅜ	ɕʰip̚ku
ㄷㅗㅇㄱㅡㄹ	toŋɡɯɭ
ㅂㅜㄹㄱㅏㄱㅕㄹ	puɭɡaɡjʌɭ
ㅍㅕㄴㄹㅣ	pʰjʌʎʎi
ㄱㅘㅇㅎㅘㅁㅜㄴ	kwaŋβwamun
ㄱㅡㄴㅈㅣㄹㄱㅡㄴㅈㅣㄹㅎㅏㄷㅏ	kɯɲd͡ʑiɭɡɯɲd͡ʑiɾɦada
ㅆㅗㄱㅏㄹㅣ	soɡaɾi
ㄷㅏㄹㅖㄴ	taɾjen
ᆸㄴㅣㄷㅏ	mnida
ㅌㅔㅅㅡㅌㅡ	tʰesʰɯtʰɯ
ㅎㅡㄹㅡㅁ	xɯɾɯm
ㅎㅗㄴㅇㅑㄱ	ɸʷoɲjak̚
ㅅㅡㅍㅏㅇㅣ	sʰɯpʰai
ㅇㅖㅃㅡㄷㅏ	jepɯda
ㅂㅗㄷㅗㅎㅏㄷㅏ	podoɦada
ㅇㅓㄸㅓㅎㄱㅔ	ʌtʌkʰe
ㄱㅜㄻㅈㅜㄹㅣㄷㅏ	kumd͡ʑuɾida
ㅎㅜㅁㅊㅣㄷㅏ	ɸʷumt͡ɕʰida
ㄱㅔㅇㅡㄹㅡㅁ	keɯɾɯm
ㄴㅜㄹㅓㅇㅇㅣ	nuɾʌŋi
ㄱㅐㅅㄱㅘ	kɛt̚kwa
ㅇㅏㅃㅏㅌㅡ	apatʰɯ
ㅅㅏㄱㅘ	sʰaɡwa
ㅁㅕㅇㄹㅕㅇㅂㅓㅂ	mjɘŋɲjʌŋbʌp̚
ㄱㅏㄹㅏㅇㅂㅣ	kaɾaŋbi
ㅈㅓㅇㅊㅣㄱㅝㄴ	t͡ɕʌŋt͡ɕʰikwʌn
ㅅㅏㅁㅏㄱㅟ	sʰamaɡɥi
ㄹㅗㅁㅏㅈㅏ	ɾomad͡ʑa
ㄱㅏㅂㅗㅇ	kaboŋ
ㅅㅔㅈㅔ	sʰed͡ʑe
ㅍㅛㅈㅜㄴ	pʰjod͡ʑun
ㅇㅓㄱㅏㅁ	ɘɡam
ㅋㅗㄴㅅㅔㅂㅌㅡ	kʰonsʰep̚tʰɯ
ㄱㅡㄹㅓㅁㅡㄹㅗ	kɯɾʌmɯɾo
ㅂㅕㄴㅈㅓㄹ	pjɘɲd͡ʑʌɭ
ㅇㅗㄷㅔㅅㅏ	odesʰa
ㅋㅏㄹㅡㅂㅗㄱㅅㅣㄹㄱㅣ	kʰaɾɯbokɕiɭɡi
ㄴㅏㅎㅡㄹ	naɣɯɭ
ㅁㅣㄴㅈㅜㅎㅘ	miɲd͡ʑuβwa
ㄹㅔㅅㅡㄹㄹㅣㅇ	ɾesʰɯʎʎiŋ
ㅎㅗㅇㅅㅜ	ɸʷoŋsʰu
ㅇㅗㄴㅊㅓㄴ	oɲt͡ɕʰʌn
ㄹㅣㅅㅡㅂㅗㄴ	ɾisʰɯbon
ㅅㅡㅌㅏㄷㅣㅇㅗ	sʰɯtʰadio
ㅎㅏㅁㅂㅜㄹㅗ	hambuɾo
ㄴㅗㅊㅓㄴㅕ	not͡ɕʰʌɲjʌ
ㅋㅡㄹㅗㅋㅔㅅ	kxɯɾokʰet̚
ㅇㅓㅍㄷㅡㄹㅣㄷㅏ	ʌp̚tɯɾida
ㅅㅔㅁㅣㅋㅗㄹㄹㅗㄴ	sʰemikʰoɭɭon
ㅎㅏㄴㄷㅜ	handu
ㅁㅓㅁㅊㅜㄷㅏ	mʌmt͡ɕʰuda
ㅈㅜㅇㄱㅓ	t͡ɕuŋɡʌ
ㅎㅏㄱㅈㅏ	hak̚t͡ɕa
ㅁㅗㅇㅣㄷㅏ	moida
ㄷㅡㅇㅈㅜㄹㅈㅟ	tɯŋd͡ʑuʎd͡ʑɥi
ㅅㅡㅌㅡㄹㅔㅇㅣㅌㅡ	sʰɯtʰɯɾeitʰɯ
ㅊㅓㅇㅊㅜㄴ	t͡ɕʰʌŋt͡ɕʰun
ㅇㅣㅃㅏㅇㅣ	ipai
ㄱㅡㄴㅑㅇ	kɯɲjaŋ
ㄴㅗㄴㅕㄴ	noɲjʌn
ㅈㅓㅎㅏㅇㄱㅣ	t͡ɕʌɦaŋɡi
ㅇㅠㄱㅏㅈㅡㅇㄱㅝㄴ	juɡad͡ʑɯŋkwʌn
ㅇㅏㄹㅣㄹㅏㅇ	aɾiɾaŋ
ㅌㅗㅇㅊㅏㄹㄹㅕㄱ	tʰoŋt͡ɕʰaʎʎjʌk̚
ㅅㅏㄹㅇㅏㄴㅏㅁㄷㅏ	sʰaɾanamta
ㅇㅏㄹㅋㅗㄹ	aɭkʰoɭ
ㅂㅜㅈㅏㄱㅇㅛㅇ	pud͡ʑaɡjoŋ
ㅈㅓㅇㅈㅏㅇ	t͡ɕɘŋd͡ʑaŋ
ㅊㅗㄴ	t͡ɕʰon
ㄴㅏㄴㅜㄷㅏ	nanuda
ㅇㅡㄹ	ɯɭ
ㅇㅠㅇㅣㄹ	juiɭ
ㅁㅏㄹㅏㅌㅗㄴ	maɾatʰon
ㅇㅕㅇㅣㄴㅅㅜㄱ	jʌinsʰuk̚
ㅂㅏㄴㅎㅏㅇㅎㅏㄷㅏ	panɦaŋɦada
ㅅㅗㄴㄱㅏㄹㅏㄱ	sʰonkaɾak̚
ㅅㅣㄹㄹㅗㅍㅗㄴ	ɕʰiɭɭopʰon
ㅂㅏㄴㄷㅡㅅㅣ	pandɯɕʰi
ㅈㅣㅈㅓㅇㅎㅏㄱ	t͡ɕid͡ʑʌŋɦak̚
ㅁㅜㄴㅢㅁㅏㅇㄷㅜㄱ	munimaŋduk̚
ㅁㅗㄳ	mok̚
ㄱㅛㅇㅚ	kjowe
ㅇㅕㄴㅊㅔㄷㅗㅇㅁㅜㄹ	jɘɲt͡ɕʰedoŋmuɭ
ㅎㅗㅂㅜㄱ	ɸʷobuk̚
ㅁㅜㄱㅣㄱㅗ	muɡiɡo
ㄷㅓㅇㅟ	tʌɥi
ㅁㅗㅂㅏㅇㅎㅏㄷㅏ	mobaŋɦada
ㅈㅏㄹㅜ	t͡ɕaɾu
ㄱㅘㅇㅅㅓㄱ	kwaŋsʰʌk̚
ㅅㅓㅁㄷㅗㄹ	sʰʌmtoɭ
ㅇㅘㅇㅎㅗㄹ	waŋβoɭ
ㄱㅗㅇㅇㅓㄴ	koŋʌn
ㄸㅏㄹㄲㅜㄱㅈㅣㄹㅎㅏㄷㅏ	taɭkuk̚t͡ɕiɾɦada
ㅅㅓㄴㅈㅣㄴㄱㅜㄱ	sʰʌɲd͡ʑinɡuk̚
ㅈㅓㄴㅇㅕㄱ	t͡ɕɘɲjʌk̚
ㅅㅡㅂㄴㅣㄲㅏ	sɯmnika
ㅋㅗㄹㄹㅗㄴ	kʰoɭɭon
ㅂㅣㄹㄴㅠㅅㅡ	piʎʎjusʰɯ
ㅅㅣㄹㄹㅗㄱ	ɕʰiɭɭok̚
ㄴㅏㅌㅡㄹㅠㅁ	natʰɯɾjum
ㅅㅛㅋㅡ	ɕʰokxɯ
ㅇㅕㄴㄱㅜㅈㅏ	jɘnɡud͡ʑa
ㄲㅗㅁㅏ	koma
ㅇㅏㄱㅏ	aɡa
ㅂㅣㅈㅜㅇ	pid͡ʑuŋ
ㅈㅏㅇㅇㅡㅁ	t͡ɕaŋɯm
ㄱㅘㅇㅎㅗㅎㅡㅂ	kwaŋβoɣɯp̚
ㅇㅕㄴㅏㅁㅇㅡㄴ	jʌnamɯn
ㅅㅗㄴㅈㅓㄴㄷㅡㅇ	sʰoɲt͡ɕʌndɯŋ
ㅅㅔㄱㅖㅍㅕㅇㅎㅘ	sʰeɡjepʰjʌŋβwa
ㄸㅢㄷㅏ	tida
ㅊㅓㄹㅓㅁ	t͡ɕʰʌɾʌm
ㄱㅓㅅㅡㄹㅓㅁㅣ	kʌsʰɯɾʌmi
ㅊㅓㅇㅊㅓㄴㅂㅕㄱㄹㅕㄱ	t͡ɕʰʌŋt͡ɕʰʌnbjʌŋɲjʌk̚
ㄸㅓㄱㄱㅜㄱ	tʌk̚kuk̚
ㅅㅜㅈㅣㅂㅎㅏㄷㅏ	sʰud͡ʑipʰada
ㄱㅓㄹㅣ	kɘɾi
ㅅㅜㅇㅛㅇㅣㄹ	sʰujoiɭ
ㅂㅏㅇㅈㅜ	paŋd͡ʑu
ㄱㅓㄹㅇㅡㅁ	kʌɾɯm
ㅅㅔㄱㅠㄴ	sʰeɡjun
ㅂㅗㄹㄱㅣ	poɭɡi
ㅅㅗㅇㄱㅜ	sʰoŋɡu
ㅇㅓㄹㅣㅅㅓㄱㄷㅏ	ʌɾisʰʌk̚ta
ㅊㅏㄹ	t͡ɕʰaɭ
ㅂㅏㅇㅣㅇㅗ	paio
ㅇㅓㅇㅜㄹㅓㅈㅣㄷㅏ	ʌuɾʌd͡ʑida
ㅅㅗㅇㄷㅗ	sʰoŋdo
ㄱㅏㅍㅏㄹㅡㄷㅏ	kapʰaɾɯda
ㅈㅗㅇㅛㅇ	t͡ɕojoŋ
ㅇㅏㄴㅌㅡㄹㅏㅅㅔㄴ	antʰɯɾasʰen
ㅋㅡㄴㄱㅗㄴㅣ	kxɯnɡoni
ㅇㅏㄹㄲㅏㄱㅣ	aɭkaɡi
ㅇㅘㅇㅂㅣ	waŋbi
ㄷㅐㅇㅡㅇ	tɛɯŋ
ㄱㅘㅇㄷㅜㅇ	kwaŋduŋ
ㅅㅣㄱㅅㅏㅎㅏㄷㅏ	ɕʰiksaɦada
ㄱㅗㅇㅈㅜㅇ	koŋd͡ʑuŋ
ㅌㅟㄹㅡㅋㅡ	tʰɥiɾɯkxɯ
ㅁㅏㄴㄴㅏㅁ	mannam
ㅋㅗㅁㅍㅗㅌㅡ	kʰompʰotʰɯ
ㄴㅏㅇㅣ	nai
ㄱㅝㄴㅊㅗㅇ	kwɘɲt͡ɕʰoŋ
ㄴㅏㄱㅎㅏㅎㅏㄷㅏ	nakʰaɦada
ㄱㅗㅇㅅㅗㄴㅎㅏㄷㅏ	koŋsʰonɦada
ㄱㅗㅇㅎㅘㅇ	koŋβwaŋ
ㄱㅐㄷㅏ	kɛda
ㅅㅏㄱㅖ	sʰakje
ㅇㅚㄹㅗㅂㄷㅏ	weɾop̚ta
ㅊㅜㄱㄱㅜ	t͡ɕʰuk̚ku
ㄱㅗㄹㅑㅇㅈㅜ	koɾjaŋd͡ʑu
ㅅㅡㅋㅗㅍㅔ	sʰɯkʰopʰe
ㅂㅜㄴㅍㅗㅎㅏㄷㅏ	punpʰoɦada
ㅁㅜㅂㅣㅇㅇㅝㅋㅡ	mubiŋwʌkxɯ
ㅅㅏㅇㅣㄹㅔㄴ	saiɾen
ㅎㅡㄹㅡㄷㅏ	xɯɾɯda
ㅘ	wa
ㅅㅗㄹㅣㅂㅈㅏ	sʰoɾip̚t͡ɕa
ㅅㅣㅊㅓㅇ	ɕʰit͡ɕʰʌŋ
ㄹㅏㅇㅣㅂㅔㄹㅣㅇㅏ	ɾaibeɾia
ㅈㅣㄴㅇㅓㄴ	t͡ɕinʌn
ㅅㅣㅂㅊㅣㄹ	ɕʰip̚t͡ɕʰiɭ
ㄱㅡㄴㅗㅅㅣㅅㅡ	kɯnoɕʰisʰɯ
ㅇㅡㅁㅁㅗㄱ	ɯmmok̚
ㅈㅓㄱㅓㅅ	t͡ɕʌɡʌt̚
ㅎㅡㄳ	xɯk̚
ㅋㅗㄹㅋㅏㅌㅏ	kʰoɭkʰatʰa
ㄱㅛㅊㅏㄹㅗ	kjot͡ɕʰaɾo
ㅂㅗㅁㄴㅏㄹ	pomnaɭ
ㄴㅔㅂㅏㄷㅏ	nebada
ㅇㅡㅁㄹㅑㅇ	ɯmɲjaŋ
ㅈㅗㅊㅗㄹㅎㅏㄷㅏ	t͡ɕot͡ɕʰoɾɦada
ㅇㅓㄹㄷㅏ	ɘɭda
ㅅㅡㅋㅔㅇㅣㅌㅡ	sʰɯkʰeitʰɯ
ㅇㅔㅅㅡㅍㅏㄴㅑ	esʰɯpʰaɲja
ㅈㅓ	t͡ɕʌ
ㅈㅗㅎㄷㅏ	t͡ɕotʰa
ㅍㅡㄹㅏㅅㅔㅇㅗㄷㅣㅁㅠㅁ	pʰɯɾasʰeodimjum
ㅂㅗㅈㅣ	pod͡ʑi
ㄲㅝㅇ	kwʌŋ
ㅌㅜㄹ	tʰuɭ
ㅈㅓㅇㅊㅏㄹㅂㅕㅇ	t͡ɕʌŋt͡ɕʰaɭbjʌŋ
ㅅㅏㅁㅅㅜ	sʰamsʰu
ㅍㅓㄹㅅㅓ	pʰʌɭsʰʌ
ㅇㅝㄹㅇㅣㄹ	wʌɾiɭ
ㄷㅗㄹㅅㅏㅇㅇㅓ	toɭsʰaŋʌ
ㅇㅣㅋㅡㄹㅏ	ikxɯɾa
ㅂㅜㅈㅓㄱ	pud͡ʑʌk̚
ㅁㅏㄴㅇㅠㅇㅣㄴㄹㅕㄱ	maɲjuiʎʎjʌk̚
ㄴㅡㄹㅇㅓㅅㅓㄷㅏ	nɯɾʌsʰʌda
ㅅㅗㅇㅝㄴ	sʰowʌn
ㅇㅜㅁㅉㅏㄹ	umt͡ɕaɭ
ㄴㅗㅅㅓㄴ	nosʰʌn
ㅁㅕㄴㅇㅕㄱㅎㅏㄱ	mjʌɲjʌkʰak̚
ㅁㅕㄱㅅㅏㄹ	mjʌksaɭ
ㅈㅔㅍㅜㅁ	t͡ɕepʰum
ㅇㅕㅇㄱㅜㄱㅇㅣㄴ	jʌŋɡuɡin
ㄱㅣㅁㅈㅓㅇㅇㅣㄹㅎㅘ	kimd͡ʑʌŋiɾβwa
ㄱㅏㄴㅡㅁ	kanɯm
ㅇㅜㅁㅓㄴ	umʌn
ㅇㅓㄹㄱㅜㄹ	ʌɭɡuɭ
ㅊㅏㅇㅣㄴㅣㅅㅡ	t͡ɕʰainisʰɯ
ㅉㅏㅂ	t͡ɕap̚
ㅇㅓㅇㅁㅏㅇㅈㅣㄴㅊㅏㅇ	ʌŋmaŋd͡ʑiɲt͡ɕʰaŋ
ㅈㅏㅂㅈㅗㅇ	t͡ɕap̚t͡ɕoŋ
ㅅㅣㅈㅓㄹ	ɕʰid͡ʑʌɭ
ㅊㅣㄹㅡㄷㅏ	t͡ɕʰiɾɯda
ㄱㅓㅇㅜㅅ	kʌut̚
ㅈㅣㄴㅡㅇ	t͡ɕinɯŋ
ㅁㅣㅇㅏ	mia
ㅈㅗㅈㅣㄱㅎㅏㄱ	t͡ɕod͡ʑikʰak̚
ㅉㅣㅈㄷㅏ	t͡ɕit̚ta
ㄲㅜㄹㅂㅓㄹ	kuɭbʌɭ
ㅇㅗㄹㅡㄴ	oɾɯn
ㅇㅏㅍㅏㄹㅡㅌㅡㅎㅔㅇㅣㅌㅡ	apʰaɾɯtʰɯɦeitʰɯ
ㅊㅏㄷㅗㄹㅂㅏㄱㅇㅣ	t͡ɕʰadoɭbaɡi
ㅅㅜㄴㅎㅚㅅㅣㅁㅍㅏㄴㅅㅗ	sʰunβweɕʰimpʰansʰo
ㅇㅣㅎㅜ	iβu
ㅁㅗㄹㅌㅏ	moɭtʰa
ㅅㅜㄹ	sʰuɭ
ㅇㅓㄷㅣㅇㅕ	ʌdijʌ
ㄱㅣㅎㅜㅎㅏㄱ	kiβuɦak̚
ㅅㅏㅁㅅㅣㅂ	sʰamɕʰip̚
ㅇㅏㅇㅣ	ai
ㅂㅗㅈㅗㄴ	pod͡ʑon
ㅇㅓㅇㅜㄹㄹㅣㄷㅏ	ʌuʎʎida
ㅁㅏㄴㅈㅜㄱㅜㄱ	maɲd͡ʑuɡuk̚
ㅇㅗㄴㄷㅜㄹㅏㅅㅡ	onduɾasʰɯ
ㅆㅏㅇㄷㅗㅇㅇㅣ	saŋdoŋi
ㅇㅡㅁㅅㅣㄱㅈㅓㅁ	ɯmɕʰik̚t͡ɕʌm
ㅇㅢㅈㅣ	ɰid͡ʑi
ㄷㅟㄴㅡㅈㄷㅏ	tɥinɯt̚ta
ㅇㅏㄹㅁㅏㅈㄷㅏ	aɭmat̚ta
ㅇㅠㄴㅡㅇㅎㅏㄷㅏ	junɯŋɦada
ㅇㅏㅂㅓㄴㅣㅁ	abʌnim
ㅂㅣㄹㅗㅅㅗ	piɾosʰo
ㅂㅣㅇㅛㅇ	pijoŋ
ㄹㅗㅅㅕㄴ	ɾoɕʰʌn
ㅁㅐㄷㅏㄹㄷㅏ	mɛdaɭda
ㄱㅣㅊㅏ	kit͡ɕʰa
ㅎㅓㅇㅛㅇㅎㅏㄷㅏ	hʌjoŋɦada
ㅊㅜㄹㅅㅣㄴㅅㅓㅇㅂㅜㄴ	t͡ɕʰuɭɕinsʰʌŋbun
ㅁㅏㅊㅣㄷㅏ	mat͡ɕʰida
ㅈㅏㄱㅏㄹ	t͡ɕaɡaɭ
ㄱㅗㄹㅁㅗㄱ	koɭmok̚
ㅇㅕㅁㅅㅗ	jʌmsʰo
ㄴㅏㄴㅏㄴㅣ	nanani
ㅇㅣㅈㅔ	id͡ʑe
ㅇㅣㅅㅡㄹㄹㅏㅁㄱㅛ	isʰɯɭɭamɡjo
ㄴㅓㄼㅇㅣ	nʌɭbi
ㅈㅗㄱㅏㅂㅣ	t͡ɕoɡabi
ㅈㅣㅇㅏㅂ	t͡ɕiap̚
ㅇㅣㅂㅎㅏㄱ	ipʰak̚
ㅇㅗㄹㅣ	oɾi
ㅇㅖㅎㅜ	jeβu
ㅊㅣㄴㅊㅓㄱ	t͡ɕʰiɲt͡ɕʰʌk̚
ㅇㅛㅇㄷㅗ	joŋdo
ㅍㅛㅈㅜㄴㅎㅘ	pʰjod͡ʑunβwa
ㅁㅏㄴㄷㅡㄹㄷㅏ	mandɯɭda
ㄱㅏㅇㅅㅓㄹ	kaŋsʰʌɭ
ㅅㅗㄴㅅㅏㅇㅎㅏㄷㅏ	sʰonsʰaŋɦada
ㅅㅗㄱㅁㅏㅇㅡㅁ	sʰoŋmaɯm
ㄱㅕㅇㄱㅣㅊㅜㅇㅊㅓㅇㄷㅗㅂㅏㅇㅇㅓㄴ	kjʌŋɡit͡ɕʰuŋt͡ɕʰʌŋdobaŋʌn
ㅈㅗㅎㅇㅏㅎㅏㄷㅏ	t͡ɕoaɦada
ㄱㅘㅇㅇㅕㄱㅅㅣ	kwaŋjʌkɕi
ㄱㅔㄴ	ken
ㄴㅏㅁㄱㅡㄱ	namɡɯk̚
ㄸㅣㅁㅜㄴㅢㅁㅜㄹㅂㅓㅁ	timunimuɭbʌm
ㅎㅗㅌㅔㄹ	ɸʷotʰeɭ
ㄱㅗㅂㅎㅏㄷㅏ	kopʰada
ㄱㅔㅇㅡㄹㅡㄷㅏ	keɯɾɯda
ㅋㅡㄱㅣ	kxɯɡi
ㅁㅓㅁㅊㅣㅅ	mʌmt͡ɕʰit̚
ㅎㅏㄹㅁㅓㄴㅣㅁ	haɭmʌnim
ㅇㅕㄴㅈㅓㄱ	jɘɲd͡ʑʌk̚
ㄱㅟㅇㅔㅅㅁㅏㄹ	kɥienmaɭ
ㄷㅏㄹㅁㅜㄹㅣ	taɭmuɾi
ㅂㅜㄹㅡㄷㅏ	puɾɯda
ㅊㅓㅇㅅㅗㅎㅏㄷㅏ	t͡ɕʰʌŋsʰoɦada
ㅇㅣㅁㅣㄷㅏㅈㅗㄹ	imidad͡ʑoɭ
ㄴㅜㄴㅂㅗㄹㅏ	nunboɾa
ㄱㅣㄹㅣㄴㅇㅕㅇㅇㅑㅇ	kiɾiɲjʌŋjaŋ
ㄱㅡㄹㅏㅁ	kɯɾam
ㄱㅡㄹㅣㄱㅗ	kɯɾiɡo
ㅅㅔㄴㅔㄱㅏㄹ	seneɡaɭ
ㅈㅓㄴㅅㅣ	t͡ɕɘnɕʰi
ㅅㅗㅂㅏㄱㅎㅏㄷㅏ	sʰobakʰada
ㄴㅔㅇㅏㄴㄷㅔㄹㅡㅌㅏㄹㅇㅣㄴ	neandeɾɯtʰaɾin
ㅇㅛㅇㅅㅏㅇㅇㅓ	joŋsʰaŋʌ
ㅇㅏㅂㅣㄷㅏㄹㅁㅏ	abidaɭma
ㄷㅗㄴㅓㅅ	tonʌt̚
ㅍㅕㅎ	pʰjʌt̚
ㅇㅗㄱㅅㅣㅁ	okɕim
ㅇㅣㅍ	ip̚
ㄷㅓㄴㄷㅔ	tʌnde
ㄱㅡㅂ	kɯp̚
ㄴㅓㅁㅓ	nʌmʌ
ㅁㅗㄱㅇㅛㄱㅎㅏㄷㅏ	moɡjokʰada
ㅃㅕㄻ	pjʌm
ㄱㅕㅌ	kjʌt̚
ㅅㅓㅌㅜㄹㄷㅏ	sʰɘtʰuɭda
ㅝ	wʌ
ㅇㅣㄴㅈㅗㅇㅊㅏㅂㅕㄹ	iɲd͡ʑoŋt͡ɕʰabjʌɭ
ㅇㅠㄹㅡㅌㅡ	juɾɯtʰɯ
ㄷㅏㄴㅕㅇㅗㄷㅏ	taɲjʌoda
ㅍㅛ	pʰjo
ㄷㅐㅅㅜ	tɛsʰu
ㅂㅕㄴㅅㅗ	pjʌnsʰo
ㅇㅣㄹㅂㅜㄹㅓ	iɭbuɾʌ
ㄷㅚㄷㅗㄹㄹㅣㄷㅏ	twedoʎʎida
ㅇㅣㄹㅅㅏㅊㅓㄴㄹㅣ	iɭsat͡ɕʰʌʎʎi
ㄱㅡㄱㅈㅏㅇ	kɯk̚t͡ɕaŋ
ㅁㅜㄷㅏㅇ	mudaŋ
ㄱㅡㄱㅓㅅ	kɯɡʌt̚
ㅃㅏㄹㅉㅣㅅㅏㄴ	paʎt͡ɕisʰan
ㅍㅜㄹㅡㄷㅣㅍㅜㄹㅡㄷㅏ	pʰuɾɯdipʰuɾɯda
ㅅㅜㅅㅈㅏ	sʰut̚t͡ɕa
ㅁㅗㄴㅏㅋㅗ	monakʰo
ㅇㅘㄴㅈㅓㄴㅎㅣ	waɲd͡ʑʌnʝi
ㅎㅏㄴㅇㅣㄴ	hanin
ㅇㅡㄴㅎㅏㄷㅏㄴ	ɯnɦadan
ㄱㅗㅇㅣㄷㅏ	koida
ㅇㅞㄴ	wen
ㅇㅕㄹㄷㅜㄹ	jʌɭtuɭ
ㅋㅗㄴㅅㅡㅌㅏㄴㅌㅣㄴㅜㅅㅡ	kʰonsʰɯtʰantʰinusʰɯ
ㅎㅘㄴㅅㅡㅇ	ɸwansʰɯŋ
ㅁㅗㄹㄹㅏ	moɭɭa
ㅅㅜㄷㅗㄱㅝㄴ	sʰudokwʌn
ㅎㅏㄴㅂㅓㄴ	hanbʌn
ㅅㅑㅁㅍㅔㅇㅣㄴ	ɕʰampʰein
ㅂㅔㅌㅡㄴㅏㅁ	petʰɯnam
ㅇㅓㄹㅕㅂㄷㅏ	ʌɾjʌp̚ta
ㅂㅕㄴㅂㅣ	pjʌnbi
ㅅㅓㅇㅈㅗ	sʰʌŋd͡ʑo
ㅍㅜㅇ	pʰuŋ
ㅇㅝㄴㅈㅏㅍㅗㄱㅌㅏㄴ	wʌɲd͡ʑapʰok̚tʰan
ㄷㅓㅎㅏㄷㅏ	tʌɦada
ㄱㅓㅁㅇㅕㄱ	kʌmjʌk̚
ㅂㅗㅇㅣㄷㅏ	poida
ㅂㅏㄱㅈㅔ	pak̚t͡ɕe
ㄴㅕㄴ	ɲjʌn
ㅈㅏㄷㅗㅇ	t͡ɕadoŋ
ㅂㅏㄴㄷㅗㅊㅔ	pandot͡ɕʰe
ㄱㅑㅇㅜㅅㄱㅓㄹㅣㄷㅏ	kjaut̚kʌɾida
ㄷㅐㅅㅏ	tɛsʰa
ㅅㅗㅅㅡ	sʰosʰɯ
ㄴㅣㅈㅔㄹㅡ	nid͡ʑeɾɯ
ㅇㅏㄹㄹㅏㄷㅣㄴ	aɭɭadin
ㄱㅣㅁㅁㅔㄹ	kimmeɭ
ㅂㅏㄴㅉㅏㄱㅇㅣㄷㅏ	paɲt͡ɕaɡida
ㅅㅜㄴㅡㅇ	sʰunɯŋ
ㄱㅜㅇㅑㄱㅅㅓㅇㄱㅕㅇ	kujaksʌŋɡjʌŋ
ㅇㅏㄱㅇㅕㅇㅎㅑㅇ	aɡjʌŋʝjaŋ
ㄹㅗㅂㅗㅌㅡ	ɾobotʰɯ
ㅅㅗㄹㄹㅗㅁㅗㄴ	sʰoɭɭomon
ㄷㅐㄷㅏ	tɛda
ㅎㅏㄴㅇㅕㅇ	haɲjʌŋ
ㄱㅣㅇㅕㄱ	kijʌk̚
ㅇㅔㄴㅓㅈㅣ	enʌd͡ʑi
ㅊㅜㅇㄱㅗ	t͡ɕʰuŋɡo
ㅆㅣㅂㅎㅏㄷㅏ	ɕipʰada
ㅃㅗㅃㅗ	popo
ㄱㅏㄹㅡㄷㅏ	kaɾɯda
ㄱㅏㄹㅏㄷㅔ	kaɾade
ㄴㅜㄴㄲㅗㅊ	nunkot̚
ㅅㅡㅌㅔㅇㅣㅍㅡㄹㄹㅓ	sʰɯtʰeipʰɯɭɭʌ
ㅇㅢㄹㅛ	ɰiɾjo
ㄲㅓㅍㅜㄹ	kʌpʰuɭ
ㅎㅘㄱㅇㅣㄴㅎㅏㄷㅏ	ɸwaɡinɦada
ㄱㅏㄱㄱㅜㄱ	kak̚kuk̚
ㅇㅑㅇㅂㅗㅇㄱㅏ	jaŋboŋɡa
ㅅㅓㅁㅅㅓ	sʰʌmsʰʌ
ㅆㅏㅇ	saŋ
ㅈㅗㅍㅣㅂㅗㄹㄹㅏㄱ	t͡ɕopʰiboɭɭak̚
ㅂㅏㄹㄷㅏㄹㅎㅏㄷㅏ	paɭtaɾɦada
ㅆㅏㅇㅈㅓㅁ	saŋd͡ʑʌm
ㅇㅏㅇㅋㅔㅌㅡ	aŋkʰetʰɯ
ㄹㅕㄱ	ɾjʌk̚
ㅎㅏㅇㄱㅗㅇㅁㅗㅎㅏㅁ	haŋɡoŋmoɦam
ㅅㅜㅇㅕㅁㅅㅜㄹㅣ	sʰujʌmsʰuɾi
ㄷㅗㅇㅇㅢ	toŋɰi
ㅍㅔㄴㅏㄴㅌㅡㄹㅔㄴ	pʰenantʰɯɾen
ㅇㅣㄹㄷㅗㅇ	iɭtoŋ
ㄷㅜㅇㅈㅣ	tuŋd͡ʑi
ㄷㅏㄹㄹㅏㅈㅣㄷㅏ	taɭɭad͡ʑida
ㄱㅕㅇㅎㅓㅁㅊㅣ	kjʌŋɦʌmt͡ɕʰi
ㄷㅏㄲㄷㅏ	tak̚ta
ㄴㅏㄷㅏ	nada
ㅈㅜㅇㄱㅖ	t͡ɕuŋɡje
ㅅㅏㅇㅓㅂ	sʰaʌp̚
ㅌㅏㄴㅏㅋㅡ	tʰanakxɯ
ㅇㅣㅁ	im
ㅂㅔㄴㄸㅗ	pento
ㄱㅡㄹㅆㅣ	kɯɭɕi
ㅇㅣㅅㅣㅁㅈㅓㄴㅅㅣㅁ	iɕʰimd͡ʑʌnɕʰim
ㄷㅡㅇㅈㅏㅇ	tɯŋd͡ʑaŋ
ㅅㅏㅁㅜㅅㅣㄹ	sʰamuɕʰiɭ
ㄱㅗㅇㄱㅛ	koŋɡjo
ㅈㅓㅇㅈㅔ	t͡ɕʌŋd͡ʑe
ㄲㅜㅈㅣㅈㄷㅏ	kud͡ʑit̚ta
ㅁㅏㅍㅏㄹㅏㅁ	mapʰaɾam
ㅅㅣㄷ	ɕʰit̚
ㅂㅡㄹㅣㅌㅡㄴ	pɯɾitʰɯn
ㅈㅣㄱㅈㅓㅂㅈㅓㄱ	t͡ɕik̚t͡ɕʌp̚t͡ɕʌk̚
ㄹㅕㄱㅝㄴ	ɾjʌɡwʌn
ㅂㅜㄱㄷㅗㅇ	puk̚toŋ
ㅎㅐㅁㅕㄴ	hɛmjʌn
ㄴㅏㅊ	nat̚
ㅂㅏㄴㅈㅜ	paɲd͡ʑu
ㅈㅏㅁㅇㅕㄹ	t͡ɕamjʌɭ
ㅇㅣㄴㅅㅏㅁ	insʰam
ㅌㅗㅇㅈㅗㄹㅣㅁ	tʰoŋd͡ʑoɾim
ㅈㅓㅁ	t͡ɕʌm
ㅍㅗㅋㅡ	pʰokxɯ
ㄱㅗㅇㄱㅣㅂㅏㅇㅅㅓㄱㅈㅏㄷㅗㅇㅊㅏ	koŋɡibaŋsʰʌk̚t͡ɕadoŋt͡ɕʰa
ㄷㅗㄹㄱㅏㅈㅏㅁㅣ	toɭɡad͡ʑami
ㅍㅗㄱㄷㅗㅇ	pʰok̚toŋ
ㅅㅣㄱㅁㅜㄹ	ɕʰiŋmuɭ
ㅌㅓㄹㅅㅣㄹ	tʰʌɭɕʰiɭ
ㄱㅘㅈㅏ	kwad͡ʑa
ㅆㅏㄹㅁㅣㄲㅜㄹㅣ	saɭmikuɾi
ㅂㅜㅎㅘㄹㅈㅓㄹ	puβwaʎt͡ɕʌɭ
ㄸㅣㅇㅎㅗㅇㅏ	tiŋβoa
ㅇㅏㅍㅡㄷㅏ	apʰɯda
ㅊㅏㅇㅇㅓㅂ	t͡ɕʰaŋʌp̚
ㅇㅠㄱㅣㅊㅔ	juɡit͡ɕʰe
ㅂㅏㄹㄹㅏㄹㄹㅏㅇㅣㅋㅏ	paɭɭaɭɭaikʰa
ㄱㅖㅅㅏㄴㅅㅓ	kjesʰansʰʌ
ㄱㅟㅁㅣㅌㅌㅓㄹ	kɥimit̚tʰʌɭ
ㅁㅏㅊㅟ	mat͡ɕʰɥi
ㄴㅏㅍㅏㄹㄲㅗㅊ	napʰaɭkot̚
ㅊㅜㄹㄴㅏㅂㄱㅖ	t͡ɕʰuɭɭap̚kje
ㅇㅝㄴㅈㅜㅍㅣㄹ	wʌɲd͡ʑupʰiɭ
ㅍㅣㄹㄷㅡ	pʰiɭdɯ
ㄱㅝㄴㅎㅏㄷㅏ	kwɘnɦada
ㄷㅗㄱㅈㅏ	tok̚t͡ɕa
ㅍㅗㄹㄹㅣㅁㅓ	pʰoʎʎimʌ
ㅂㅞㄺ	pwek̚
ㅍㅣㄹㅏㄴ	pʰiɾan
ㅌㅚㄱㅡㄴㅎㅏㄷㅏ	tʰweɡɯnɦada
ㅌㅗㅇㅍㅜㅇ	tʰoŋpʰuŋ
ㅂㅏㅇㅊㅣㅎㅏㄷㅏ	paŋt͡ɕʰiɦada
ㅊㅓㄴㅈㅏ	t͡ɕʰʌɲd͡ʑa
ㅇㅗㄹㄹㅣㅁㅁㅏㄹ	oʎʎimmaɭ
ㅎㅏㄷㅗ	hado
ㅁㅏㅁㅜㄹㅣ	mamuɾi
ㄱㅏㄹㅜ	kaɾu
ㅋㅏㄹㄹㅗㄹㅣ	kʰaɭɭoɾi
ㄷㅟㅇㄱㅜㄹㄷㅟㅇㄱㅜㄹ	tɥiŋɡuɭdɥiŋɡuɭ
ㅇㅣㄹㅋㅓㄷㄷㅏ	iɭkʰʌt̚ta
ㅇㅗㄹㄹㅏㅇㅗㄷㅏ	oɭɭaoda
ㅅㅡㅌㅏㄷㅣㅇㅜㅁ	sʰɯtʰadium
ㅎㅏㅁㄲㅔ	hamke
ㅎㅚㄷㅏㅁ	ɸwedam
ㄱㅝㄴㄷㅏㅇ	kwʌndaŋ
ㅂㅏㄴㄴㅕㄴ	panɲjʌn
ㅇㅓㅉㅣㅎㅏㄷㅏ	ʌt͡ɕiɦada
ㅁㅜㅇㅛㅇㅎㅏㄷㅏ	mujoŋɦada
ㅍㅔㄴㅏㅈㅣㄴ	pʰenad͡ʑin
ㅎㅏㄴㅆㅏㅇ	hansaŋ
ㅎㅐㄷㅗㅇ	hɛdoŋ
ㄱㅗㄾ	koɭ
ㅊㅏㄹㅣㅁ	t͡ɕʰaɾim
ㅇㅏㅂㄷㅗ	ap̚to
ㄷㅏㅇㅣㅇㅏㅁㅗㄴㄷㅡ	taiamondɯ
ㄱㅡㅂㅇㅕ	kɯbjʌ
ㅂㅣㅅ	pit̚
ㄴㅔㅁㅗㄲㅗㄹ	nemokoɭ
ㅌㅏㄴㅇㅑㄱㄱㅗ	tʰaɲjak̚ko
ㄷㅐㅈㅜㅇㅁㅜㄴㅎㅘ	tɛd͡ʑuŋmunβwa
ㅇㅚㅅㅗㄴㅈㅏ	wesʰoɲd͡ʑa
ㅎㅗㅅㅜ	ɸʷosʰu
ㅎㅚㄱㄷㅡㄱㅎㅏㄷㅏ	ɸwek̚tɯkʰada
ㅇㅢㅎㅚ	ɰiβwe
ㄴㅏㅁㅈㅏㄱ	namd͡ʑak̚
ㅅㅣㅂㅔㄹㅣㅇㅏ	ɕʰibeɾia
ㄱㅏㄷㅜㄴㅕㅅㅓㅇ	kaduɲjʌsʰʌŋ
ㅇㅏㅍㅈㅏㅇㅅㅓㄷㅏ	ap̚t͡ɕaŋsʰʌda
ㅈㅣㅂㅜㅌㅣ	t͡ɕibutʰi
ㅋㅏㄹㅡㅁㅏ	kʰaɾɯma
ㄱㅜㄴㅣ	kuni
ㅁㅔㅅㅣㅈㅣ	meɕʰid͡ʑi
ㅁㅏㄹㅡㄷㅏ	maɾɯda
ㅅㅡㅋㅏㄴㄷㅠㅁ	sʰɯkʰandjum
ㄱㅓㄴㅅㅓㄹㅎㅏㄷㅏ	kɘnsʰʌɾɦada
ㅎㅘㅈㅏㅇㅈㅏㅇ	ɸwad͡ʑaŋd͡ʑaŋ
ㅂㅜㄹㄱㅜㅅㅗㄱ	puɭɡusʰok̚
ㅍㅓㄹㄹㅓㄱㅍㅓㄹㄹㅓㄱ	pʰʌɭɭʌk̚pʰʌɭɭʌk̚
ㄱㅝㄴ	kwʌn
ㄱㅏㅁㅁㅣㄹㅛ	kammiɾjo
ㄷㅏㄹㅋㅗㅁㅎㅏㄷㅏ	taɭkʰomɦada
ㅅㅏㅁㅕㄴ	sʰamjʌn
ㅎㅗㄹㄹㅗ	ɸʷoɭɭo
ㅂㅓㄹㅇㅣㄷㅏ	pɘɾida
ㅍㅕㄴ	pʰjʌn
ㅂㅗㅇㅣㄹㄹㅓ	poiɭɭʌ
ㅅㅏㄱㅣㄲㅜㄴ	sʰaɡikun
ㅎㅜㄱㅕㄴㅇㅣㄴ	ɸʷuɡjʌnin
ㅅㅏㅌ	sʰat̚
ㅇㅣㅋㅔㅂㅏㄴㅏ	ikʰebana
ㅇㅕㄹㅂㅏㄴ	jʌɭban
ㄱㅘㄴㅍㅜㅇㄱㅡㅁ	kwanpʰuŋɡɯm
ㅋㅡㄹㅗㅇㅏㅌㅣㅇㅏ	kxɯɾoatʰia
ㄱㅜㅇㅏㄴㅣㄷㅣㄴ	kuanidin
ㅋㅗㅌㅡㄷㅣㅂㅜㅇㅏㄹㅡ	kʰotʰɯdibuaɾɯ
ㅇㅕㄹㅇㅕㄷㅓㄼ	jʌʎʎjʌdʌɭ
ㄱㅕㅇㅈㅔ	kjʌŋd͡ʑe
ㅂㅏ	pa
ㄱㅏㅁㄱㅏㄱㅈㅓㄱ	kamɡak̚t͡ɕʌk̚
ㅈㅏㅇㄱㅘㄴ	t͡ɕaŋɡwan
ㅈㅓㄴㅎㅏㄴ	t͡ɕʌnɦan
ㅈㅓㅇㅈㅓㄱㅂㅜㄴ	t͡ɕʌŋd͡ʑʌk̚pun
ㅅㅡㄹㄱㅣ	sʰɯɭɡi
ㅎㅏㄹㄹㅖㅃㅡ	haʎʎjepɯ
ㅇㅜㅈㅓㅇ	ud͡ʑʌŋ
ㅌㅗㅇㄹㅗ	tʰoŋno
ㅁㅓㄹㅣㅁㅏㄹ	mʌɾimaɭ
ㅇㅗㅁㅜㄴ	omun
ㅇㅣㄴㅈㅔ	iɲd͡ʑe
ㅆㅏㄹㄱㅜㄱㅅㅜ	saɭɡuksu
ㄷㅏㅎㄷㅏ	tatʰa
ㅇㅓㄹㄹㅜㄱㅁㅏㄹ	ʌɭɭuŋmaɭ
ㅁㅐㄷㅏㄹㄹㅣㄷㅏ	mɛdaʎʎida
ㅁㅛㅈㅣ	mjod͡ʑi
ㄱㅜㄺㄷㅏ	kuk̚ta
ㅇㅣㄴㄱㅝㄴ	inkwʌn
ㅂㅗㅈㅏㅇ	pod͡ʑaŋ
ㅆㅏㅇㄷㅜㅇㅇㅣ	saŋduŋi
ㄱㅏㄱㅈㅗㅇ	kak̚t͡ɕoŋ
ㅅㅜㅇㅡㄴ	sʰuɯn
ㅊㅗㄴㅡㅇㄹㅕㄱ	t͡ɕʰonɯŋɲjʌk̚
ㅅㅜㄹㅈㅣㅂ	sʰuʎt͡ɕip̚
ㅍㅏㅊㅜㅇ	pʰat͡ɕʰuŋ
ㄷㅏㅇ	taŋ
ㅂㅣㅎㅏㄷㅏ	piɦada
ㅍㅏㄹㅁㅣㅌㅡㅅㅏㄴ	pʰaɭmitʰɯsʰan
ㅇㅢㅅㅣㄱ	ɰiɕʰik̚
ㄱㅣㅇㅕㅎㅏㄷㅏ	kijʌɦada
ㄷㅐㄷㅏㄴㅎㅏㄷㅏ	tɛdanɦada
ㄷㅏㄴㅇㅕㅂㄱㅣ	taɲjʌp̚ki
ㅂㅣㄴㅂㅏㅇ	pinbaŋ
ㅎㅡㅂㅎㅕㄹㄱㅟ	xɯpʰjʌɭɡɥi
ㅈㅓㅁㅊㅏ	t͡ɕɘmt͡ɕʰa
ㅅㅣㅇㅣㄴ	ɕʰiin
ㅍㅜㅁㄱㅏㅍㅇㅡㅁㅎㅏㄷㅏ	pʰumɡapʰɯmɦada
ㅇㅟㄱㅜㄹㅁㅏㄹ	ɥiɡuɭmaɭ
ㅂㅜㄱㅡㄴ	puɡɯn
ㅂㅓㅂㅇㅝㄴ	pʌbwʌn
ㅈㅗㄱ	t͡ɕok̚
ㄸㅜㄹㅕㅅㅎㅏㄷㅏ	tuɾjʌtʰada
ㅇㅏㄴㅈㅓㄴ	aɲd͡ʑʌn
ㅍㅗㅎㅏㅁㄷㅚㄷㅏ	pʰoɦamdweda
ㄱㅣㅎㅚ	kiβwe
ㅃㅣㅇㄱㅝㄹ	piŋɡwʌɭ
ㄱㅗㅅㅡㅌㅡ	kosʰɯtʰɯ
ㅅㅡㅇㄱㅏㅇㄱㅣ	sʰɯŋɡaŋɡi
ㄷㅓㄹㅓㅂㄷㅏ	tɘɾʌp̚ta
ㅇㅖㅅㅏㅇ	jesʰaŋ
ㅇㅕㄴㅇㅝㄹㅇㅣㄹ	jʌnwʌɾiɭ
ㅅㅗㄱㅅㅏㄱㅇㅣㅁ	sʰoksaɡim
ㅈㅓㄴㅎㅕ	t͡ɕʌnʝjʌ
ㄴㅏㄱㅊㅓㄴㅈㅜㅇㅢ	nak̚t͡ɕʰʌɲd͡ʑuɰi
ㄱㅓㄹㅇㅡㅁㅁㅏ	kʌɾɯmma
ㄱㅜㄹㅂㅣ	kuɭbi
ㅌㅡㄹㅓㄱ	tʰɯɾʌk̚
ㅁㅜㅅㅡㅋㅏㅌㅡ	musʰɯkʰatʰɯ
ㅍㅏㄷㅜㅊㅡ	pʰadut͡ɕʰɯ
ㄱㅡㄲㅡㅈㅔ	kɯkɯd͡ʑe
ㅇㅑㅇㅍㅣㅈㅣ	jaŋpʰid͡ʑi
ㅂㅏㅇㅣㄴㅓㄹㅣ	painʌɾi
ㅇㅔㅇㅣㅈㅡ	eid͡ʑɯ
ㅎㅐㅍㅏㄹㅣ	hɛpʰaɾi
ㅈㅏㅇㄴㅏㄴ	t͡ɕaŋnan
ㅅㅏㅊㅜㄴㄱㅣ	sʰat͡ɕʰunɡi
ㅈㅜㅁㅜㄹㅡㄷㅏ	t͡ɕumuɾɯda
ㄴㅡㅈㄱㅏㅇㅡㄹ	nɯt̚kaɯɭ
ㄱㅣㅎㅚㄱ	kiβwek̚
ㅈㅏㅂㄷㅏㅁ	t͡ɕap̚tam
ㄷㅏㅌㅜㄷㅏ	tatʰuda
ㅁㅗㄹ	moɭ
ㅈㅜㅂㅜ	t͡ɕubu
ㄱㅗㄹㅂㅏㄴ	koɭban
ㅍㅕㅇㅎㅕㅇ	pʰjʌŋʝjʌŋ
ㅁㅔㄴㅠ	meɲju
ㅍㅏㅍㅏㄹㅏㅊㅣ	pʰapʰaɾat͡ɕʰi
ㄱㅏㄺㄷㅏ	kak̚ta
ㅂㅏㅇㅅㅣㅁ	paŋɕʰim
ㄱㅏㄴㅡㅇㅅㅓㅇ	kanɯŋsʌŋ
ㅆㅏㅇㄱㅣㅇㅕㄱ	saŋɡijʌk̚
ㅌㅏㅅㅠㅋㅔㄴㅌㅡ	tʰaɕʰukʰentʰɯ
ㅈㅣㅂㅏㅇㅅㅏㄴ	t͡ɕibaŋsʰan
ㅊㅣㄹㅅㅓㅇㅈㅏㅇㅇㅓ	t͡ɕʰiɭsʌŋd͡ʑaŋʌ
ㅈㅗㅎㅕㄹ	t͡ɕoʝjʌɭ
ㅂㅏㄴㅅㅣㅇㅗㅅ	panɕʰiot̚
ㅇㅠㅇㅣㄱㅎㅏㄷㅏ	juikʰada
ㅅㅡㅇㅟㅅㅡ	sʰɯɥisʰɯ
ㄷㅏㅁㅂㅗㅁㅜㄹ	tambomuɭ
ㅂㅣㅌㅡㅋㅗㅇㅣㄴ	pitʰɯkʰoin
ㅂㅏㄴㅡㄹ	panɯɭ
ㅇㅑㅇㅊㅣ	jaŋt͡ɕʰi
ㄸㅡㄹㅏㄱㄸㅗㄹㅡ	tɯɾak̚toɾɯ
ㅅㅏㅇㅣㅈㅡ	sʰaid͡ʑɯ
ㅈㅣㅍㅜㄹㅏㄱㅣ	t͡ɕipʰuɾaɡi
ㅂㅗㄱㄱㅝㄴ	pok̚kwʌn
ㄱㅜㅇㅣ	kui
ㅇㅠㅅㅏㅎㅏㄷㅏ	jusʰaɦada
ㅇㅜㅅㅏ	usʰa
ㄲㅜㄱㅜㄹㅣ	kuɡuɾi
ㅊㅣㄴㅡㄴ	t͡ɕʰinɯn
ㅂㅜㄱㄷㅗㄷㄷㅏ	puk̚tot̚ta
ㅌㅗㄴ	tʰon
ㄷㅟㅈㅟ	tɥid͡ʑɥi
ㅊㅏㅁ	t͡ɕʰam
ㄴㅠㅌㅡㄹㅣㅇㅏ	ɲjutʰɯɾia
ㅍㅗㄱㅇㅜ	pʰoɡu
ㄴㅗㅇㅈㅏㅇ	noŋd͡ʑaŋ
ㅂㅏㄹㅈㅓㄴㅎㅏㄷㅏ	paʎt͡ɕʌnɦada
ㅈㅓㄴㄷㅗㅅㅓ	t͡ɕʌndosʰʌ
ㄷㅗㄹㅇㅏㄱㅏㄷㅏ	toɾaɡada
ㅅㅏㄱㅗㄹ	sʰaɡoɭ
ㄱㅣㄴㄱㅡㅂ	kinɡɯp̚
ㄱㅏㅂㅈㅏㄱㅅㅡㄹㅔ	kap̚t͡ɕaksɯɾe
ㅅㅣㅂㅏㄹ	ɕʰibaɭ
ㄱㅓㄷㅡㄹㅡㅁ	kɘdɯɾɯm
ㅃㅕㅌ	pjʌt̚
ㅍㅏㄹㅏㄱㅘㅇㅣ	pʰaɾaɡwai
ㅈㅚㅇㅏㄱ	t͡ɕweak̚
ㄱㅓㄴㅊㅜㄱ	kɘɲt͡ɕʰuk̚
ㅊㅗㅇㅡㅁㅍㅏ	t͡ɕʰoɯmpʰa
ㅅㅔㅂㅓㄹㅅㅣㄱ	sʰebʌɭɕʰik̚
ㅇㅠㅁㅗㅊㅏ	jumot͡ɕʰa
ㅍㅣㅌㅡ	pʰitʰɯ
ㅁㅏㄱㄱㅓㄹㄹㅣ	mak̚kʌʎʎi
ㅂㅜㅌㅣㅋㅡ	putʰikxɯ
ㅅㅣㄷㅏㄹㄹㅣㄷㅏ	ɕʰidaʎʎida
ㅂㅕㄴㅎㅘㅎㅏㄷㅏ	pjɘnβwaɦada
ㅈㅣㅍ	t͡ɕip̚
ㄱㅘㅇㅅㅏㄴ	kwaŋsʰan
ㄹㅕㅇ	ɾjʌŋ
ㅂㅏㅇㅁㅜㄴ	paŋmun
ㄱㅏㅁㅆㅏㄷㅏ	kamsada
ㅈㅏㄲㅜㅁㅏㄴ	t͡ɕakuman
ㅍㅜㄹㅂㅓㅈㅓㄴ	pʰuɭbʌd͡ʑʌn
ㅂㅘㅈㅜㄷㅏ	pwad͡ʑuda
ㅇㅓㅈ	ʌt̚
ㅆㅏ	sa
ㅍㅏㅂㅋㅗㄴ	pʰap̚kʰon
ㅎㅘㄱㅅㅣㄹㅎㅣ	ɸwakɕiɾʝi
ㅌㅏㄷㅏ	tʰada
ㅅㅓㅇㅜㄹ	sʰʌuɭ
ㄱㅏㅅㅗㅈㅔ	kasʰod͡ʑe
ㅈㅣㅇㅗㄱ	t͡ɕiok̚
ㄷㅗㄱㅅㅓㅅㅣㄹ	toksʌɕʰiɭ
ㅎㅚㅇㄹㅕㅇㅎㅏㄷㅏ	ɸweŋɲjʌŋɦada
ㄴㅏㄲㅅㅣ	nakɕi
ㅇㅏㅁㅏㄹㄱㅏㅁ	amaɭɡam
ㅎㅡㅇㄱㅕㅂㄷㅏ	xɯŋɡjʌp̚ta
ㅅㅓㄹㅁㅕㅇㅎㅏㄷㅏ	sʰʌɭmjʌŋɦada
ㅊㅔㄹㅡㄴㅗㅂㅣㄹ	t͡ɕʰeɾɯnobiɭ
ㅈㅓㄴㅊㅔ	t͡ɕʌɲt͡ɕʰe
ㅇㅑㄱㄱㅏㄴ	jak̚kan
ㅊㅣㅇㅊㅏㄴㅎㅏㄷㅏ	t͡ɕʰiŋt͡ɕʰanɦada
ㄷㅐㄷㅏㅂㅎㅏㄷㅏ	tɛdapʰada
ㅅㅡㅂㅈㅣ	sʰɯp̚t͡ɕi
ㅂㅏㄴㅇㅕㄱㅈㅏ	paɲjʌk̚t͡ɕa
ㅍㅏㅊㅜㅇㄹㅠ	pʰat͡ɕʰuŋɲju
ㄲㅏㄹ	kaɭ
ㄷㅐㄹㅣㅇㅣㄴ	tɛɾiin
ㅌㅣㅌㅏㄴ	tʰitʰan
ㅋㅏㅈㅏㅎㅡㅅㅡㅌㅏㄴ	kʰad͡ʑaɣɯsʰɯtʰan
ㄱㅕㅇㅜㄹ	kjʌuɭ
ㅅㅣㅅ	ɕʰit̚
ㅂㅣㅌㅏㅁㅣㄴ	pitʰamin
ㅇㅟㅇㅝㄴㅈㅏㅇ	ɥiwʌɲd͡ʑaŋ
ㄱㅕㅂㅊㅣㄷㅏ	kjʌp̚t͡ɕʰida
ㅅㅏㅇㅅㅜ	sʰaŋsʰu
ㄱㅕㄹㅎㅏㅂ	kjʌɾɦap̚
ㅂㅜㅇㅣㄴㅎㅏㄷㅏ	puinɦada
ㄱㅡㄹㅣㅁㅂㅜㄴㅍㅣㄹ	kɯɾimbunpʰiɭ
ㅈㅜㄱㅈㅣ	t͡ɕuk̚t͡ɕi
ㅅㅔㄴㅚ	sʰenwe
ㅋㅏㅇㅜㅂㅗㅇㅣ	kʰauboi
ㅎㅗㅈㅓㅇ	ɸʷod͡ʑʌŋ
ㅇㅚㄱㅛㄱㅘㄴ	weɡjoɡwan
ㅇㅜㄹㅜㄱㅘㅇㅣ	uɾuɡwai
ㄷㅏㄹㅣㅁㅣㅈㅣㄹ	taɾimid͡ʑiɭ
ㄱㅜㄹㅓㅇ	kuɾʌŋ
ㅁㅏㄹㅕㄱ	maɾjʌk̚
ㄱㅜㄹㅣㄷㅏ	kuɾida
ㅅㅣㄹㅁㅕㅇ	ɕʰiɭmjʌŋ
ㅎㅘㄴㄱㅕㅇ	ɸwanɡjʌŋ
ㅇㅕㄴㅈㅜㅎㅏㄷㅏ	jɘɲd͡ʑuɦada
ㅍㅏㅇㅣㅍㅡㅇㅗㄹㅡㄱㅏㄴ	pʰaipʰɯoɾɯɡan
ㅎㅏㄱㄱㅡㅂ	hak̚kɯp̚
ㅊㅓㅅㄴㅏㄹ	t͡ɕʰʌnnaɭ
ㅂㅗㅅㅓㄱ	posʰʌk̚
ㅅㅜㄱㅈㅔ	sʰuk̚t͡ɕe
ㅈㅣㅈㄷㅏ	t͡ɕit̚ta
ㅁㅏㅊㅏ	mat͡ɕʰa
ㄷㅐㄷㅏㅂ	tɛdap̚
ㅋㅡㄹㅣㅅㅡㅁㅏㅅㅡㅇㅣㅂㅡ	kxɯɾisʰɯmasʰɯibɯ
ㅇㅏㄴㅌㅏㄴㅏㄴㅏㄹㅣㅂㅗ	antʰananaɾibo
ㄱㅣㄱㅡㄴ	kiɡɯn
ㄹㅚㄴㅌㅡㄱㅔㄴㅠㅁ	ɾwentʰɯɡeɲjum
ㅅㅔㅊㅏ	sʰet͡ɕʰa
ㄱㅗㅁㅏㅂㅅㅡㅂㄴㅣㄷㅏ	komapsɯmnida
ㅊㅣㅁㅁㅗㄹ	t͡ɕʰimmoɭ
ㄷㅗㄱㅅㅏㄹ	toksaɭ
ㅇㅔㅅㅓ	esʰʌ
ㅌㅏㄱㅏㄹㄹㅗㄱㅡㅇㅓ	tʰaɡaɭɭoɡɯʌ
ㅈㅜㄴㅣㅁ	t͡ɕunim
ㅇㅝㄴㅎㅏㄷㅏ	wɘnɦada
ㅇㅏㅁㅜ	amu
ㅁㅣㄹㄹㅣㅁ	miʎʎim
ㅂㅣㄷㅜㄹㄱㅣ	piduɭɡi
ㅅㅑㅍㅡㅍㅔㄴㅅㅣㄹ	ɕʰapʰɯpʰenɕʰiɭ
ㅌㅜㅅㅜㄱㅎㅏㄷㅏ	tʰusʰukʰada
ㅋㅓㄹㅌㅡ	kʰʌɭtʰɯ
ㅊㅏㄹㄴㅏ	t͡ɕʰaɭɭa
ㅂㅗㄱㅅㅡㅂ	poksɯp̚
ㅍㅏㅇㅣㄴㄷㅓ	pʰaindʌ
ㅇㅖㅇㅑㄱ	jejak̚
ㅂㅜㄹㅍㅕㅇ	puɭpʰjʌŋ
ㅁㅏㅁㅜㄹㅡㄷㅏ	mamuɾɯda
ㄱㅜㄴㅅㅏ	kunsʰa
ㅅㅗㄴㄱㅏㄹㅏㄱㅈㅣㄹ	sʰonɡaɾak̚t͡ɕiɭ
ㅎㅗㄴㅇㅣㄴ	ɸʷonin
ㅇㅣㄹㅎㅏㄷㅏ	iɾɦada
ㄷㅏㄹㅣㅁㅣㅈㅣㄹㅎㅏㄷㅏ	taɾimid͡ʑiɾɦada
ㅂㅏㄴㅈㅣㅎㅏ	paɲd͡ʑiɦa
ㄱㅖㅇㅑㄱ	kjejak̚
ㄹㅣㅇㅜㄷㅔㅈㅏㄴㅔㅇㅣㄹㅜ	ɾiuded͡ʑaneiɾu
ㄱㅏㅎㅏㄷㅏ	kaɦada
ㅎㅏㅂㅊㅏㅇㄷㅏㄴ	hap̚t͡ɕʰaŋdan
ㅊㅓㄴㅇㅘㅇㅅㅓㅇ	t͡ɕʰʌnwaŋsʰʌŋ
ㅂㅔㅇㅣㄹ	peiɭ
ㅈㅜㄴㅂㅣ	t͡ɕunbi
ㄱㅜㄱㅎㅏㄴㅁㅜㄴ	kukʰanmun
ㄷㅏㄹㅍㅣㄹ	taɭpʰiɭ
ㄷㅏㅇㅣㅇㅗㄷㅡ	taiodɯ
ㅇㅕㄹㅅㅚ	jɘɭswe
ㅌㅏㅇㅣㅌㅡㄹ	tʰaitʰɯɭ
ㅇㅓㅁㅣ	ɘmi
ㄱㅏㄱㅘㄴ	kaɡwan
ㅇㅕㅉㅜㄷㅏ	jɘt͡ɕuda
ㅅㅜㄹㅑㅇ	sʰuɾjaŋ
ㅌㅗㅇㅎㅏㄷㅏ	tʰoŋɦada
ㄴㅏㅌㅁㅏㄹ	nanmaɭ
ㅇㅚㄱㅘ	wekwa
ㅁㅏㅇㅇㅝㄴㄱㅕㅇ	maŋwʌnɡjʌŋ
ㄱㅜㄱㅈㅔ	kuk̚t͡ɕe
ㅍㅏㄴㅏㅁㅏ	pʰanama
ㅇㅏㄱㄷㅏㅇ	ak̚taŋ
ㅎㅘㅇㅊㅓㄴ	ɸwaŋt͡ɕʰʌn
ㄱㅔㅇㅜㄷㅏ	keuda
ㅂㅏㄹㅈㅓㄴ	paʎt͡ɕʌn
ㅈㅏㅂㄷㅏ	t͡ɕap̚ta
ㅂㅡㄹㄹㅏㄷㅣㅁㅣㄹㅡ	pɯɭɭadimiɾɯ
ㅊㅜㅇㅊㅣㅇ	t͡ɕʰuŋt͡ɕʰiŋ
ㄱㅜㅎㅗ	kuβo
ㄴㅗㄹㅇㅣ	noɾi
ㄷㅐㅇㅡㅁㅅㅜㄴ	tɛɯmsʰun
ㅈㅓㅇㄷㅏㅇ	t͡ɕɘŋdaŋ
ㄷㅗㄹㅇㅏㅇㅗㄷㅏ	toɾaoda
ㅈㅐㅈㅏㄱㄴㅕㄴ	t͡ɕɛd͡ʑaŋɲjʌn
ㅁㅕㄴ	mjʌn
ㅇㅣㄷㅣㅅㅣㅇㅓ	idiɕʰiʌ
ㅈㅓㄴㅈㅏㄱㅏㅁㅏ	t͡ɕʌɲd͡ʑaɡama
ㅆㅗㄹㅕㄴ	soɾjʌn
ㅊㅓㄴㄱㅏㄹㄱㅜㅇ	t͡ɕʰʌnɡaɭɡuŋ
ㅅㅏㅇㅓㅂㄱㅏ	sʰaʌp̚ka
ㅅㅏㄴㅌㅣㅇㅏㄱㅗ	sʰantʰiaɡo
ㅍㅕㄴㅊㅏㄶㅇㅡㅅㅣㄷㅏ	pʰjʌɲt͡ɕʰanɯɕʰida
ㅇㅖㅅㅏㅇㄷㅚㄷㅏ	jesʰaŋdweda
ㅇㅑㅁㅜㅅㅜㅋㅡㄹㅗ	jamusʰukxɯɾo
ㄱㅡㄴㅈㅣㄹㅓㅂㄷㅏ	kɯɲd͡ʑiɾʌp̚ta
ㅇㅣㅂㅂㅓㅂㅈㅏ	ip̚pʌp̚t͡ɕa
ㅎㅜㅅㅏ	ɸʷusʰa
ㅁㅣㄲㅡㄹㅓㅂㄷㅏ	mikɯɾʌp̚ta
ㅅㅡㅌㅗㅂㅡ	sʰɯtʰobɯ
ㄴㅏㅂㅏㅇ	nabaŋ
ㄲㅗㅊㅇㅣㅍ	konnip̚
ㅊㅗㅎㅗㄴ	t͡ɕʰoβon
ㅁㅏㄹ	maɭ
ㅂㅜㄹㅊㅣㄴㅈㅓㄹ	puʎt͡ɕʰiɲd͡ʑʌɭ
ㅈㅜㅇㅓ	t͡ɕuʌ
ㅁㅣㄹㄷㅗ	miɭto
ㅇㅐㅇㅘㄴㄷㅗㅇㅁㅜㄹ	ɛwandoŋmuɭ
ㅁㅓㄱㅡㅁㄷㅏ	mʌɡɯmda
ㄷㅗㅌㅗㄹㅣ	totʰoɾi
ㄷㅏㅇㅎㅘㅇ	taŋβwaŋ
ㅈㅣㄱㄱㅘㄴ	t͡ɕik̚kwan
ㅆㅣㅂㄷㅏ	ɕip̚ta
ㄱㅏㅁㅏㄴㄷㅜㄷㅏ	kamanduda
ㄹㅠㅎㅕㅇ	ɾjuʝjʌŋ
ㅂㅓㄹㅇㅓㅈㅣㄷㅏ	pɘɾʌd͡ʑida
ㅅㅓㅇㄱㅕㅇ	sʰɘŋɡjʌŋ
ㅂㅗㄹㅡㅅㅣ	poɾɯɕʰi
ㅋㅗㅅㅡㅌㅏㄹㅣㅋㅏ	kʰosʰɯtʰaɾikʰa
ㅁㅏㅅㅇㅓㅄㄷㅏ	madʌp̚ta
ㄱㅣㄹㅇㅣ	kiɾi
ㄱㅏㄴㅈㅣㄹㅇㅣㄷㅏ	kaɲd͡ʑiɾida
ㄷㅏㅇㅅㅣㄴㄷㅡㄹ	taŋɕʰindɯɭ
ㅇㅑㅈㅏ	jad͡ʑa
ㅈㅣㄴㄷㅗㅇㅅㅜ	t͡ɕindoŋsʰu
ㅇㅣㄹㅇㅘㅇ	iɾwaŋ
ㅈㅣㅂㄷㅏ	t͡ɕip̚ta
ㅃㅣㄸㅏㄱㅎㅏㄷㅏ	pitakʰada
ㅅㅣㄴㄱㅗㅎㅏㄷㅏ	ɕʰinɡoɦada
ㅈㅓㅈㄷㅏㅇㅁㅗㅅㄱㅕㄴㄷㅣㅁㅈㅡㅇ	t͡ɕʌt̚taŋmot̚kjʌndimd͡ʑɯŋ
ㅈㅣㄱㅎㅜ	t͡ɕikʰu
ㅇㅕㄹㅓㅅ	jʌɾʌt̚
ㄸㅡㄴㅅㅗㅁㅜㄴ	tɯnsʰomun
ㅈㅔㅂㅣ	t͡ɕebi
ㄱㅣㄹㅡㅁㅂㅏㅂ	kiɾɯmbap̚
ㅅㅏㅁㄹㅠㄴㅊㅏ	sʰamɲjuɲt͡ɕʰa
ㅅㅗㅅㅣㅈㅣ	sʰoɕʰid͡ʑi
ㅋㅗㄹㅣㅇㅏ	kʰoɾia
ㄱㅣㅇㅜㄹ	kiuɭ
ㅎㅏㅅㅜㄷㅗ	hasʰudo
ㅇㅏㄴㄷㅗㄹㅏ	andoɾa
ㄱㅏㅅㅣㄴㅏㅂㅈㅣㄹㅣ	kaɕʰinap̚t͡ɕiɾi
ㄱㅕㄹㅎㅗㄴ	kjʌɾβon
ㅅㅠ	ɕʰu
ㄹㅣㄴ	ɾin
ㄷㅗㅇㄷㅡㅇㅎㅏㄷㅏ	toŋdɯŋɦada
ㅈㅏㄱㄷㅏ	t͡ɕak̚ta
ㅈㅏㄹㅏㄷㅏ	t͡ɕaɾada
ㅋㅟㄹㅠㅁ	kʰɥiɾjum
ㄷㅡㅇㅇㅠ	tɯŋju
ㅁㅏㅈㅇㅣ	mad͡ʑi
ㄴㅏㅃㅡㄷㅏ	napɯda
ㅅㅏㄹㅏㅇ	sʰaɾaŋ
ㅇㅏㅌㅣㅅㅡㅌㅡ	atʰisʰɯtʰɯ
ㅇㅗㄴㅢ	oni
ㅅㅔㅇㅛ	sʰejo
ㅁㅜㄴㅇㅓㄷㅏㄹㅣ	munʌdaɾi
ㄱㅟㄱㅜㄱㅎㅏㄷㅏ	kɥiɡukʰada
ㅋㅏㄹㅏㅋㅏㅅㅡ	kʰaɾakʰasʰɯ
ㅇㅛㅇㅅㅓㅎㅏㄷㅏ	joŋsʰʌɦada
ㅅㅏㄷㅏㄴ	sʰadan
ㅎㅗㄷㅜ	ɸʷodu
ㅅㅣㅀㅇㅓㅎㅏㄷㅏ	ɕʰiɾʌɦada
ㄷㅡㄹㄱㅣㄹㅡㅁ	tɯɭɡiɾɯm
ㅈㅣㄹㅏㅍㅡ	t͡ɕiɾapʰɯ
ㅁㅏㄹㅇㅓㅄㅇㅣ	maɾʌpɕi
ㄷㅗㅇㅁㅜㄹ	toŋmuɭ
ㅈㅗㄱㅣㅇ	t͡ɕoɡiŋ
ㅇㅏㄱㅅㅜㅎㅏㄷㅏ	aksuɦada
ㅋㅏㄹㄴㅏㅂㅈㅏㄹㅜ	kʰaɭɭap̚t͡ɕaɾu
ㅅㅜㅍㅏㄴ	sʰupʰan
ㄱㅗㅇㅇㅛㅇㅇㅓ	koŋjoŋʌ
ㅅㅓㄹㄴㅗㅇㅌㅏㅇ	sʰʌɭɭoŋtʰaŋ
ㄱㅟㄱㅜㅁㅓㅇ	kɥiɡumʌŋ
ㅅㅣㅎㅓㅁㅎㅏㄷㅏ	ɕʰiɦʌmɦada
ㄱㅗㅎㅕㄹㅇㅏㅂ	koʝjʌɾap̚
ㅇㅏㅁㅇㅠ	amju
ㅎㅗㅇㅋㅗㅇ	ɸʷoŋkʰoŋ
ㅅㅓㅇㄴㅏㅁ	sʰʌŋnam
ㅊㅣㅁㄴㅏㅇ	t͡ɕʰimnaŋ
ㄱㅜㅍㅏㄴ	kupʰan
ㅈㅗㅇㅇㅑㅇ	t͡ɕoŋjaŋ
ㄱㅏㄴㄷㅏㄴㅎㅏㄷㅏ	kandanɦada
ㅂㅓㅁㅂㅜ	pɘmbu
ㄴㅗㄴㅇㅢㅎㅏㄷㅏ	nonɰiɦada
ㄷㅗㅇㅅㅏ	toŋsʰa
ㅂㅔㄹㅡㄴ	peɾɯn
ㅋㅡㄹㄹㅣㄴㅣㅇ	kxɯʎʎiniŋ
ㅌㅏㄹㅊㅟㅈㅔ	tʰaʎt͡ɕʰɥid͡ʑe
ㄱㅗㅅㅜㄴㅈㅟ	kosʰuɲd͡ʑɥi
ㅅㅗㄲㅜㅂㅊㅣㄴㄱㅜ	sʰokup̚t͡ɕʰinɡu
ㅅㅜㄱㅇㅣㄷㅏ	sʰuɡida
ㅇㅝㄴㅅㅏㄴ	wʌnsʰan
ㅂㅏㅋㅜ	pakʰu
ㅍㅏㄹ	pʰaɭ
ㅅㅗㅈㅣㅍㅜㅁ	sʰod͡ʑipʰum
ㅅㅟㄹㅣ	ʃʰɥiɾi
ㅊㅜㅈㅓㄱㅎㅏㄷㅏ	t͡ɕʰud͡ʑʌkʰada
ㅅㅣㅁㅅㅏㅅㅜㄱㄱㅗ	ɕʰimsʰasʰuk̚ko
ㅂㅣㄱㅓㅂ	piɡʌp̚
ㅁㅏㅊㅏㄴㄱㅏㅈㅣ	mat͡ɕʰanɡad͡ʑi
ㄱㅗㅎㅑㅇ	koʝjaŋ
ㅎㅗㄸㅓㄱ	ɸʷotʌk̚
ㅎㅚㅂㅗㄱ	ɸwebok̚
ㄴㅏㅁㅈㅏㅊㅣㄴㄱㅜ	namd͡ʑat͡ɕʰinɡu
ㄷㅐㅍㅗ	tɛpʰo
ㅅㅗㄱㅊㅣㅇ	sʰok̚t͡ɕʰiŋ
ㅂㅏㅇㅅㅜㅎㅏㄷㅏ	paŋsʰuɦada
ㅂㅓㅂㄹㅠㄹㅎㅏㄱ	pʌmɲjuɾɦak̚
ㅇㅗㅁㅅㅡㅋㅡ	omsʰɯkxɯ
ㅈㅏㅇㄱㅘ	t͡ɕaŋɡwa
ㅇㅏㄴㅅㅣㅁ	anɕʰim
ㅅㅜㄹㅕㅁ	sʰuɾjʌm
ㅇㅠㄱㅏ	juɡa
ㅇㅡㅁㄹㅛㅅㅜ	ɯmɲjosʰu
ㅎㅗㅇㅎㅏㄱ	ɸʷoŋɦak̚
ㅈㅜㅇㄴㅕㄴ	t͡ɕuŋɲjʌn
ㅇㅜㄴㅈㅓㄴㅈㅏ	uɲd͡ʑʌɲd͡ʑa
ㄱㅛㄱㅏ	kjoɡa
ㅁㅔㅇㅣㅅㅡ	meisʰɯ
ㅁㅗㄱㅈㅏ	mok̚t͡ɕa
ㄴㅓ	nʌ
ㅅㅏㅈㅣㄴㄱㅣ	sʰad͡ʑinɡi
ㅈㅗㄱㅡㅁㅏㅎㄷㅏ	t͡ɕoɡɯmatʰa
ㅅㅜㄷㅏㄹ	sʰudaɭ
ㅇㅣㄹㅜㄱㅎㅏㄷㅏ	iɾukʰada
ㅌㅓㅈㅣㄷㅏ	tʰɘd͡ʑida
ㅍㅗㅎㅏㅁㅎㅏㄷㅏ	pʰoɦamɦada
ㅇㅜㅇㄷㅔ	uŋde
ㅌㅗㅇㅈㅔ	tʰoŋd͡ʑe
ㅎㅏㄴㅅㅜㅁㅈㅣㅅㄷㅏ	hansʰumd͡ʑit̚ta
ㅂㅕㄹㅂㅕㄹ	pjʌɭbjʌɭ
ㅈㅏㄱㅍㅜㅁㅈㅣㅂ	t͡ɕak̚pʰumd͡ʑip̚
ㅌㅗㅇ	tʰoŋ
ㅅㅔㄱㅘㄴ	sʰeɡwan
ㄱㅗㅂㄷㅏ	kop̚ta
ㄷㅔㅁㅗ	temo
ㅇㅚㅊㅣㄷㅏ	wet͡ɕʰida
ㄷㅏㅂㅎㅏㄷㅏ	tapʰada
ㅊㅓㄴㅂㅜㅈㅓㄱ	t͡ɕʰʌnbud͡ʑʌk̚
ㄴㅡㄴㄷㅔ	nɯnde
ㄹㅣㅇㅑㄷㅡ	ɾijadɯ
ㅍㅕㅇㅎㅘ	pʰjʌŋβwa
ㄹㅔㅇㅏㄱㅌㅗㄹㅡ	ɾeak̚tʰoɾɯ
ㅌㅓㅁㅣㄴㅓㄹ	tʰʌminʌɭ
ㄱㅣㅁㅏㄴ	kiman
ㄱㅑㄱㅊㅜㄹ	kjak̚t͡ɕʰuɭ
ㄷㅚㄴㅈㅏㅇ	tweɲd͡ʑaŋ
ㄱㅏㄴㅅㅣㄴ	kanɕʰin
ㅂㅜㄱㄱㅡㄱㄱㅗㅁ	puk̚kɯk̚kom
ㅇㅜㅅㅔ	usʰe
ㅎㅐㄷㅏㄹ	hɛdaɭ
ㄱㅗㄱㅣ	koɡi
ㄱㅏㄹㄷㅏ	kaɭda
ㅊㅔㅈㅔ	t͡ɕʰed͡ʑe
ㅅㅔㅌㅡ	sʰetʰɯ
ㅈㅓㅇㄱㅏ	t͡ɕɘŋka
ㄷㅏㄹㅡㄷㅏ	taɾɯda
ㅅㅏㅈㅏ	sʰad͡ʑa
ㅇㅛㄱㅜㄷㅚㄷㅏ	joɡudweda
ㅍㅐ	pʰɛ
ㅅㅏㄱㅓㄹㅣ	sʰaɡʌɾi
ㄱㅗㅇㅈㅓㅇ	koŋd͡ʑʌŋ
ㅈㅏㅍㅏㄴㄱㅣ	t͡ɕapʰanɡi
ㄷㅏㅂㅅㅏ	tapsa
ㅈㅣㅈㅓㄱㅟㄷㅏ	t͡ɕid͡ʑʌɡɥida
ㅂㅜㄱㅅㅜㅍㅈㅟ	puksup̚t͡ɕɥi
ㅊㅗㄴㄹㅏㄱ	t͡ɕʰoɭɭak̚
ㅇㅕㄹㅊㅏ	jʌʎt͡ɕʰa
ㅁㅜㄴㅎㅘㅈㅓㄱ	munβwad͡ʑʌk̚
ㅅㅓㅁㅣㄴ	sʰʌmin
ㅈㅔㄱㅓㅎㅏㄷㅏ	t͡ɕeɡʌɦada
ㄱㅏㅂㅗ	kabo
ㅅㅔㄹㄹㅓㄹㅣ	sʰeɭɭʌɾi
ㅅㅓㅇㅑㅇ	sʰʌjaŋ
ㅇㅔㅅㅡㅌㅗㄴㅣㅇㅏㅇㅓ	esʰɯtʰoniaʌ
ㅇㅕㄱㅎㅏㄱ	jʌkʰak̚
ㅈㅣㅂㄷㅏㄴ	t͡ɕip̚tan
ㅇㅣㄷㅗㅇ	idoŋ
ㄱㅣㄹㄴㅑㅇㅇㅣ	kiʎʎjaŋi
ㅈㅣㄴㅇㅝㄴㅈㅣ	t͡ɕinwʌɲd͡ʑi
ㅎㅐㅇㅏㄴ	hɛan
ㅌㅡㄹㅓㅁㅍㅔㅅ	tʰɯɾʌmpʰet̚
ㅈㅓㅇㅅㅣㄴㅂㅜㄴㅇㅕㄹㅈㅡㅇ	t͡ɕʌŋɕʰinpuɲjʌʎd͡ʑɯŋ
ㅂㅜㄱㅂㅏㅇㅈㅜㅇㄱㅗㄱㅣ	puk̚paŋd͡ʑuŋɡoɡi
ㅇㅠㄴㅏㄴㅎㅣ	junanʝi
ㄱㅗㅊㅔ	kot͡ɕʰe
ㅊㅚㄱㅗ	t͡ɕʰweɡo
ㄱㅗㅇㄱㅣ	koŋɡi
ㅇㅓㅎㅟㅅㅗ	ʌɦɥisʰo
ㅊㅏㅁㄱㅏㅎㅏㄷㅏ	t͡ɕʰamɡaɦada
ㅂㅗㄴ	pon
ㄱㅗㅂㅏㅇㅇㅗㄹㅣ	kobaŋoɾi
ㅁㅏㄹㅅㅗㅁㅆㅣ	maɭsomɕi
ㄱㅗㅇㄷㅗㅇ	koŋdoŋ
ㄱㅛㅍㅏ	kjopʰa
ㄱㅣㅇㅓㄱㄹㅕㄱ	kiʌŋɲjʌk̚
ㅅㅜㄷㄱㅏㄹㅏㄱ	sʰut̚kaɾak̚
ㅈㅗㄱㅂㅏㄹ	t͡ɕok̚paɭ
ㅈㅗㅅㅓㄴㅇㅓ	t͡ɕosʰʌnʌ
ㅎㅘㅇㄷㅗ	ɸwaŋdo
ㅌㅓㄸㅡㄹㅣㄷㅏ	tʰɘtɯɾida
ㅂㅓㅈㅣㄴㅣㅇㅏ	pʌd͡ʑinia
ㅊㅗㄴ	t͡ɕʰon
ㄱㅜㅊㅔ	kut͡ɕʰe
ㄱㅖㅈㅘ	kjed͡ʑwa
ㅈㅔㅈㅗㅇㅓㅂ	t͡ɕed͡ʑoʌp̚
ㄴㅏㅁㅜㄴㅡㄹㅂㅗ	namunɯɭbo
ㅈㅣㄱㅈㅓㅂ	t͡ɕik̚t͡ɕʌp̚
ㅈㅜㅇㄱㅜㄱㅇㅣㄴ	t͡ɕuŋɡuɡin
ㅇㅣㄴㄱㅗㅇㅈㅣㄴㅡㅇ	inɡoŋd͡ʑinɯŋ
ㄱㅜㄱㅂㅏㅂ	kuk̚pap̚
ㄴㅗㄹㅏㅎㄷㅏ	noɾatʰa
ㄱㅗㅁㄱㅜㄱ	komkuk̚
ㅁㅗㄹㅣㅌㅏㄴㅣ	moɾitʰani
ㅅㅣㄱㄹㅛㅍㅜㅁ	ɕʰiŋɲjopʰum
ㅇㅝㄹㅇㅛㅇㅣㄹ	wʌɾjoiɭ
ㅇㅣㅈㅇㅓㅂㅓㄹㅣㄷㅏ	id͡ʑʌbʌɾida
ㅇㅣㄴㄴㅣ	inni
ㅊㅓㄴㅈㅣㅇㅣㄴ	t͡ɕʰʌɲd͡ʑiin
ㄱㅏㅅㅏㄴ	kasʰan
ㅅㅓㅇㅊㅏㄴ	sʰʌŋt͡ɕʰan
ㅇㅜㄹㅏㄴㅠㅁ	uɾaɲjum
ㅊㅏㅇㅈㅗㅎㅏㄷㅏ	t͡ɕʰaŋd͡ʑoɦada
ㅎㅘㅈㅏㅇ	ɸwad͡ʑaŋ
ㅍㅕㅈ	pʰjʌt̚
ㄷㅏㄻㄷㅏ	tamta
ㅊㅓㅇㅡㅁ	t͡ɕʰʌɯm
ㄱㅏㅅㅣ	kaɕʰi
ㅅㅏㄹㅉㅣㄷㅏ	sʰaʎt͡ɕida
ㅅㅣㄴㅎㅕㅇㅋㅗㄹㅗㄴㅏㅂㅣㄹㅜㅅㅡㄱㅏㅁㅇㅕㅁㅈㅡㅇ	ɕʰinʝjʌŋkʰoɾonabiɾusʰɯɡamjʌmd͡ʑɯŋ
ㄱㅖㅇㅑㄱㅎㅏㄷㅏ	kjejakʰada
ㅅㅗㅇㅠㅈㅏ	sʰojud͡ʑa
ㄴㅗㄴㅡㄷㅏ	nonɯda
ㅁㅏㅅㅡㅋㅏㄹㅏ	masʰɯkʰaɾa
ㅈㅓㄴㄱㅣㅌㅗㅇㅅㅣㄴㅅㅏ	t͡ɕɘnɡitʰoŋɕʰinsʰa
ㅇㅏㄹㅡㅁㄷㅏㅂㄷㅏ	aɾɯmdap̚ta
ㅎㅐㅊㅣㄷㅏ	hɛt͡ɕʰida
ㄱㅣㅇㅠㄱ	kijuk̚
ㅇㅕㄴㅅㅡㅂㅎㅏㄷㅏ	jɘnsʰɯpʰada
ㅆㅣ	ɕi
ㄱㅓㅁㅇㅡㄴㄱㅡㅁ	kʌmɯnɡɯm
ㅈㅏㄱㅇㅓㅂ	t͡ɕaɡʌp̚
ㅇㅘㄱㅈㅏㄱㅡㄹㅡㄹㅡ	wak̚t͡ɕaɡɯɾɯɾɯ
ㅁㅗㅇㄱㅏㅇ	moŋɡaŋ
ㅉㅏㄼㄷㅏ	t͡ɕaɭta
ㅅㅓㅊㅔ	sʰʌt͡ɕʰe
ㅈㅣㅈㅓㄱ	t͡ɕid͡ʑʌk̚
ㄴㅡㄴ	nɯn
ㅈㅜㅇㅇㅛㅎㅏㄷㅏ	t͡ɕuŋjoɦada
ㅇㅣㄹㅊㅓㄴ	iʎt͡ɕʰʌn
ㅈㅗㅅㅓㄴㅇㅣㄴ	t͡ɕosʰʌnin
ㅂㅜㄱㅇㅏㅁㅔㄹㅣㅋㅏ	puɡameɾikʰa
ㄹㅏㅇㅣㄴ	ɾain
ㅂㅏㅇㅈㅓㅂㅇㅝㄴ	paŋd͡ʑʌbwʌn
ㅇㅑㄱㅍㅜㅁ	jak̚pʰum
ㄴㅗㅇㅁㅣㄴ	noŋmin
ㅎㅐㅇㅇㅣㄴ	hɛŋin
ㅎㅏㅁㅅㅓㅇ	hamsʰʌŋ
ㅇㅣㅅㅏㅎㅚ	isʰaβwe
ㄴㅜㅊㅣ	nut͡ɕʰi
ㄸㅏㄹㅏㅇㅗㄷㅏ	taɾaoda
ㄱㅘㄱㅂㅏㅂ	kwak̚pap̚
ㅇㅡㅁㅅㅗㅁㅜㄴㅈㅏ	ɯmsʰomuɲd͡ʑa
ㅁㅜㄴㄱㅜㅈㅓㅁ	munɡud͡ʑʌm
ㅂㅏㄱㄷㅗㅇ	pak̚toŋ
ㄱㅘㄹㅗㅅㅏ	kwaɾosʰa
ㅎㅗㅅㅣㄹ	ɸʷoɕʰiɭ
ㅈㅣㅈㅣㄹㅎㅏㄱ	t͡ɕid͡ʑiɾɦak̚
ㅂㅣㄷㅏ	pida
ㅂㅏㄴㄱㅏㅄ	pankap̚
ㄹㅏㅈㅏㄴㅑ	ɾad͡ʑaɲja
ㅇㅏㄹㅡㅁㅔㄴㅣㅇㅏ	aɾɯmenia
ㅈㅣㄹㅅㅓ	t͡ɕiɭsʌ
ㄱㅏㄹㅡㅊㅣㄷㅏ	kaɾɯt͡ɕʰida
ㅅㅡㄴㅣㅁ	sʰɯnim
ㅋㅓㄴㅣㅇ	kʰʌniŋ
ㅎㅡㄹㅕㅈㅣㄷㅏ	xɯɾjʌd͡ʑida
ㅍㅡㄹㅗㅌㅡㅇㅏㄱㅌㅣㄴㅠㅁ	pʰɯɾotʰɯak̚tʰiɲjum
ㄷㅏㅈㅓㅇㅎㅏㄷㅏ	tad͡ʑʌŋɦada
ㅁㅓㄴㅈㅓ	mʌɲd͡ʑʌ
ㅁㅏㅎㅏㄴ	maɦan
ㅅㅏㅇㅈㅏ	sʰaŋd͡ʑa
ㅈㅜㅇㄱㅜㄱ	t͡ɕuŋɡuk̚
ㄹㅕㄱㅘㄴ	ɾjʌɡwan
ㅎㅏㄴㄱㅏ	hanɡa
ㅅㅗㅂㅕㄴ	sʰobjʌn
ㄴㅐㅈㅜㄷㅏ	nɛd͡ʑuda
ㄱㅗㅈㅗㅅㅓㄴ	kod͡ʑosʰʌn
ㄱㅓㄷㄷㅏ	kʌt̚ta
ㅂㅓㅌㅓㅁㅣㄹㅋㅡ	pʌtʰʌmiɭkxɯ
ㅋㅏㄹㄴㅏㄹ	kʰaɭɭaɭ
ㄷㅗㅇㅣㅂ	toip̚
ㄱㅔ	ke
ㄱㅗㅁㅍㅏㅇㅇㅣ	kompʰaŋi
ㅎㅜㄴㅁㅣㄴㅈㅓㅇㅇㅡㅁ	ɸʷunmiɲd͡ʑʌŋɯm
ㅍㅛㅎㅏㄷㅏ	pʰjoɦada
ㅁㅓㄱㅜㄹㅣ	mʌɡuɾi
ㄹㅔㄴㅠㅁ	ɾeɲjum
ㄷㅜㄹㄹㅓㅆㅏㄷㅏ	tuɭɭʌsada
ㅎㅓㄹㄷㅏ	hɘɭda
ㅊㅜㄹㅍㅏㄴㅎㅏㄷㅏ	t͡ɕʰuɭpʰanɦada
ㅅㅏㄴ	sʰan
ㅅㅓㅂㅜ	sʰʌbu
ㄱㅐㅅㅓㄴㅎㅏㄷㅏ	kɛsʰʌnɦada
ㅈㅏㅇㅕㄴㅅㅡㄹㅓㅂㄷㅏ	t͡ɕajʌnsʰɯɾʌp̚ta
ㅂㅕㄴㅈㅓㄹㅎㅏㄷㅏ	pjɘɲd͡ʑʌɾɦada
ㅇㅢㅁㅜ	ɰimu
ㄱㅏㅇㄴㅏㅁㅊㅓㄴㅈㅏㄱㅜㄱ	kaŋnamt͡ɕʰʌɲd͡ʑaɡuk̚
ㅂㅗㄱㅁㅜㅎㅏㄷㅏ	poŋmuɦada
ㅅㅣㄹㄸㅡㄱㅣ	ɕʰiɭtɯɡi
ㅊㅏㅁㄱㅣㄹㅡㅁ	t͡ɕʰamɡiɾɯm
ㅈㅓㅇㄹㅑㅇ	t͡ɕɘŋɲjaŋ
ㅇㅏㅍㅊㅣㅁㅏ	ap̚t͡ɕʰima
ㄱㅞ	kwe
ㅁㅔㅌㅓ	metʰʌ
ㅅㅗㄱㅇㅡㅁ	sʰoɡɯm
ㄷㅏㅂㄷㅏ	tap̚ta
ㄱㅏㅇㅈㅗㅎㅏㄷㅏ	kaŋd͡ʑoɦada
ㅋㅡㄴㅎㅢㄴㅈㅜㄱㅈㅣ	kxɯnʝiɲd͡ʑuk̚t͡ɕi
ㅊㅟㅁㅣ	t͡ɕʰɥimi
ㄱㅐㅈㅣㄹㅏㄹㅎㅏㄷㅏ	kɛd͡ʑiɾaɾɦada
ㄷㅜㄷㅏ	tuda
ㅋㅡㄴㄱㅟㅂㅏㄱㅈㅟ	kxɯnɡɥibak̚t͡ɕɥi
ㅈㅓㅇㅅㅜ	t͡ɕʌŋsʰu
ㄱㅏㄱㅖ	kaɡje
ㅎㅡㄱㅅㅓㄹㅌㅏㅇ	xɯksʌɭtʰaŋ
ㅊㅏㅅㅈㅜㅈㅓㄴㅈㅏ	t͡ɕʰat̚t͡ɕud͡ʑʌɲd͡ʑa
ㅋㅔㅇㅣㅍㅏㅂ	kʰeipʰap̚
ㄴㅕㅅㅓㅇ	ɲjʌsʰʌŋ
ㄹㅗㅈㅗ	ɾod͡ʑo
ㅂㅡㄹㅗㅁㅣㄴ	pɯɾomin
ㅇㅜㅅㅍㅡㄷㅏ	ut̚pʰɯda
ㄱㅜㅂㅇㅣ	kubi
ㅈㅏㅇㅁㅗㄴㅣㅁ	t͡ɕaŋmonim
ㅂㅜㄴㅁㅏㄹ	punmaɭ
ㅇㅜㄷㅏㄴ	udan
ㅇㅜㅈㅜㅅㅓㄴ	ud͡ʑusʰʌn
ㅂㅜㄴㄷㅏㄴ	pundan
ㅅㅓㄱㅗ	sʰʌɡo
ㅍㅡㄹㄹㅣㅂㅍㅡㄹㄹㅗㅂ	pʰɯʎʎip̚pʰɯɭɭop̚
ㅈㅏㅂㅣ	t͡ɕabi
ㅅㅣㅂㅗ	ɕʰibo
ㅂㅏㄴㄹㅏㄴ	paɭɭan
ㄱㅏㅅㅣㅇㅓㅁㅓㄴㅣ	kaɕʰiʌmʌni
ㅅㅗㄴㅏㅁㅜ	sʰonamu
ㄱㅓㄴㅈㅓㄴㅎㅏㄷㅏ	kʌɲd͡ʑʌnɦada
ㅊㅗㄱㅈㅣ	t͡ɕʰok̚t͡ɕi
ㅂㅏㄹㅇㅡㅁ	paɾɯm
ㅇㅓㄹㅡㄴ	ɘɾɯn
ㅈㅓㅈㅏ	t͡ɕʌd͡ʑa
ㅈㅣㅅㄱㅜㅈㄷㅏ	t͡ɕit̚kut̚ta
ㄱㅣㅅㅡㅇㅇㅟ	kisʰɯŋɥi
ㄴㅐㅈㅣ	nɛd͡ʑi
ㅋㅏㄹㄹㅓㅁ	kʰaɭɭʌm
ㅁㅗㄱㄷㅗㄹㅣ	mok̚toɾi
ㄱㅛㄷㅗ	kjodo
ㅈㅜㄱㅇㅣㄷㅏ	t͡ɕuɡida
ㅇㅏㄴㄱㅜ	anɡu
ㅈㅜㅇㅈㅚ	t͡ɕuŋd͡ʑwe
ㅁㅣㅊ	mit̚
ㄴㅗㅇㄷㅏㅁ	noŋdam
ㄷㅐㅈㅓㄴㅊㅏㅍㅗ	tɛd͡ʑʌɲt͡ɕʰapʰo
ㄷㅏㄻㅇㅡㅁ	taɭmɯm
ㅅㅏㅅㅡㅁ	sʰasʰɯm
ㅋㅜㅂㅏ	kʰuba
ㅁㅣㄴㅅㅡㅋㅡ	minsʰɯkxɯ
ㅍㅛㄱㅗㅂㅓㅅㅓㅅ	pʰjoɡobʌsʰʌt̚
ㅈㅣㅍㅓ	t͡ɕipʰʌ
ㅁㅗㅅㅏ	mosʰa
ㅎㅚㄱㅣ	ɸweɡi
ㄱㅏㅇㅇㅏㅈㅣ	kaŋad͡ʑi
ㅈㅗㅅㅓㄴㅂㅏㄴㄷㅗ	t͡ɕosʰʌnbando
ㄱㅜㅁㅣㅎㅗ	kumiβo
ㅅㅜㄱㄴㅕ	sʰuŋɲjʌ
ㅁㅕㅇㅊㅣㅇ	mjʌŋt͡ɕʰiŋ
ㄱㅡㄴㅈㅓㄹㅎㅏㄷㅏ	kɯɲd͡ʑʌɾɦada
ㅇㅕㄱㅘ	jɘɡwa
ㅇㅓㄱㅡㄹㅓㅈㅣㄷㅏ	ʌɡɯɾʌd͡ʑida
ㅈㅏㅂㅅㅣㄴ	t͡ɕapɕin
ㅈㅗㅇㄹㅗ	t͡ɕoŋno
ㅇㅜㅍㅕㄴ	upʰjʌn
ㅌㅏㅎㅕㅂ	tʰaʝjʌp̚
ㅌㅗㅎㅏㄷㅏ	tʰoɦada
ㅇㅣㄹㅅㅣㅁㄷㅏㄴㄱㅕㄹ	iɭɕimdanɡjʌɭ
ㅍㅣㄹㅌㅓ	pʰiɭtʰʌ
ㅌㅏㅈㅏㅎㅏㄷㅏ	tʰad͡ʑaɦada
ㅂㅡㄹㅣㅈㅣㅌㅏㅇㅜㄴ	pɯɾid͡ʑitʰaun
ㅈㅗㅇ	t͡ɕoŋ
ㄱㅘㄴㅅㅜㄹㅣ	kwansʰuɾi
ㅋㅟㄴㅗㄹㄹㅣㄴ	kʰɥinoʎʎin
ㅂㅡㄹㄹㅜㄱㅣㄹ	pɯɭɭuɡiɭ
ㅈㅜㅂㄷㅏ	t͡ɕup̚ta
ㅆㅏㄱㅗㄷㅗㄹㄷㅏ	saɡodoɭda
ㅍㅣㄹㅅㅏㄹㄱㅣ	pʰiɭsaɭɡi
ㅇㅓㄹㅕㅂㅅㅏㄹㅣ	ʌɾjʌpsaɾi
ㄱㅜㄹㅗㄴㅏ	kuɾona
ㄱㅏㄴㄱㅖ	kanɡje
ㅎㅓㅂㅔㅇㅣ	hʌbei
ㅇㅜㄴㅈㅓㄴ	uɲd͡ʑʌn
ㄷㅗㅇㄴㅏㅁㅇㅏㅅㅣㅇㅏ	toŋnamaɕʰia
ㅇㅗㅂㅓㅋㅡㄹㄹㅓㄱ	obʌkxɯɭɭʌk̚
ㄱㅗㅅ	kot̚
ㅁㅣㄹㄹㅣㄷㅏ	miʎʎida
ㅇㅠㅇㅝㄹ	juwʌɭ
ㅇㅛㅇㄷㅗㄴ	joŋdon
ㅇㅕㄷㅡㄹㅡㅁ	jʌdɯɾɯm
ㄱㅡㄷㅏㅇㅡㅁ	kɯdaɯm
ㄱㅜㅇㅣㅂ	kuip̚
ㄴㅔ	ne
ㅇㅟㄷㅗ	ɥido
ㄱㅗㅈㅣㅂㅅㅡㄹㅓㅂㄷㅏ	kod͡ʑipsɯɾʌp̚ta
ㅎㅡㄵ	xɯn
ㅅㅛㅋㅔㅇㅣㅅㅡ	ɕʰokʰeisʰɯ
ㄴㅏㅁㅜ	namu
ㅂㅣㅅㅏㅇ	pisʰaŋ
ㅈㅗㄴㄱㅕㅇ	t͡ɕonɡjʌŋ
ㅅㅣㄴㅊㅓㅇ	ɕʰiɲt͡ɕʰʌŋ
ㅍㅏ	pʰa
ㄷㅜㅂㅜ	tubu
ㅅㅜㅅㅡㅂ	sʰusʰɯp̚
ㅎㅘㄹㅅㅓㅇ	ɸwaɭsʌŋ
ㅇㅣㄴㅎㅘㅈㅣ	inβwad͡ʑi
ㅅㅏㅎㅏㄱ	sʰaɦak̚
ㄸㅓㄷㅡㄹㅆㅓㄱㅎㅏㄷㅏ	tʌdɯɭsʌkʰada
ㅅㅗㄱㅆㅡㄹㅣㅁ	sʰoksɯɾim
ㅇㅖㅇㅓㄴㅈㅏ	jeʌɲd͡ʑa
ㅁㅣㅌㅣㅇ	mitʰiŋ
ㅂㅜㄹㅅㅏㅇ	puɭsʰaŋ
ㅂㅐㅁ	pɛm
ㅎㅘㄴㅇㅕㅇ	ɸwaɲjʌŋ
ㄲㅜㅈㅜㄴㅎㅣ	kud͡ʑunʝi
ㅂㅡㄹㄹㅏㄷㅣㅂㅗㅅㅡㅌㅗㅋㅡ	pɯɭɭadibosʰɯtʰokxɯ
ㅁㅜㄷㄷㅏ	mut̚ta
ㅋㅟㄴ	kʰɥin
ㄷㅗㄹ	toɭ
ㅈㅐㄷㅏ	t͡ɕɛda
ㄴㅏㅁㅂㅜ	nambu
ㅈㅣ	t͡ɕi
ㄴㅏㅁㄴㅕㄴㅗㅅㅗ	namɲjʌnosʰo
ㅂㅓㄴㅇㅕㄱ	pʌɲjʌk̚
ㅍㅗㅌㅡㅇㅗㅂㅡㅅㅡㅍㅔㅇㅣㄴ	pʰotʰɯobɯsʰɯpʰein
ㅂㅏㄹㅁㅕㅇ	paɭmjʌŋ
ㅇㅏㄹㅏㅂㅇㅔㅁㅣㄹㅣㅌㅡ	aɾabemiɾitʰɯ
ㄱㅏㄱㅅㅣㅂㅜㅇㅇㅓ	kakɕibuŋʌ
ㄱㅗㅁ	kom
ㅅㅜㅁㅂㅏㄲㅗㄱㅈㅣㄹ	sʰumbakok̚t͡ɕiɭ
ㄱㅣㅇㅕ	kijʌ
ㅇㅑㄱㅎㅏㄷㅏ	jakʰada
ㅇㅢㄱㅕㄴㄹㅏㄴ	ɰiɡjʌnnan
ㄴㅕㄴㄷㅗ	ɲjʌndo
ㅎㅓㄹㅣㅋㅔㅇㅣㄴ	hʌɾikʰein
ㅅㅜㅅㅣㄹㅗ	sʰuɕʰiɾo
ㄴㅚㅁㅜㄹ	nwemuɭ
ㅇㅏㄹㅏㅂㅇㅓ	aɾabʌ
ㅂㅗㄴㅓㅅㅡ	ponʌsʰɯ
ㄱㅗㅇㄱㅜㄱ	koŋɡuk̚
ㅇㅝㄴㅁㅏㅇㅎㅏㄷㅏ	wɘnmaŋɦada
ㄱㅔㅌㅏ	ketʰa
ㅇㄱㄹㅇ	iɡʌɾeaɭ
ㄴㅜㄴㅇㅏㄹ	nunaɭ
ㄱㅘㄴㅎㅕㅇㅅㅏ	kwanʝjʌŋsʰa
ㄸㅣㄷㅗㅇㄱㅏㅂ	tidoŋɡap̚
ㄴㅏㅁㅈㅗㅅㅓㄴ	namd͡ʑosʰʌn
ㅇㅜㅁㅣㄴ	umin
ㅍㅢㅎ	pʰit̚
ㅂㅏㅇㅁㅕㅇ	paŋmjʌŋ
ㅅㅗㄹㅈㅣㄱ	sʰoʎt͡ɕik̚
ㄸㅏㅎㄷㅏ	tatʰa
ㅁㅕㅇㅇㅘㅇㅅㅓㅇ	mjʌŋwaŋsʰʌŋ
ㅇㅣㄱㅘ	ikwa
ㅌㅗㅇㄱㅏ	tʰoŋɡa
ㅇㅠㄱㅘㄱ	juɡwak̚
PCㅂㅏㅇ	pʰiɕibaŋ
ㅈㅗㅎㅇㅏㅈㅣㄷㅏ	t͡ɕoad͡ʑida
ㅇㅛㄱㅜㅎㅏㄷㅏ	joɡuɦada
ㅅㅏㅈㅏㄱㅗㅊㅜ	sʰad͡ʑaɡot͡ɕʰu
ㅇㅔㅌㅣㅇㅗㅍㅣㅇㅏ	etʰiopʰia
ㅈㅜㄱㅝㄴ	t͡ɕukwʌn
ㅇㅡㅇㅇㅝㄴ	ɯŋwʌn
ㅂㅜㄹㄱㅗㅁ	puɭɡom
ㅊㅏㅁㅇㅡㄹㅗ	t͡ɕʰamɯɾo
ㅅㅣㅈㅗㅈㅗ	ɕʰid͡ʑod͡ʑo
ㅅㅏㅁㅏㄱㅎㅘ	sʰamakʰwa
ㄱㅚㄷㅏ	kweda
ㄸㅏㅇㅗㄷㅏ	taoda
ㄲㅡㄹㅇㅓㅇㅏㄴㄷㅏ	kɯɾʌanta
ㅁㅜㅅㅡㄹㄹㅣㅁ	musʰɯʎʎim
ㅇㅢㅎㅏㄱ	ɰiɦak̚
ㅅㅚㅃㅕ	sʰwepjʌ
ㅅㅓㄹㅇㅕㄴㅌㅏ	sʰʌɾjʌntʰa
ㄷㅐㄹㅠㄱㅅㅗㅇㅅㅏㄹㅣ	tɛɾjuksoŋsʰaɾi
ㅅㅗㄴㅂㅏㄹㅌㅗㅂ	sʰonbaɭtʰop̚
ㅂㅕㄴㄷㅗㅇ	pjɘndoŋ
ㅈㅏㅁㅕㅇㅈㅗㅇ	t͡ɕamjʌŋd͡ʑoŋ
ㅅㅗㄱㅗㄱ	sʰoɡok̚
ㅊㅏㅂㅜㄴㅁㅗㄳ	t͡ɕʰabunmok̚
ㅁㅏㅈㅑㄹㅡ	mad͡ʑaɾɯ
ㅅㅣㄷㅏ	ɕʰida
ㅇㅗㄹㄹㅣㄱㅗ	oʎʎiɡo
ㄱㅠㄴㄱㅖ	kjunɡje
ㄴㅏㄴㅅㅣ	nanɕʰi
ㅇㅏㄹㄱㅗㄱ	aɭɡok̚
ㅇㅡㅁㄱㅏ	ɯmɡa
ㅂㅜㄴㄱㅝㄴ	punkwʌn
ㅌㅗㅇㅇㅕㄱㅅㅏ	tʰoŋjʌksa
ㅂㅡㄹㅗㅋㅓ	pɯɾokʰʌ
ㄷㅔㅂㅟ	tebɥi
ㅈㅔㄴㅗㅂㅏ	t͡ɕenoba
ㅁㅏㄴㅕ	maɲjʌ
ㅂㅣㄱㅏㄱ	piɡak̚
ㄲㅗㅂㅜㄹㅏㅇㄱㅜㄱㅅㅜ	kobuɾaŋɡuksu
ㅎㅡㅂㅇㅣㄴㄹㅕㄱ	xɯbiʎʎjʌk̚
ㅍㅏㅁㅜㄴ	pʰamun
ㄱㅏㅈㅣㄱㅗ	kad͡ʑiɡo
ㅈㅣㄱㅈㅓㅂㅎㅘㅂㅓㅂ	t͡ɕik̚t͡ɕʌpʰwabʌp̚
ㄱㅜㄱㅕㅇ	kuɡjʌŋ
ㅁㅟㅅㅡㄹㄹㅣ	mɥisʰɯʎʎi
ㅅㅗㄴㅅㅏㅇ	sʰonsʰaŋ
ㅅㅡㄷㅗㅋㅜ	sʰɯdokʰu
ㅊㅓㄴㅁㅜㄴㅎㅏㄱ	t͡ɕʰʌnmunɦak̚
ㅅㅔㅁㅗㄲㅗㄹ	sʰemokoɭ
ㅇㅠㅊㅓㅇ	jut͡ɕʰʌŋ
ㅁㅕㅇㅇㅖ	mjʌŋje
ㅂㅓㄹㄹㅣㄷㅏ	pɘʎʎida
ㄱㅐㅈㅏㅇ	kɛd͡ʑaŋ
ㅎㅏㄴ	han
ㅂㅐㄱㅛ	pɛɡjo
ㅈㅔㅂㅗㄱ	t͡ɕebok̚
ㅅㅗㅂㅣ	sʰobi
ㄷㅐㅎㅏㄴㅈㅔㄱㅜㄱ	tɛɦaɲd͡ʑeɡuk̚
ㅊㅓㅇㅂㅏㅈㅣ	t͡ɕʰʌŋbad͡ʑi
ㅈㅡㅇㄱㅝㄴㅅㅏ	t͡ɕɯŋkwʌnsʰa
ㄷㅓㅅㄴㅣ	tʌnni
ㄴㅜㄴㅣㅁ	nunim
ㄷㅗㄷㅏㄹㅣ	todaɾi
ㅎㅏㄹ	haɭ
ㄷㅏㄴㅍㅜㅇㄴㅏㅁㅜ	tanpʰuŋnamu
ㅇㅜㅇㅜㄹㅎㅏㄷㅏ	uuɾɦada
ㄴㅣㅋㅗㅅㅣㅇㅏ	nikʰoɕʰia
ㅈㅏㅇㄹㅖ	t͡ɕaŋɲje
ㅊㅗㅇㄹㅣ	t͡ɕʰoŋni
ㄹㅔ	ɾe
ㄴㅗㅇㅖ	noje
ㅇㅗㄱ	ok̚
ㅅㅜㅎㅘ	sʰuβwa
ㅇㅏㅅㅡㅌㅏㄴㅏ	asʰɯtʰana
ㅁㅏㅁㅓㅅ	mamʌt̚
ㅈㅏㄷㅗㅇㅎㅘ	t͡ɕadoŋβwa
ㅇㅏㅂㅏㄴㅏ	abana
ㄴㅡㅇㅎㅏㄷㅏ	nɯŋɦada
ㅅㅓㅇㄱㅜㄴ	sʰʌŋɡun
ㄱㅓㅁㄷㅜㅇㅇㅗㄹㅣㅅㅏㅊㅗㄴ	kʌmduŋoɾisʰat͡ɕʰon
ㅅㅓㄱㅓ	sʰɘɡʌ
ㅇㅜㅇㅓㄴ	uʌn
ㅇㅣㄹㅅㅣㄴㄹㅗㄴ	iɭɕinnon
ㄷㅗㄱㅁㅜㄹ	toŋmuɭ
ㅃㅗㄹㅅㅡㅋㅏ	poɭsʰɯkʰa
ㅇㅏㅂㅣㅈㅏㅇ	abid͡ʑaŋ
ㅎㅏ	ha
ㅇㅕㄹㄴㅔㅅ	jʌɭɭet̚
ㅌㅡㄹㅣㅍㅗㄹㄹㅣ	tʰɯɾipʰoʎʎi
ㅈㅜㅇㅇㅟ	t͡ɕuŋɥi
ㅇㅡㅇㅈㅣㅇㅎㅏㄷㅏ	ɯŋd͡ʑiŋɦada
ㅎㅔㄹㅏ	heɾa
ㅂㅗㄹㅡㅁ	poɾɯm
ㅂㅣㅂㅓ	pibʌ
ㅊㅜㄹㅅㅓㄱ	t͡ɕʰuɭsʌk̚
ㅊㅡㄱㅇㅟ	t͡ɕʰɯɡɥi
ㅇㅜㅅㅡㅂㄷㅏ	usʰɯp̚ta
ㅍㅕㄴㅈㅣㅂㅈㅏ	pʰjʌɲd͡ʑip̚t͡ɕa
ㅎㅜㅅㅣㄱ	ɸʷuɕʰik̚
ㅈㅓㅇㄱㅝㄴ	t͡ɕʌŋkwʌn
ㄱㅡㄴㅏㄹ	kɯnaɭ
ㄷㅏㄹㅏㅎㄷㅏ	taɾatʰa
ㄲㅗㅊㅈㅣㅂ	kot̚t͡ɕip̚
ㅈㅔㅇㅠㄱ	t͡ɕejuk̚
ㅅㅜㄹㅣㄴㅏㅁ	sʰuɾinam
ㅂㅏㅌ	pat̚
ㅌㅗ	tʰo
ㅍㅛㅎㅕㄴㅎㅕㅇ	pʰjoʝjʌnʝjʌŋ
ㅁㅜㄹㅇㅓㅂㅗㄷㅏ	muɾʌboda
ㄴㅗㄱㄷㅏ	nok̚ta
ㄷㅏㄹㅡㅁㅇㅓㅄㄷㅏ	taɾɯmʌp̚ta
ㅇㅗㄹㅡㄱㅏㅅㅡㅁ	oɾɯɡasʰɯm
ㄱㅗㄷㅂㅏㄹㅗ	kot̚paɾo
ㅂㅗㄱㅅㅓㄴ	poksʌn
ㄱㅓㅁㄷㅜㅇㅇㅗㄹㅣ	kʌmduŋoɾi
ㅂㅏㄱㄷㅏ	pak̚ta
ㄱㅡㄹㅔㅇㅣㅂㅣ	kɯɾeibi
ㅁㅛㅅㅏ	mjosʰa
ㄱㅡㅈㅓ	kɯd͡ʑʌ
ㅇㅖㅇㅓㄴ	jeʌn
ㄴㅔㄷㅓㄹㄹㅏㄴㄷㅡㅇㅓ	nedʌɭɭandɯʌ
ㄷㅗㄷㅂㅗㄱㅣ	tot̚poɡi
ㅅㅗㅁㄸㅏㅁ	sʰomtam
ㅊㅣㅁㅁㅗㄱ	t͡ɕʰimmok̚
ㅇㅣㄴㅈㅗㅇ	iɲd͡ʑoŋ
ㅅㅣㄹㅅㅣ	ɕʰiɭɕi
ㅅㅓㅇㅅㅣㄴ	sʰɘŋɕʰin
ㄴㅗㅍㅇㅣㅁㅁㅏㄹ	nopʰimmaɭ
ㅅㅜㄴㅏㅂㅈㅏㅇ	sʰunap̚t͡ɕaŋ
ㄱㅏㅇㅣㄷㅡ	kaidɯ
ㅎㅟ	hɥi
ㄷㅐㅅㅣㄴ	tɛɕʰin
ㅅㅗㅎㅏㄱㄱㅛ	sʰoɦak̚kjo
ㅅㅗㅁㅌㅓㄹ	sʰomtʰʌɭ
ㅈㅜㅇㄱㅏㄴ	t͡ɕuŋɡan
ㅇㅏㅂㅣ	abi
ㅈㅔㅌㅡㄱㅣ	t͡ɕetʰɯɡi
ㅇㅑㄱㅕㅇ	jaɡjʌŋ
ㅇㅏㄴㅅㅣㅁㅎㅏㄷㅏ	anɕʰimɦada
ㅁㅏㄴㄷㅜ	mandu
ㅅㅡㅍㅜㄹ	sʰɯpʰuɭ
ㅇㅣㄹㅊㅔ	iʎt͡ɕʰe
ㄲㅏㅇㅊㅣ	kaŋt͡ɕʰi
ㄱㅘㄴㅂㅏㄱㅈㅟ	kwanbak̚t͡ɕɥi
ㅈㅓㅈㅜ	t͡ɕɘd͡ʑu
ㅅㅣㅇㅝㄴㅎㅏㄷㅏ	ɕʰiwʌnɦada
ㄱㅡㅁㅈㅏㅌㅏㅂ	kɯmd͡ʑatʰap̚
ㅅㅡㄹㄹㅏㅂㅡ	sʰɯɭɭabɯ
ㅇㅣㄱㅏㄴㅈㅣㄹ	iɡaɲd͡ʑiɭ
ㄷㅜㅅㅔ	tusʰe
ㄱㅕㄹㅣ	kjʌɾi
ㅂㅏㄹㄷㅟㄲㅜㅁㅊㅣ	paɭtɥikumt͡ɕʰi
ㅂㅜㄹㅓㅁ	puɾʌm
ㄴㅗㅋㅡ	nokxɯ
ㅈㅚ	t͡ɕwe
ㅇㅕㅍ	jʌp̚
ㄷㅗㄹㅇㅏㄱㅏㅅㅣㄷㅏ	toɾaɡaɕʰida
ㅂㅣㅇㅅㅏㅇㄱㅘㄴ	piŋsʰaŋɡwan
ㅌㅗㄴㅔㅇㅣㄷㅗ	tʰoneido
ㅅㅓㄹㄱㅛㅈㅏ	sʰʌɭɡjod͡ʑa
ㅇㅏㄴㅁㅕㄴㅅㅡㅇㅁㅏ	anmjʌnsʰɯŋma
ㅂㅏㅇㅅㅏㄴㅡㅇ	paŋsʰanɯŋ
ㅅㅗㅅㅜ	sʰosu
ㅇㅣㅅㅡㄹㄹㅏㅁㄱㅛㄷㅗ	isʰɯɭɭamɡjodo
ㅍㅣㅍㅔㄹㅣㄷㅣㄴ	pʰipʰeɾidin
ㅂㅗㄱㅎㅗ	pokʰo
ㅍㅗㅌㅡㄹㅜㅇㅣㅅㅡ	pʰotʰɯɾuisʰɯ
ㅇㅏㄹㅇㅏㅊㅏㄹㅣㄷㅏ	aɾat͡ɕʰaɾida
ㅁㅐㅈㅜ	mɛd͡ʑu
ㄴㅜㄴㅆㅏㅇㅜㅁ	nunsaum
ㄱㅜㄱㅈㅔㅇㅓ	kuk̚t͡ɕeʌ
ㄷㅗㄹㅗ	toɾo
ㅍㅏㅇㅣㅌㅣㅇ	pʰaitʰiŋ
ㅇㅑㄱㅡㅁㅇㅑㄱㅡㅁ	jaɡɯmjaɡɯm
ㅅㅓㄱ	sʰʌk̚
ㅊㅏㅌㅡ	t͡ɕʰatʰɯ
ㄷㅗㄹㅂㅗㄷㅏ	toɭboda
ㄱㅡㅅㄷㅏ	kɯt̚ta
ㅋㅏㄹㅡㅂㅣㄹㅇㅏㅁㅣㄴ	kʰaɾɯbiɾamin
ㅇㅖㅇㅚ	jewe
ㅊㅜㅊㅜㄹ	t͡ɕʰut͡ɕʰuɭ
ㅇㅕㄹㄹㅏㅁㅅㅣㄹ	jʌɭɭamɕʰiɭ
ㅎㅐㅂㅕㄴ	hɛbjʌn
ㅂㅓㅌㅡㄴ	pʌtʰɯn
ㅖ	je
ㅁㅜㄹㄹㅣㅎㅏㄱ	muʎʎiɦak̚
ㅅㅏㅌㅏㅇ	sʰatʰaŋ
ㅇㅖㅅㅜㅎㅚ	jesʰuβwe
ㅂㅜㄱㅎㅏㄴ	pukʰan
ㅂㅗㅌㅗㅇㅎㅘ	potʰoŋβwa
ㅂㅜㄱㄷㅗㄷㅇㅜㄷㅏ	puk̚toduda
ㄱㅜㄴㅈㅜㅇㄱㅏㅇㅛ	kuɲd͡ʑuŋɡajo
ㅁㅓㄱㅇㅣㄱㅡㅁㅜㄹ	mʌɡiɡɯmuɭ
ㅇㅓㄱㅡㄴ	ɘɡɯn
ㅇㅕㅁㅂㅕㅇ	jɘmbjʌŋ
ㅎㅔㅁㅗㄱㅡㄹㄹㅗㅂㅣㄴ	hemoɡɯɭɭobin
ㅇㅝㄴㅂㅗㄴ	wʌnbon
ㄱㅏㄴㅡㅇ	kanɯŋ
ㅁㅏㅈㅊㅜㄷㅏ	mat̚t͡ɕʰuda
ㅇㅑㅇㄹㅕㄱ	jaŋɲjʌk̚
ㅎㅡㄱㅎㅡㄱ	xɯkxɯk̚
ㄷㅏㅇㅡㅁ	taɯm
ㅇㅣㅂㅏㄹ	ibaɭ
ㄹㅣㄴㅅㅡ	ɾinsʰɯ
ㅈㅓㅂㄱㅡㄴ	t͡ɕʌp̚kɯn
ㅇㅣㄹㅇㅓ	iɾʌ
ㅅㅜㅍ	sʰup̚
ㅅㅡㅇㅞㅌㅓ	sʰɯwetʰʌ
ㄱㅛㅊㅏㅇㅟ	kjot͡ɕʰaɥi
ㅍㅣㄹㅣㄷㅣㄴ	pʰiɾidin
ㅍㅡㄹㅗㄹㄹㅔㅌㅏㄹㅣㅇㅏ	pʰɯɾoɭɭetʰaɾia
ㅁㅏㄹㄷㅏ	maɭda
ㅇㅕㅊㅔ	jʌt͡ɕʰe
ㅁㅣㅂㅜㄴㅂㅓㅂ	mibunbʌp̚
ㅎㅘㄱㅏ	ɸwaɡa
ㄱㅜ	ku
ㅅㅡㄹㅣㄹㅏㅇㅋㅏ	sʰɯɾiɾaŋkʰa
ㅂㅜㄹㄱㅜㅎㅏㄷㅏ	puɭɡuɦada
ㄴㅣㄱ	nik̚
ㅈㅜㅈㅜㅇ	t͡ɕud͡ʑuŋ
ㅂㅚㅂㄷㅏ	pwep̚ta
ㅁㅜㅌ	mut̚
ㅂㅏㄷㅊㅣㅁ	pat̚t͡ɕʰim
ㅂㅣㅊㅟ	pit͡ɕʰɥi
ㅈㅏㅂㅓㄹㄹㅔ	t͡ɕabʌɭɭe
ㅅㅜㄹㅕㄱ	sʰuɾjʌk̚
ㄱㅣㄱㅏㄱ	kiɡak̚
ㄱㅏㄴㅎㅗㅇㅝㄴ	kanβowʌn
ㅅㅡㄴㅗㅂㅗㄷㅡ	sʰɯnobodɯ
ㄱㅟㄸㅜㄹㅏㅁㅣ	kɥituɾami
ㅈㅣㅎㅏㄷㅗ	t͡ɕiɦado
ㅍㅣㄱㅇㅓㅂ	pʰiɡʌp̚
ㄲㅜㄱㅈㅓㄱㅜ	kuk̚t͡ɕʌɡu
ㅇㅕㄴㅇㅖㅇㅣㄴ	jɘɲjein
ㅊㅣㅇㅛㄱ	t͡ɕʰijok̚
ㅈㅓㅇㅇㅠㄱㅈㅓㅁ	t͡ɕʌŋjuk̚t͡ɕʌm
ㄷㅐㅎㅏㄴㅁㅣㄴㄱㅜㄱ	tɛɦanminɡuk̚
ㅌㅣㅂㅡㅇㅣ	tʰibɯi
ㄷㅏㅇㅇㅕㄴㅎㅏㄷㅏ	taŋjʌnɦada
ㅇㅣㅅㅁㅗㅁ	inmom
ㄱㅜㄹㅔㄴㅏㄹㅜㅅ	kuɾenaɾut̚
ㄱㅘㅎㅏㄱ	kwaɦak̚
ㅁㅗㅂㅏㅇ	mobaŋ
ㅇㅠㅌㅠㅂㅡ	jutʰjubɯ
ㄱㅣㅅ	kit̚
ㅂㅜㄹㅍㅕㄴㅎㅏㄷㅏ	puɭpʰjʌnɦada
ㄴㅗㄹㅕㄱㅎㅏㄷㅏ	noɾjʌkʰada
ㄴㅗㅇㅇㅓ	noŋʌ
ㅊㅜㅇㅅㅣㅁ	t͡ɕʰuŋɕʰim
ㅇㅜㅇㅞㄱ	uwek̚
ㅈㅣㄴㅊㅜㄹㅎㅏㄷㅏ	t͡ɕiɲt͡ɕʰuɾɦada
ㅅㅏㅅㄱㅏㅅ	sʰat̚kat̚
ㅅㅔㄹㅋㅏ	sʰeɭkʰa
ㅈㅗㅇㅈㅗㄱ	t͡ɕoŋd͡ʑok̚
ㅂㅜㅅㅣㄴ	puɕʰin
ㅅㅏㅌㅜㄹㅡㄴㅜㅅㅡ	sʰatʰuɾɯnusʰɯ
ㄹㅣㄴㅜㄱㅅㅡ	ɾinuksɯ
ㅅㅓㅇㅈㅓㄱ	sʰʌŋd͡ʑʌk̚
ㄷㅜㄷㅡㄹㅣㄷㅏ	tudɯɾida
ㅇㅗㅋㅔㅅㅡㅌㅡㄹㅏ	okʰesʰɯtʰɯɾa
ㄱㅏㅁㅌㅏㄴㅅㅏ	kamtʰansʰa
ㄱㅏㅅㅡㅁ	kasʰɯm
ㄹㅗㄱ	ɾok̚
ㅅㅏㅁㄷㅏ	sʰamta
ㅂㅓㄹㄸㅓㄱ	pʌɭtʌk̚
ㅂㅣㄴ	pin
ㅇㅑㅇㅈㅏ	jaŋd͡ʑa
ㄱㅣㅂㅗㄴ	kibon
ㄲㅏㅁㄷㅜㅇㅇㅣ	kamduŋi
ㅅㅏㅇㅑㅇㅎㅏㄷㅏ	sʰajaŋɦada
ㄷㅡㄹㅇㅕㄷㅏㅂㅗㄷㅏ	tɯɾjʌdaboda
ㅅㅓㄹㅁㅏ	sʰʌɭma
ㅁㅗㄹㄷㅣㅂㅡ	moɭdibɯ
ㄱㅕㅇㅅㅣ	kjʌŋɕʰi
ㅁㅏㅅㅣㄴㅏ	maɕʰina
ㄷㅏㅁㅎㅘㅇ	tamβwaŋ
ㅊㅜㄹㅅㅏㄴㅇㅠㄹ	t͡ɕʰuɭsʰaɲjuɭ
ㅊㅓㄴㅈㅣ	t͡ɕʰʌɲd͡ʑi
ㅂㅜㅇㅠ	puju
ㄷㅏㄹㅣㅁㅣ	taɾimi
ㅇㅣㄴㄱㅏㅁ	inɡam
ㅋㅗㅋㅗㄴㅓㅅ	kʰokʰonʌt̚
ㅈㅓㄴㄱㅜㄱ	t͡ɕʌnɡuk̚
ㄱㅏㅊㅜㄱ	kat͡ɕʰuk̚
ㅌㅏㅁㅣㄹㅇㅓ	tʰamiɾʌ
ㅉㅗㅊㄱㅣㄷㅏ	t͡ɕot̚kida
ㅅㅏㄴㅈㅏㅇ	sʰaɲd͡ʑaŋ
ㅁㅣㄴㅈㅜㅈㅜㅇㅢㅈㅏ	miɲd͡ʑud͡ʑuɰid͡ʑa
ㅁㅐㅇㄲㅗㅇㅇㅣ	mɛŋkoŋi
ㅎㅡㅇㅁㅣㄹㅗㅂㄷㅏ	xɯŋmiɾop̚ta
ㅂㅜㄴㅗㅇ	punoŋ
ㄸㅐㅁㄴㅏㅂ	tɛmnap̚
ㅈㅓㅇㅅㅏㅇ	t͡ɕɘŋsʰaŋ
ㅇㅣㄴㅏㄹ	inaɭ
ㅂㅓㄹㅈㅜㄷㅏ	pʌʎd͡ʑuda
ㄱㅗㅇㅎㅓㅎㅏㄷㅏ	koŋɦʌɦada
ㅇㅣㄹㅂㅗㄴㅇㅣㄴ	iɭbonin
ㅁㅝ	mwɘ
ㅌㅡㄹㅗㅌㅡ	tʰɯɾotʰɯ
ㄱㅏㄴㅅㅓㄴㄷㅗㄹㅗ	kansʰʌndoɾo
ㅈㅣㄱㅜ	t͡ɕiɡu
ㅎㅏㄴㅏㅁ	hanam
ㅂㅜㄹㅓㅂㄷㅏ	puɾʌp̚ta
ㅍㅏㄹㅕㅁㅊㅣ	pʰaɾjʌmt͡ɕʰi
ㅅㅚㅇㅗㄹㅣ	sʰweoɾi
ㄷㅐㅅㅣㄴㅎㅏㄷㅏ	tɛɕʰinɦada
ㅈㅗㄲㅣ	t͡ɕoki
ㅍㅜㄹㅂㅏㅌ	pʰuɭbat̚
ㅊㅏㅁㅈㅜ	t͡ɕʰamd͡ʑu
ㄹㅗㅂㄷㅏ	ɾop̚ta
ㅎㅡㅍ	xɯp̚
ㅅㅔㄷㅏ	sʰeda
ㅅㅣㄷㅗㅎㅏㄷㅏ	ɕʰidoɦada
ㅅㅡㅇㄹㅣ	sʰɯŋni
ㅇㅕㄴㅊㅜㄹ	jɘɲt͡ɕʰuɭ
ㅇㅕㄴㄱㅡㅁ	jʌnɡɯm
ㄲㅡㄶㅇㅣㅁㅇㅓㅄㅇㅣ	kɯnimʌpɕi
ㅁㅗㄹㅣㅅㅕㅅㅡ	moɾiɕʰʌsʰɯ
ㅇㅜㄴㄷㅗㅇㅈㅏㅇ	undoŋd͡ʑaŋ
ㅌㅗㅊㅣ	tʰot͡ɕʰi
ㅊㅓㄴㅇㅏㄴㅁㅜㄴ	t͡ɕʰʌnanmun
ㅊㅏㅁㅅㅓㄱㅎㅏㄷㅏ	t͡ɕʰamsʰʌkʰada
ㅈㅓㄹㄱㅏㅇ	t͡ɕʌɭɡaŋ
ㅈㅗㄹㅠ	t͡ɕoɾju
ㄱㅓㅁㅈㅓㅇㅁㅏㅇㄷㅜㄱ	kʌmd͡ʑʌŋmaŋduk̚
ㄱㅜㄷㅓㄱㅣ	kudʌɡi
ㅇㅠㅌㅗㅇ	jutʰoŋ
ㄹㅜㅌㅔㄴㅠㅁ	ɾutʰeɲjum
ㄱㅏㄹㅇㅏㅌㅏㄷㅏ	kaɾatʰada
ㅇㅣㄹㅇㅕㄷㅓㄼ	iɾjʌdʌɭ
ㅌ.ㄷ	tʰɯdɯ
ㅍㅣㄴㅔㄴ	pʰinen
ㅃㅕ	pjʌ
ㅅㅓㅇㅇㅛㄱ	sʰɘŋjok̚
ㅍㅏㅈㅓㄴ	pʰad͡ʑʌn
ㅇㅕㅈㅓㄴㅎㅏㄷㅏ	jʌd͡ʑʌnɦada
ㄹㅗㅆㅣㅇㅑㅁㅏㄹ	ɾoɕijamaɭ
ㅇㅕㄴㅎㅚ	jɘnβwe
ㄱㅏㄱㄱㅣ	kak̚ki
ㅈㅣㄴㅈㅣㅎㅏㄷㅏ	t͡ɕiɲd͡ʑiɦada
ㄴㅜㅇㅣ	nui
ㅅㅣㄴㅁㅕㅇㄱㅣ	ɕʰinmjʌŋɡi
ㅇㅏㅅㅔㄴㅏㅍㅡㅌㅔㄴ	asʰenapʰɯtʰen
ㅍㅗㅌㅏㄹ	pʰotʰaɭ
ㄱㅘㄴㄹㅣㅇㅣㄴ	kwaʎʎiin
ㅈㅏㄱㅇㅡㄴㄸㅏㅅㅈㅟ	t͡ɕaɡɯntat̚t͡ɕɥi
ㅇㅏㅈㅜㅁㅁㅏ	ad͡ʑumma
ㅆㅏㅎㄷㅏ	satʰa
ㄴㅏㄴㅊㅜㄴㅣ	naɲt͡ɕʰuni
ㄱㅣㄹㅡㄷㅏ	kiɾɯda
ㅇㅑㅇㄷㅏㄹㅣ	jaŋdaɾi
ㄱㅖㄹㅕㄹ	kjeɾjʌɭ
ㄷㅗㅁㅣㄴㅣㅋㅏ	tominikʰa
ㅇㅘㅇㅣㅍㅏㅇㅣ	waipʰai
ㄱㅓㅅㅡㄹㅡㅁㄷㅗㄴ	kʌsʰɯɾɯmton
ㄷㅣㅈㅔㅇㅣ	tid͡ʑei
ㅊㅣㅇㅑㄱ	t͡ɕʰijak̚
ㅅㅏㅇㅇㅢㅎㅏㄷㅏ	sʰaŋɰiɦada
ㅈㅏㄴ	t͡ɕan
ㅇㅖㅁㅔㄴ	jemen
ㄷㅣㅅㅡㅋㅡ	tisʰɯkxɯ
ㄱㅏㅇㅈㅜㄴㅊㅣ	kaŋd͡ʑuɲt͡ɕʰi
ㄴㅗㄴㄷㅏㄴㅣ	nondani
ㅇㅏㅇㅑㅌㅗㄹㄹㅏ	ajatʰoɭɭa
ㅌㅏㄴㅎㅘ	tʰanβwa
ㅈㅓㄴㅅㅣㅎㅚ	t͡ɕɘnɕʰiβwe
ㄱㅐㅅㅓㄴ	kɛsʰʌn
ㅎㅡㅁㅈㅏㅂㄷㅏ	xɯmd͡ʑap̚ta
ㄱㅘㅇㅁㅜㄹㅎㅏㄱ	kwaŋmuɾɦak̚
ㄱㅐㄴㅏㄹㅣ	kɛnaɾi
ㅈㅝ	t͡ɕwʌ
ㅇㅏㅁㅎㅗ	amβo
ㅌㅏㅇㅣㅂ	tʰaip̚
ㅂㅜㅅㅣ	puɕʰi
ㅅㅣㅈㅏㄱㅎㅏㄷㅏ	ɕʰid͡ʑakʰada
ㅇㅜㄹㄷㅏ	uɭda
ㅍㅣㅊㅓㅍㅗㄴ	pʰit͡ɕʰʌpʰon
ㅁㅜㄴㅈㅣㄹㅡㄷㅏ	muɲd͡ʑiɾɯda
ㅈㅔㅅㅣㅎㅏㄷㅏ	t͡ɕeɕʰiɦada
ㅇㅛㅇㅑㄱㅎㅏㄷㅏ	jojakʰada
ㄴㅏㅁㄴㅕㅋ	namɲjʌk̚
ㄱㅗㅇㅁㅗ	koŋmo
ㄱㅐㅊㅓㄴ	kɛt͡ɕʰʌn
ㅎㅗㄹㅡㅁㅗㄴ	ɸʷoɾɯmon
ㅁㅏㄷㅡㄹㅣㄷㅡ	madɯɾidɯ
ㅊㅜㄱㅣㄱㅕㅇ	t͡ɕʰuɡiɡjʌŋ
ㅇㅓㄴㅜㄹ	ɘnuɭ
ㅎㅡㅁ	xɯm
ㅇㅏㅈㅜㄹㄹㅔㄴ	ad͡ʑuɭɭen
ㅋㅡㅅㅏㄴㅌㅔㄴ	kxɯsʰantʰen
ㅁㅕㅇㅂㅜ	mjʌŋbu
ㅊㅔㅈㅣㄹ	t͡ɕʰed͡ʑiɭ
ㅌㅓㄱ	tʰʌk̚
ㅎㅗㄱㄱㅏㅇㅣㄷㅗ	ɸʷok̚kaido
ㅇㅓㅁㅓ	ʌmʌ
ㅈㅏㅁㅈㅏㄹㅣ	t͡ɕamd͡ʑaɾi
ㅌㅔㅇㅗㄷㅗㅅㅣㅇㅜㅅㅡ	tʰeodoɕʰiusʰɯ
ㄷㅜㄷㅓㅇ	tudʌŋ
ㅇㅜㅇㅕㄴㅎㅣ	ujʌnʝi
ㅈㅜㅇㅢ	t͡ɕuɰi
ㄹㅜㅇㅏㄴㄷㅏ	ɾuanda
ㅌㅜㅌㅏㅇㅋㅏㅁㅔㄴ	tʰutʰaŋkʰamen
ㅈㅜㅇㅎㅘ	t͡ɕuŋβwa
ㅊㅣㄴㅎㅏㄷㅏ	t͡ɕʰinɦada
ㅇㅠㅇㅈㅏ	juŋd͡ʑa
ㄱㅟㅇㅔㅅㅁㅏㄹㅎㅏㄷㅏ	kɥienmaɾɦada
ㅇㅣㅁㅅㅣㄴ	imɕʰin
ㅅㅗㄱㄱㅕㄴ	sʰok̚kjʌn
ㄴㅗㄷㅗㅇㅈㅏ	nodoŋd͡ʑa
ㄱㅏㅊㅏ	kat͡ɕʰa
ㅈㅣㅌㄷㅏ	t͡ɕit̚ta
ㄴㅗㄴㅁㅜㄴ	nonmun
ㅁㅜㄹㅅㅗ	muɭso
ㅌㅗㅈㅣ	tʰod͡ʑi
ㄲㅗㅈㅣㅂㄷㅏ	kod͡ʑip̚ta
ㅃㅐㄷㅏ	pɛda
ㅅㅏㅎㅡㄹ	sʰaɣɯɭ
ㄹㅏㄷㅠㅁ	ɾadjum
ㅈㅓㄱㅂㅜㄴ	t͡ɕʌk̚pun
ㄱㅓㅁㅇㅡㄴㅁㅗㄱㄴㅗㄴㅂㅕㅇㅇㅏㄹㅣ	kʌmɯnmoŋnonbjʌŋaɾi
ㅍㅕㅇㅂㅓㅁ	pʰjʌŋbʌm
ㅇㅣㅁㅗ	imo
ㅇㅣㅂㅈㅏ	ip̚t͡ɕa
ㅈㅣㄱㅏㄱ	t͡ɕiɡak̚
ㅂㅔㄹㅏㄴㄷㅏ	peɾanda
ㅍㅣㅅ	pʰit̚
ㄹㅕㄴㅎㅏㅂ	ɾjʌnɦap̚
ㄱㅛㅌㅗㅇㅅㅏㄱㅗ	kjotʰoŋsʰaɡo
ㅆㅣㅂㅏㄹ	ɕibaɭ
ㅊㅓㄹㄱㅏㅂㅅㅏㅇㅇㅓ	t͡ɕʰʌɭɡapsaŋʌ
ㄱㅘㄱㅓㅅㅣㅈㅔ	kwaɡʌɕʰid͡ʑe
ㄱㅖㅅㅏㄴㅇㅝㄴ	kjesʰanwʌn
ㅊㅓㄹㄷㅗ	t͡ɕʰʌɭto
ㅅㅣㅅㅣㄴㄱㅕㅇ	ɕʰiɕʰinɡjʌŋ
ㄷㅗㅇㅏㄴ	toan
ㅈㅓㄴㅁㅜㄴㅇㅣㄹㄲㅜㄴ	t͡ɕʌnmuniɭkun
ㄷㅏㄴㅊㅔ	taɲt͡ɕʰe
ㅆㅏㅇㅜㅁ	saum
ㅁㅏㅍㅣㅇㅏ	mapʰia
ㄷㅏㄹㅜㄷㅏ	taɾuda
ㅇㅘㄹ	waɭ
ㄱㅣㄴㅕ	kiɲjʌ
ㄴㅗㅇㄷㅏㅁ	noŋdam
ㅁㅣㅇㅋㅡ	miŋkxɯ
ㅇㅣㅅㄸㅏㄹㅡㄷㅏ	it̚taɾɯda
ㅎㅏㄴㅎㅏㄱ	hanɦak̚
ㅁㅣㅆㅏㅇㅣㄹ	misaiɭ
ㅊㅣㅌㅗㅇ	t͡ɕʰitʰoŋ
ㅈㅏㅇㅢ	t͡ɕaɰi
ㅁㅣㅊㅣㄷㅏ	mit͡ɕʰida
ㄷㅗㅇㅌㅣㅁㅗㄹㅡ	toŋtʰimoɾɯ
ㄴㅚㅇㅜ	nweu
ㄱㅘㄴㅇㅡㅁ	kwanɯm
ㅈㅏㅁㅇㅓㄴ	t͡ɕamʌn
ㅂㅏㅇㄱㅡㅁ	paŋɡɯm
ㅇㅏㄴ	an
ㅑ	ja
ㄹㅣㅂㅗㄴ	ɾibon
ㅎㅘㅎㅏㅂㅁㅜㄹ	ɸwaɦammuɭ
ㅊㅗㅈㅓㅁ	t͡ɕʰot͡ɕʌm
ㅌㅏㄴㅌㅏㄹㄹㅓㅁ	tʰantʰaɭɭʌm
ㅇㅣㄹㅂㅏㄴㅇㅣㄴ	iɭbanin
ㄱㅏㄴㅎㅗㅅㅏ	kanβosʰa
ㅈㅔㅎㅏㄴ	t͡ɕeɦan
ㅇㅗㄹㅛㄹ	oɾjoɭ
ㄱㅏㄹㅆㅡㄸㅜㄱ	kaɭsɯtuk̚
ㅇㅣㅅㅣㅂ	iɕʰip̚
ㄷㅡㅁㅜㄹㄷㅏ	tɯmuɭda
ㅁㅗㄱ	mok̚
ㄲㅔㅅㅓ	kesʰʌ
ㅇㅠㅅㅓ	jusʰʌ
ㄱㅓㅂㅁㅓㄱㄷㅏ	kʌmmʌk̚ta
ㅂㅜㄴㅍㅣㄹ	punpʰiɭ
ㄱㅏㄷㅡ	kadɯ
ㅇㅟㅎㅏㄷㅏ	ɥiɦada
ㅆㅓㅇㅜㅈㅣ	sʌud͡ʑi
ㄴㅗㅇㅊㅗㄴ	noŋt͡ɕʰon
ㅌㅏㅇㅣㅇㅓ	tʰaiʌ
ㅁㅟㄴㅎㅔㄴ	mɥinɦen
ㄹㅔㄱ	ɾek̚
ㄷㅗㄱㅏㄴㅣ	toɡani
ㅇㅕㄱㅇㅝㄴ	jʌɡwʌn
ㄱㅏㅁㄷㅗㅇㅅㅏ	kamdoŋsʰa
ㅁㅛㅅㅏㅎㅏㄷㅏ	mjosʰaɦada
ㅇㅣㅇㅜㄹㄷㅏ	iuɭda
ㅁㅏㅈㅜㅇㅎㅏㄷㅏ	mad͡ʑuŋɦada
ㅅㅣㅂㅈㅏ	ɕʰip̚t͡ɕa
ㅈㅜㅁㅜㅅㅣㄷㅏ	t͡ɕumuɕʰida
ㅇㅕㅁㄱㅣ	jʌmɡi
ㅅㅏㅇㄴㅕㅁ	sʰaŋɲjʌm
ㄸㅗㄱ	tok̚
ㅈㅔㅁㅗㄱ	t͡ɕemok̚
ㅇㅕㅇㅜㄹㅁㅏㅈㅏ	jʌuɭmad͡ʑa
ㄱㅐ	kɛ
ㅋㅏㅍㅣㅂㅏㄹㅏ	kʰapʰibaɾa
ㅁㅗㄹㅗㅋㅗ	moɾokʰo
ㄴㅗㄱㅇㅡㅁ	noɡɯm
ㄱㅏㅅ	kat̚
ㅎㅏㅇㅕㄱㅏㄴ	hajʌɡan
ㅊㅣㄷㅏ	t͡ɕʰida
ㅂㅣㅇㄱㅕㄹ	piŋɡjʌɭ
ㅌㅔㅋㅡㄴㅔㅌㅠㅁ	tʰekxɯnetʰjum
ㅍㅏㅅㅠㅌㅗㅇㅓ	pʰaɕʰutʰoʌ
ㅁㅗㅇㅛㅇ	mojoŋ
ㅇㅑㅇㅁㅗ	jaŋmo
ㅈㅣㄹㅅㅗ	t͡ɕiɭsʰo
ㅌㅜㅍㅛㅎㅏㄷㅏ	tʰupʰjoɦada
ㅃㅏㅈㅣㄷㅏ	pad͡ʑida
ㅇㅣㄹㅇㅝㄴ	iɾwʌn
ㅅㅏㄹㅣㅇㅝㄴ	sʰaɾiwʌn
ㅁㅗㄹㅏㄴㅂㅗㅇ	moɾanboŋ
ㅁㅗㄹㄹㅣㅂㅡㄷㅔㄴㅓㅁ	moʎʎibɯdenʌm
ㅅㅏㅁㅇㅕㅂㄱㅣ	sʰamjʌp̚ki
ㅇㅠㄱㅅㅜ	juksu
ㄱㅓㅁㅇㅡㄴㅁㅓㄹㅣㅎㅢㄴㄸㅏㅇㅗㄱㅣ	kʌmɯnmʌɾiʝintaoɡi
ᆫㅈㅣ	ɲd͡ʑi
ㄱㅓㄴㄴㅓㅇㅗㄷㅏ	kɘnnʌoda
ㅋㅏㅇㅣㅁㅏㄴ	kʰaiman
ㅍㅡㄹㅗㅍㅣㄹㄹㅔㄴ	pʰɯɾopʰiɭɭen
ㅇㅑㅇㄷㅗㅇㅇㅣ	jaŋdoŋi
ㅊㅗㅇㅇㅏㄹㅇㅕㄹㅊㅏ	t͡ɕʰoŋaɾjʌʎt͡ɕʰa
ㄱㅣㅂㅗㄴㅈㅓㄱ	kiboɲd͡ʑʌk̚
ㅂㅜㄺㅇㅡㄴㄱㅣ	puɭɡɯnɡi
ㅂㅏㄹㄱㅕㄴ	paɭɡjʌn
ㅌㅏㄹㅈㅜㅈㅏ	tʰaʎt͡ɕud͡ʑa
ㅁㅔㅅㅌㅗㄲㅣ	met̚tʰoki
ㅅㅣㄴㅊㅓㅇㅈㅏ	ɕʰiɲt͡ɕʰʌŋd͡ʑa
ㅁㅕㅇㅎㅏㅁ	mjʌŋɦam
ㅍㅕㄴㅇㅏㄴㅎㅏㄷㅏ	pʰjʌnanɦada
ㄸㅏㄹㄱㅣ	taɭɡi
ㅇㅏㅁㅔㄹㅣㅋㅏㅎㅗㅇㅁㅓㄹㅣㅇㅗㄹㅣ	ameɾikʰaβoŋmʌɾioɾi
ㅈㅜㄱㅓ	t͡ɕuɡʌ
ㅇㅏㅁㅅㅓㄱ	amsʰʌk̚
ㅅㅓㅇㅆㅣ	sʰɘŋɕi
ㅅㅣㅁㅣㄴ	ɕʰimin
ㄱㅕㄱㅇㅓㄴ	kjʌɡʌn
ㅅㅓㅇㅈㅓㄴㅎㅘㄴ	sʰɘŋd͡ʑʌnβwan
ㅂㅣㄴㅣㄹ	piniɭ
ㄴㅏㄹㅁㅏㅇㄷㅜㄱ	naɭmaŋduk̚
ㅅㅔㅇㅝㅈㅣㄷㅏ	sʰewʌd͡ʑida
ㅇㅏㄹㄷㅔㅎㅏㅇㅣㄷㅡ	aɭdeɦaidɯ
ㅇㅕㅇㅇㅜㅇ	jʌŋuŋ
ㄹㅏㅂㅔㄹ	ɾabeɭ
ㅂㅏㄱㅔㅌㅡ	paɡetʰɯ
ㄱㅏㅅㅗㄹㄹㅣㄴ	kasʰoʎʎin
ㅅㅣㄹㅈㅓㅇ	ɕʰiʎt͡ɕʌŋ
ㅋㅏㅍㅔ	kapʰe
ㅇㅔㅅㅡㅌㅗㄴㅣㅇㅏ	esʰɯtʰonia
ㄱㅗㅇㅂㅜㅎㅏㄷㅏ	koŋbuɦada
ㅅㅜㄹㅌㅏㄴ	sʰuɭtʰan
ㄷㅏㄱㅓㄷㅏ	taɡʌda
ㅁㅏㄹㅆㅡㅁㅎㅏㄷㅏ	maɭsɯmɦada
ㅍㅜㄴㅏㅍㅜㅌㅣ	pʰunapʰutʰi
ㅇㅏㄹㅇㅏㅂㅗㄷㅏ	aɾaboda
ㄹㅠㄱ	ɾjuk̚
ㅂㅏㄹㅗ	paɾo
ㄱㅜㅇㅣㅈㅓㅇㅜ	kuid͡ʑʌu
ㄹㅣㅌㅠㅁ	ɾitʰjum
ㅅㅡㄹㄹㅗㅂㅔㄴㅣㅇㅏㅇㅓ	sʰɯɭɭobeniaʌ
ㄱㅜㅇㄹㅠㅇ	kuŋɲjuŋ
ㅂㅏㅇㅇㅕㅇ	paŋjʌŋ
ㅍㅣㄹㅅㅜ	pʰiɭsʰu
ㅋㅡㄹㄹㅓㅂ	kxɯɭɭʌp̚
ㅂㅡㄹㅣㅈㅣ	pɯɾid͡ʑi
ㅈㅓㄴㄱㅘㄴㅇㅖㅇㅜ	t͡ɕʌnɡwanɲjeu
ㅂㅜㄹㅡㅈㅛㅇㅏ	puɾɯd͡ʑoa
ㅎㅡㄱㄱㅣㅅㅏ	xɯk̚kisʰa
ㅈㅏㄹㅈㅏㄹㅁㅗㅅ	t͡ɕaʎd͡ʑaɭmot̚
ㄱㅗㄱㅘㄴ	koɡwan
ㅇㅗㅎㅏㅇㅣㅇㅗ	oɦaio
ㅍㅓㅁㅍㅡ	pʰʌmpʰɯ
ㅂㅗㄱㅅㅓㅁ	poksʌm
ㅅㅜㅅㅏㅇ	sʰusʰaŋ
ㅁㅏㅈㅎㅡㅇㅈㅓㅇ	matʰɯŋd͡ʑʌŋ
ㅅㅏㅇㅛㅇㄷㅚㄷㅏ	sʰajoŋdweda
ㅁㅗㅅㅔ	mosʰe
ㅇㅖㅇㅑㄱㅎㅏㄷㅏ	jejakʰada
ㅈㅣㅁㅈㅏㄱ	t͡ɕimd͡ʑak̚
ㅅㅣㄴㅅㅓㅇㅎㅏㄷㅏ	ɕʰinsʰʌŋɦada
ㅇㅟㅂㅏㄴ	ɥiban
ㅇㅖㅋㅏㅌㅔㄹㅣㄴㅂㅜㄹㅡㅋㅡ	jekʰatʰeɾinbuɾɯkxɯ
ㄱㅐㄹㅑㅇ	kɛɾjaŋ
ㄱㅜㄷㄷㅏ	kut̚ta
ㅇㅣㅎㅗㄴㅎㅏㄷㅏ	iβonɦada
ㄷㅗㄹㄹㅣㄷㅏ	toʎʎida
ㅅㅜㅇㅇㅓ	sʰuŋʌ
ㅇㅑㅇㅂㅏㄴ	jaŋban
ㅇㅕㄷㅏㄷㄷㅏ	jɘdat̚ta
ㅋㅏㅁㅂㅗㄷㅣㅇㅏ	kʰambodia
ㅅㅣㄴㅈㅜ	ɕʰiɲd͡ʑu
ㅅㅣㄱㅏㄴ	ɕʰiɡan
ㅎㅘㅎㅏㄱㅈㅓㄴㄷㅏㄹㅁㅜㄹㅈㅣㄹ	ɸwaɦak̚t͡ɕʌndaɭmuʎt͡ɕiɭ
ㄷㅡㄹㅇㅓㄱㅏㄷㅏ	tɯɾʌɡada
ㅇㅡㅁㄷㅗㄱ	ɯmdok̚
ㅅㅜㄴㄱㅏㄴ	sʰunɡan
ㅍㅣㅇㅏㄴㅣㅅㅡㅌㅡ	pʰianisʰɯtʰɯ
ㄱㅗㄹㅣ	koɾi
ㄱㅜㅎㅗㄱㅡㅁ	kuβoɡɯm
ㅌㅚㅂㅣ	tʰwebi
ㄷㅏㄹ	taɭ
ㅈㅗㅈ	t͡ɕot̚
ㅈㅓㅇㅈㅣㄱㅎㅏㄷㅏ	t͡ɕɘŋd͡ʑikʰada
ㄱㅘㅇㅇㅝㄴ	kwaŋwʌn
ㄱㅜㄷㅜㅅㅚ	kudusʰwe
ㅈㅗㅇㄹㅛ	t͡ɕoŋɲjo
ㅍㅗㄷㅗㄷㅏㅇ	pʰododaŋ
ㄴㅜㄷㄷㅏ	nut̚ta
ㅈㅏㄴㅔㄷㅡㄹ	t͡ɕanedɯɭ
ㅂㅏㄴㄷㅗ	pando
ㅁㅏㅇㅡㅁ	maɯm
ㅇㅑㄱㅅㅣㄹ	jakɕiɭ
ㅎㅏㄴㅌㅔ	hantʰe
ㅅㅣㅂㅏㅇ	ɕʰibaŋ
ㄷㅜㅈㅜㄹㅁㅏㅇㄷㅜㄱ	tud͡ʑuɭmaŋduk̚
ㅃㅜㄴ	pun
ㅍㅏㄴㄱㅕㄹ	pʰanɡjʌɭ
ㅈㅔㄹ	t͡ɕeɭ
ㄴㅏㅇㅇㅣㄴ	naŋin
ㅈㅣㅅㄷㅏ	t͡ɕit̚ta
ㅅㅣㄴㄴㅏㄷㅏ	ɕʰinnada
ㅇㅏㄹㅡㅂㅏㅇㅣㅌㅡ	aɾɯbaitʰɯ
ㅇㅡㄴㅇㅕㄴㅇㅓ	ɯnɲjʌnʌ
ㄱㅏㅁㅂㅣㅇㅏ	kambia
ㅎㅏㅇㅣㄷㅡㄹㅏㅈㅣㄴ	haidɯɾad͡ʑin
ㅊㅓㅇㅁㅓㄹㅣㅇㅗㄹㅣ	t͡ɕʰʌŋmʌɾioɾi
ㅅㅔㄱㅡㅁ	sʰeɡɯm
ㅇㅐㅂㅓㄹㄹㅔ	ɛbʌɭɭe
ㅅㅣㅈㅏㅇㅎㅏㅅㅣㄷㅏ	ɕʰid͡ʑaŋɦaɕʰida
ㅅㅓㄹㅡㄴ	sʰʌɾɯn
ㅋㅏㄹㅏㄴ	kʰaɾan
ㅋㅗㄴㅅㅔㄴㅌㅡ	kʰonsʰentʰɯ
ㄴㅗㄱㅇㅡㅁㅅㅣㄹ	noɡɯmɕʰiɭ
ㅅㅓㅇㅖ	sʰʌje
ㄱㅕㅇㄱㅣ	kjɘŋɡi
ㅅㅏㅊㅏㅇ	sʰat͡ɕʰaŋ
ㄷㅏㄺㄱㅗㄱㅣ	tak̚koɡi
ㅇㅣㄹㅊㅣㅎㅏㄷㅏ	iʎt͡ɕʰiɦada
ㄱㅏㅊㅣ	kat͡ɕʰi
ㅇㅣㄴㄹㅕㄱ	iʎʎjʌk̚
ㄱㅏㄹㅋㅟ	kaɭkʰɥi
ㅁㅗㄱㅈㅓㄴ	mok̚t͡ɕʌn
ㄴㅏㄱㅏㄷㅏ	naɡada
ㅇㅕㅂㄹㅗㄱㅊㅔ	jʌmnok̚t͡ɕʰe
ㅅㅓㄴㅍㅜㅇㄱㅣ	sʰʌnpʰuŋɡi
ㄱㅛㄹㅣ	kjoɾi
ㅇㅏㅁㅅㅗ	amsʰo
ㅇㅑㅇㅂㅗㄱ	jaŋbok̚
ㅊㅏㅇㄴㅕ	t͡ɕʰaŋɲjʌ
ㅊㅏㅅㅁㅜㄹ	t͡ɕʰanmuɭ
ㄱㅣㅁ	kim
ㄱㅡㄴㅔㄷㅡㄹ	kɯnedɯɭ
ㅌㅗㅊㅣㅋㅏ	tʰot͡ɕʰikʰa
ㅂㅜㄹㄱㅣ	puɭɡi
ㅊㅗㅅㅣㅁㄹㅣㅎㅏㄱ	t͡ɕʰoɕʰimniɦak̚
ㄷㅗㄹㅅㅗㅌ	toɭsʰot̚
ㄷㅐㅎㅏㄷㅏ	tɛɦada
ㅁㅏㄷㅏ	mada
ㅄ	pjʌŋɕʰin
ㅍㅗㄹㄷㅓ	pʰoɭdʌ
ㅁㅏㅁ	mam
ㅈㅓㅂ	t͡ɕʌp̚
ㅇㅗㄱㅅㅣㅌㅗㅅㅣㄴ	okɕitʰoɕʰin
ㅇㅏㄷㅗㅇ	adoŋ
ㅇㅓㅈㅔㅅㅂㅏㅁ	ʌd͡ʑet̚pam
ㅋㅡㄹㅣㅂㅌㅗㄴ	kxɯɾip̚tʰon
ㄱㅟㅅㄱㅜㅁㅓㅇ	kɥit̚kumʌŋ
ㅇㅕㄴㄱㅜㅎㅏㄷㅏ	jɘnɡuɦada
ㄴㅏㅁㅍㅕㄴ	nampʰjʌn
ㅉㅣㄴㅁㅏㄴㄷㅜ	t͡ɕinmandu
ㄷㅡㄹㅊㅣㄱㅣ	tɯʎt͡ɕʰiɡi
ㄷㅐㄹㅠㄱㅂㅏㅌㅈㅟ	tɛɾjuk̚pat̚t͡ɕɥi
ㅇㅡㅁㅇㅏㄱㄱㅏ	ɯmak̚ka
ㄴㅏㅁㅁㅏㄴ	namman
ㄱㅡㅁㅇㅕㄴ	kɯmjʌn
ㅁㅜㄹㄹㅔ	muɭɭe
ㅊㅗㅇㅡㄴㅎㅏㄷㅏㄴ	t͡ɕʰoɯnɦadan
ㄷㅐㅇㅟ	tɛɥi
ㄱㅛㅇㅠㄱㅎㅏㄷㅏ	kjojukʰada
ㅂㅡㄹㅏㅈㅣㄹㄹㅣㅇㅏ	pɯɾad͡ʑiʎʎia
ㅈㅔㄴㅔㅂㅏ	t͡ɕeneba
ㅇㅏㄱㅅㅜ	aksu
ㅇㅗ	o
ㅊㅜㄹㅊㅜㄹㅎㅏㄷㅏ	t͡ɕʰuʎt͡ɕʰuɾɦada
ㅅㅓㅂㅓㄹ	sʰʌbʌɭ
ㅍㅏㄹㄱㅡㄱㄱㅝㄴ	pʰaɭɡɯk̚kwʌn
ㅊㅣㄱ	t͡ɕʰik̚
ㅂㅏㄹㅅㅏ	paɭsa
ㅁㅓㄱ	mʌk̚
ㅂㅣㅇㅜㄷㅏ	piuda
ㅅㅗㄴㅈㅏ	sʰoɲd͡ʑa
ㅇㅘㅇㅣㅍㅡ	waipʰɯ
ㅅㅔㄱㅖㄱㅘㄴ	sʰeɡjeɡwan
ㄷㅜㄷㅓㅈㅣ	tudʌd͡ʑi
ㅇㅣㅂㄷㅏ	ip̚ta
ㅈㅓㅈㄲㅗㄱㅈㅣ	t͡ɕʌt̚kok̚t͡ɕi
ㅅㅜㅈㅣㄹ	sʰud͡ʑiɭ
ㄱㅏㅁㅏㄴㄱㅏㅁㅏㄴ	kamanɡaman
ㅅㅜㅍㅕㅇ	sʰupʰjʌŋ
ㄱㅜㄱㅁㅣㄴ	kuŋmin
ㅅㅏㄹㅗㅈㅏㅂㄷㅏ	sʰaɾod͡ʑap̚ta
ㅈㅔㅊㅜㄹㅎㅏㄷㅏ	t͡ɕet͡ɕʰuɾɦada
ㅂㅜㄴㅍㅗ	punpʰo
ㅈㅣㄹㅂㅕㅇ	t͡ɕiɭbjʌŋ
ㅇㅜㄷㅗ	udo
ㄴㅟㅇㅜㅊㅣㄷㅏ	nɥiut͡ɕʰida
ㄱㅜㄱㅅㅣ	kukɕi
ㅅㅣㄴㅈㅗㅇ	ɕʰiɲd͡ʑoŋ
ㅈㅜㅇㄱㅜㄱㅁㅏㄹ	t͡ɕuŋɡuŋmaɭ
ㅍㅗㅎㅚㄱㅎㅏㄷㅏ	pʰoβwekʰada
ㄱㅣㄱㅘㄴㅊㅏ	kiɡwaɲt͡ɕʰa
ㄱㅗㄹㄱㅕㄱ	koɭɡjʌk̚
ㄲㅏㅁㅏㄱㅟ	kamaɡɥi
ㅁㅛㅁㅣ	mjomi
ㅂㅏㄹㅍㅛ	paɭpʰjo
ㅋㅏㄴ	kʰan
ㅂㅜㄹㅓㄸㅡㄹㅣㄷㅏ	puɾʌtɯɾida
ㅁㅜㄷㄷㅏ	mut̚ta
ㅈㅏㅈㄷㅏ	t͡ɕat̚ta
ㄲㅡㅀㅇㅣㄷㅏ	kɯɾida
ㅂㅗㄴㄱㅕㄱㅈㅓㄱ	ponkjʌk̚t͡ɕʌk̚
ㅌㅏㅎㅕㅂㅎㅏㄷㅏ	tʰaʝjʌpʰada
ㅎㅏㄱㅂㅜ	hak̚pu
ㅂㅜㄴ	pun
ㅇㅣㅅㅏㅇㅏㄱ	isʰaak̚
ㅇㅡㄹㅗ	ɯɾo
ㅊㅗㄴㄴㅗㅁ	t͡ɕʰonnom
ㅅㅗㅊㅗㅇ	sʰot͡ɕʰoŋ
ㄱㅏㄷㅜㄹㅣ	kaduɾi
ㄱㅏㅇㄱㅜㄷㅏ	kaŋɡuda
ᆫㄷㅏ	nda
ㅂㅜㄱ	puk̚
ㅊㅓㄴㄷㅗ	t͡ɕʰɘndo
ㄷㅏㄴㄹㅏㄱ	taɭɭak̚
ㅇㅔㅊㅟ	et͡ɕʰɥi
ㅅㅓㅇㅁㅜㄴ	sʰʌŋmun
ㅋㅏㅁㅔㄹㄹㅔㅇㅗㄴ	kʰameɭɭeon
ㅁㅏㅋㅔㅌㅣㅇ	makʰetʰiŋ
ㄱㅓㄹㅍㅡㄹㅔㄴㄷㅡ	kʌɭpʰɯɾendɯ
ㄴㅗㅇㅣㄴㅂㅕㅇㅎㅏㄱ	noinbjʌŋɦak̚
ㄷㅗㅇㅁㅜㄹㅇㅝㄴ	toŋmuɾwʌn
ㅅㅏㅎㅑㅇ	sʰaʝjaŋ
ㄱㅡㄱㅔ	kɯɡe
ㅈㅏㄱㄱㅗㄱㅈㅏ	t͡ɕak̚kok̚t͡ɕa
ㅂㅜㄴㅌㅏㅇㅈㅣㄹ	puntʰaŋd͡ʑiɭ
ㅎㅏㅂㅊㅔ	hap̚t͡ɕʰe
ㄱㅏ	ka
ㅁㅏㅌㄱㅣㄷㅏ	mat̚kida
ㄱㅏㄱㅡㅁ	kaɡɯm
ㄷㅣㅅㅡㅍㅡㄹㄹㅔㅇㅣ	tisʰɯpʰɯɭɭei
ㄴㅐㅇㅈㅏㅇㄱㅗ	nɛŋd͡ʑaŋɡo
ㄷㅗㅇㅈㅓㄴ	toŋd͡ʑʌn
ㄷㅗㄴㄱㅏㅅㅡ	tonɡasʰɯ
ㄴㅗㅇㅎㅏㄱ	noŋɦak̚
ㄱㅗㅇㅍㅗ	koŋpʰo
ㅇㅠㅊㅣㅇㅝㄴ	jut͡ɕʰiwʌn
ㅂㅏㅇㅈㅓㅁ	paŋt͡ɕʌm
ㅈㅣㅂㅇㅏㄴ	t͡ɕiban
ㄱㅏㅁㅁㅏ	kamma
ㅍㅛㅈㅜㄴㅇㅓ	pʰjod͡ʑunʌ
ㅇㅝㄴㄹㅛ	wʌʎʎjo
ㅂㅔㅍㅡ	pepʰɯ
ㅊㅜㄹㄱㅜ	t͡ɕʰuɭɡu
ㅇㅖㄴㅣㄹㄱㅗㅂ	jeniɭɡop̚
ㄸㅣㄷㅏ	tida
ㅇㅏㄹㅍㅏㅂㅔㅅ	aɭpʰabet̚
ㅇㅗㄴㅡㄹ	onɯɭ
ㅅㅏㄴㅅㅣ	sʰanɕʰi
ㄱㅔㅇㅣㅁ	keim
ㅎㅗㅅㅡ	ɸʷosʰɯ
ㄱㅗㅁㅜㄹ	komuɭ
ㅇㅣㅊㅔㅈㅏ	it͡ɕʰed͡ʑa
ㄷㅏㅋㅡㅅㅓㅋㅡㄹ	takxɯsʌkxɯɭ
ㄷㅡㄹㅏㅇㅣㅂㅡㅎㅏㄷㅏ	tɯɾaibɯɦada
ㅅㅗㄲㅜㅂ	sʰokup̚
ㅈㅗㄹㅣ	t͡ɕoɾi
ㅅㅡㅇㅈㅣㄴ	sʰɯŋd͡ʑin
ㅇㅓㅇㅕㅃㅡㄷㅏ	ʌjʌpɯda
ㄴㅏㄹㅆㅣㄴㅎㅏㄷㅏ	naɭɕinɦada
ㅈㅣㅍㄷㅏ	t͡ɕip̚ta
ㅍㅗㅈㅏㅇ	pʰod͡ʑaŋ
ㅇㅗㄱㅁㅜㄴ	oŋmun
ㅇㅣㄹㅇㅓㄴㅏㄹㅏ	iɾʌnaɾa
ㄷㅏㄴㅣㄷㅏ	tanida
ㄱㅡㄴㅎㅖ	kɯnʝje
ㅅㅏㄴㅑㅇㅎㅏㄷㅏ	sʰaɲjaŋɦada
ㅍㅓㅇ	pʰʌŋ
ㅊㅏㄹㅑㅇ	t͡ɕʰaɾjaŋ
ㅂㅜㄴㅇㅟㄱㅣ	punɥiɡi
ㅎㅡㅂㅇㅕㄴ	xɯbjʌn
ㄷㅗㅁㅏㅇㅊㅣㄷㅏ	tomaŋt͡ɕʰida
ㅅㅏㄴㅅㅏㄹㅂㅏㄷㅗㄹㅡ	sʰansʰaɭbadoɾɯ
ㅈㅗㅇㅑㄱㄷㅗㄹ	t͡ɕojak̚toɭ
ㅂㅗㅇㅌㅜ	poŋtʰu
ㄱㅏㅂㄱㅏㄱ	kap̚kak̚
ㅈㅜ	t͡ɕu
ㄱㅏㅂㅈㅏㄱㅣ	kap̚t͡ɕaɡi
ㅇㅕㄱㄱㅕㅇ	jʌk̚kjʌŋ
ㅈㅡㄹㄱㅣㄷㅏ	t͡ɕɯɭɡida
ㅇㅠㅈㅣㅎㅏㄷㅏ	jud͡ʑiɦada
ㅂㅏㄲㅗㄹㅏㄱ	pakoɾak̚
ㅇㅐㅇㅣㄴ	ɛin
ㅈㅏㅇㅅㅣㄱ	t͡ɕaŋɕʰik̚
ㄱㅣㅇㅝㄴㅈㅓㄴ	kiwʌɲd͡ʑʌn
ㅇㅗㅇㅝㄹ	owʌɭ
ㅇㅓㄷㄷㅏ	ɘt̚ta
ㅎㅏㅅㅜㄱㅈㅣㅂ	hasʰuk̚t͡ɕip̚
ㅍㅡㄹㅣㅌㅗㄹㅣㅇㅏ	pʰɯɾitʰoɾia
ㅈㅓㄴㅇㅓ	t͡ɕɘnʌ
ㅇㅟㄱㅡㄹㅁㅏㄹ	ɥiɡɯɭmaɭ
ㅂㅐㅅㅣㄴ	pɛɕʰin
ㄱㅗㅇㄱㅜㄴ	koŋɡun
ㄱㅜㄱㅕㅇㅎㅏㄷㅏ	kuɡjʌŋɦada
ㅋㅗㅇ	kʰoŋ
ㅅㅡㅇㅁㅜㅇㅝㄴ	sʰɯŋmuwʌn
ㄲㅗㅊㄱㅏㄹㅜ	kot̚kaɾu
ㄱㅓㅁㅊㅏㄹ	kɘmt͡ɕʰaɭ
ㅇㅠㄷㅗ	judo
ㅇㅣㅇㅓㅍㅗㄴ	iʌpʰon
ㅂㅗㄷㅏ	poda
ㅅㅜㄴㅂㅏㄱㅎㅏㄷㅏ	sʰunbakʰada
ㅁㅣㅅㅡㅌㅓ	misʰɯtʰʌ
ㄱㅜㄱㄱㅗ	kuk̚ko
ㄱㅡㄹㅓㅎㅏㄷㅏ	kɯɾʌɦada
ㅎㅏㅈㅣㅁㅏㄴ	had͡ʑiman
ㅁㅜㄹㅕㅂ	muɾjʌp̚
ㄷㅡㅇ	tɯŋ
ㄱㅟㅅㅣㄴ	kɥiɕʰin
ㅇㅠㄹㅏㅅㅣㅇㅏ	juɾaɕʰia
ㄷㅏㄹㄹㅕㅇㅗㄷㅏ	taʎʎjʌoda
ㄱㅏㅁㅈㅏ	kamd͡ʑa
ㅈㅔㅈㅏㄱ	t͡ɕed͡ʑak̚
ㅈㅏㄷㅜㄴㅏㅁㅜ	t͡ɕadunamu
ㅂㅏㅇㅣㅇㅗㄹㄹㅣㄴ	paioʎʎin
ㄷㅝ	twɘ
ㄱㅣㄴㅣㅂㅣㅅㅏㅇㅜ	kinibisʰau
ㅈㅡㅇㅈㅣㄴㅎㅏㄷㅏ	t͡ɕɯŋd͡ʑinɦada
ㄱㅗㅇㄹㅛㅇ	koŋɲjoŋ
ㅍㅗㄷㅡㄱㅗㄹㅣㅊㅏ	pʰodɯɡoɾit͡ɕʰa
ㅇㅑㅁㅊㅏ	jamt͡ɕʰa
ㅍㅏㄷㅗ	pʰado
ㅂㅏㅋㅟㅂㅓㄹㄹㅔ	pakʰɥibʌɭɭe
ㅂㅜㄹㅡㅅㅣㅁ	puɾɯɕʰim
ㅎㅏㅇㄹㅗ	haŋno
ㅃㅜㄹ	puɭ
ㅎㅘㄹ	ɸwaɭ
ㅂㅏㅈㅣ	pad͡ʑi
ㅂㅕㅇㅇㅝㄴ	pjɘŋwʌn
ㄱㅏㄴㅏ	kana
ㅂㅣㄹㅛ	piɾjo
ㅃㅕㅈ	pjʌt̚
ㄱㅐㅈㅓㅇ	kɛd͡ʑʌŋ
ㅇㅛㄱㅏ	joɡa
ㅅㅏㅈㅓㄴ	sʰad͡ʑʌn
ㄹㅔㅍㅓㅌㅗㄹㅣ	ɾepʰʌtʰoɾi
ㅇㅗㄹㅡㄴㅅㅗㄴㅈㅏㅂㅇㅣ	oɾɯnsʰoɲd͡ʑabi
ㅅㅗㅊㅣ	sot͡ɕʰi
ㄱㅡㄹㅏㅍㅡ	kɯɾapʰɯ
ㅍㅏㄴㅍㅏㄴㅎㅏㄷㅏ	pʰanpʰanɦada
ㅈㅣㄹㄹㅣㄷㅏ	t͡ɕiʎʎida
ㅅㅡㄹㅏㅅㅗㄴㅣ	sʰɯɾasʰoni
ㄱㅓㄴㅈㅗㅎㅏㄷㅏ	kʌɲd͡ʑoɦada
ㅅㅜㅎㅏㅁㅜㄹ	sʰuɦamuɭ
ㄱㅜㅇㄱㅡㄱㅈㅓㄱ	kuŋɡɯk̚t͡ɕʌk̚
ㅋㅗㄴㅂㅣㅍㅡ	kʰonbipʰɯ
ㅇㅣㅁㅣㄴ	imin
ㄱㅘㅇㅈㅜ	kwaŋd͡ʑu
ㄱㅗㅅㅜ	kosʰu
ㅎㅘㄱㅏㅇㅇㅏㅁ	ɸwaɡaŋam
ㅊㅜㄱㅜㅎㅏㄷㅏ	t͡ɕʰuɡuɦada
ㄴㅝ	nwɘ
ㄸㅔㄱ	tek̚
ㅇㅢㅎㅏㄷㅏ	ɰiɦada
ㅁㅏㄴㅈㅜㅇㅓ	maɲd͡ʑuʌ
ㅂㅗㄱㅈㅏㅇ	pok̚t͡ɕaŋ
ㅇㅑㅋㅜㅈㅏ	jakʰud͡ʑa
ㅁㅗㅊㅜㅇ	mot͡ɕʰuŋ
ㅌㅣㄴㅇㅔㅇㅣㅈㅓ	tʰineid͡ʑʌ
ㅇㅣㅅㅏㅇ	isʰaŋ
ㄱㅜㄱㅕㅇㄱㅜㄴ	kuɡjʌŋɡun
ㅎㅏㄴㅈㅏ	haɲt͡ɕa
ㄴㅜㄴㄷㅗㅇㅈㅏ	nundoŋd͡ʑa
ㄱㅕㄹㅅㅏㅇㅗㅇㅇㅟ	kjʌɭsaoŋɥi
ㅈㅓㅇㄱㅓㅈㅏㅇ	t͡ɕʌŋɡʌd͡ʑaŋ
ㅇㅏㄱㄷㅏㅁ	ak̚tam
ㅇㅣㅌㅡㄷㄴㅏㄹ	itʰɯnnaɭ
ㄷㅚㄴㅅㅗㄹㅣ	twensʰoɾi
ㅅㅣㅅㅏㅇ	ɕʰisʰaŋ
ㅈㅗㄹㅣ	t͡ɕoɾi
ㅂㅜㄹㅈㅣㄹㅡㄷㅏ	puʎd͡ʑiɾɯda
ㅇㅏㅋㅘㄹㅣㅇㅜㅁ	akʰwaɾium
ㄱㅣㄷㄷㅏ	kit̚ta
ㄲㅘㄹㅣ	kwaɾi
ㄱㅔㅅㅏㄴㅣ	kesʰani
ㅊㅓㄹㅂㅏㅂㅌㅗㅇ	t͡ɕʰʌɭbap̚tʰoŋ
ㅅㅓㅇㅝㄹ	sʰʌwʌɭ
ㄱㅜㅂㄷㅏ	kup̚ta
ㅂㅏㄹㅏㅂㅗㄷㅏ	paɾaboda
ㅁㅏㅅㅜㄹ	masʰuɭ
ㅁㅕㄴㄷㅗㅎㅏㄷㅏ	mjɘndoɦada
ㅎㅏㅌㅡ	hatʰɯ
ㅁㅔㅂㅆㅏㄹ	mepsaɭ
ㅇㅗㅀㄷㅏ	oɭtʰa
ㅊㅏㅂㅜㄴㅂㅓㅂ	t͡ɕʰabunbʌp̚
ㅈㅏㅇㅂㅗㄷㅏ	t͡ɕaŋboda
ㅊㅓㄱㅊㅜ	t͡ɕʰʌk̚t͡ɕʰu
ㅈㅣㄹㅡㄷㅏ	t͡ɕiɾɯda
ㅅㅓㄱㅅㅜㄴ	sʰʌksun
ㅈㅜㅇㅅㅣㅁㄷㅏㄻㅇㅡㅁ	t͡ɕuŋɕʰimdaɭmɯm
ㄱㅠㅅㅗㅅㅜㅈㅣ	kjusʰosʰud͡ʑi
ㅁㅣㄴㅣㅂㅓㅅㅡ	minibʌsʰɯ
ㄷㅏㅇㅇㅕㄴ	taŋjʌn
ㄷㅏㄴㅅㅜㄴ	tansʰun
ㄹㅏㄴㅣ	ɾani
ㄷㅓㅂㅡㄴㅠㅁ	tʌbɯɲjum
ㄷㅡㅇㅎㅓㄹㅣ	tɯŋɦʌɾi
ㅇㅑㅇㄹㅗㅇㅝㄴ	jaŋnowʌn
ㄱㅏㅌㅇㅣㅎㅏㄷㅏ	kat͡ɕʰiɦada
ㄷㅏㄴㅊㅓㄴ	taɲt͡ɕʰʌn
ㅍㅕㄴㄹㅣㄴ	pʰjʌʎʎin
ㅂㅏㄴㅏㄷㅠㅁ	panadjum
ㄱㅓㅁㅣㅈㅜㄹ	kʌmid͡ʑuɭ
ㅇㅣㅉㅗㄱ	it͡ɕok̚
ㅂㅏㄴㅇㅕㅇ	paɲjʌŋ
ㄴㅏㅁㅍㅗ	nampʰo
ㄱㅘㅁㄷㅗ	kwamdo
ㅅㅗㄴㅏㄱㅂㅣ	sʰonak̚pi
ㅁㅜㅊㅓㄱ	mut͡ɕʰʌk̚
ㅂㅗㄱㅈㅣ	pok̚t͡ɕi
ㄷㅏㄹㅏㄱㄱㅏㅌㄷㅏ	taɾak̚kat̚ta
ㄱㅜㄹㅡㅁ	kuɾɯm
ㅈㅗㅂㄷㅏ	t͡ɕop̚ta
ㄱㅕㅇ	kjɘŋ
ㅂㅏㄹㄱㅕㄴㅎㅏㄷㅏ	paɭɡjʌnɦada
ㅈㅓㄴㅂㅜ	t͡ɕʌnbu
ㄱㅘㄴㄹㅕㄴㅅㅓㅇ	kwaʎʎjʌnsʌŋ
ㅎㅡㅇㅂㅜㄴㅎㅏㄷㅏ	xɯŋbunɦada
ㅂㅔㄷㅡㄹㅗ	pedɯɾo
ㄱㅏㄹㅇㅗㅅ	kaɾot̚
ㅁㅜ	mu
ㅁㅣㄷㅏㄷㅇㅣㅁㅜㄴ	midadimun
ㅇㅣㅇㅑ	ija
ㅎㅏㄴㄱㅏㅇㅜㄴㄷㅔ	hanɡaunde
ㅌㅗㅇㅊㅣㅎㅏㄷㅏ	tʰoŋt͡ɕʰiɦada
ㅊㅜㄹㅏㄱ	t͡ɕʰuɾak̚
ㅈㅏㄱㅡㄹㅔㅂㅡ	t͡ɕaɡɯɾebɯ
ㅅㅓㄴㅅㅜ	sʰɘnsʰu
ㄱㅣㅎㅜ	kiβu
ㅌㅏㅈㅣㅋㅡㅇㅓ	tʰad͡ʑikxɯʌ
ㅊㅏㅁㄱㅗㅅㅓ	t͡ɕʰamɡosʰʌ
ㄱㅗㄹㅕㅁㅏㄹ	koɾjʌmaɭ
ㅅㅓㅇㄱㅏ	sʰɘŋɡa
ㅈㅏㅇㄱㅏㅂ	t͡ɕaŋɡap̚
ㅎㅘㄱㅅㅓㅇㄱㅣ	ɸwaksʌŋɡi
ㅁㅣㄴㅈㅜㅈㅜㅇㅢ	miɲd͡ʑud͡ʑuɰi
ㅇㅗㅅㅡㄹㄹㅗ	osʰɯɭɭo
ㅎㅗㄱㅣㅅㅣㅁ	ɸʷoɡiɕʰim
ㅎㅡㄲ	xɯk̚
ㅇㅣㄸㅏㄱㅏ	itaɡa
ㅂㅜㄹㅎㅕㄴㄷㅡㅅ	puɾʝjʌndɯt̚
ㅂㅓㅌㅓ	pʌtʰʌ
ㅅㅗㅇㅡㅁㅅㅜㄴ	sʰoɯmsʰun
ㅔ	e
ㄲㅡㄹㅣ	kɯɾi
ㅇㅜㄴㅜㄴㅎㅔㄱㅅㅠㅁ	ununɦekɕum
ㄱㅘㄴㅁㅗㄱ	kwanmok̚
ㅁㅕㅇㅁㅕㅇㅎㅏㄷㅏ	mjɘŋmjʌŋɦada
ㄷㅗㅇ	toŋ
ㄱㅛㅎㅑㅇㄱㅗㄱ	kjoʝjaŋɡok̚
ㄱㅡㄹㅜㅂ	kɯɾup̚
ㅍㅜㄹ	pʰuɭ
ㅇㅕㅎㅗㅇㅘ	jʌβowa
ㄱㅣㄷㅏㄹㅣㄷㅏ	kidaɾida
ㄱㅏㅅㅓㄹ	kasʰʌɭ
ㅅㅚㅎㅘㅇㅈㅗㄹㅗㅇㅇㅣ	sʰweβwaŋd͡ʑoɾoŋi
ㅊㅣㅁㅂㅓㅁ	t͡ɕʰimbʌm
ㅁㅐ	mɛ
ㅋㅜㅇ	kʰuŋ
ㅂㅏㅇㄱㅘㅇㅇㅕㅁ	paŋɡwaŋɲjʌm
ㅅㅡㅁㅜㄹ	sʰɯmuɭ
ㄱㅏㅇㅟ	kaɥi
ㅅㅣㅅㅏㅇㅎㅏㅂㅜ	ɕʰisʰaŋhabu
ㄷㅡㄹㅣㄷㅏ	tɯɾida
ㅋㅗㅇㅛㅌㅔ	kʰojotʰe
ㅋㅏㄷㅡ	kʰadɯ
ㅍㅛㅈㅔ	pʰjod͡ʑe
ㅂㅜㄹㅇㅏㄹ	puɾaɭ
ㅁㅗㅅㅣㄷㅏ	moɕʰida
ㄲㅗㅊㄷㅏㅂㅏㄹ	kot̚tabaɭ
ㅆㅓㄱㄷㅏ	sʌk̚ta
ㅂㅕㄹㅏㅇ	pjʌɾaŋ
ㅈㅟㅁㅕㄴㅡㄹㅣ	t͡ɕɥimjʌnɯɾi
ㅁㅜㅈㅗㄱㅓㄴ	mud͡ʑokʌn
ㅁㅣㄴㅁㅜㄹㄱㅓㅁㅈㅓㅇㅁㅏㅇㄷㅜㄱ	minmuɭɡʌmd͡ʑʌŋmaŋduk̚
ㅅㅜㅇㅝㄴ	sʰuwʌn
ㅊㅓㄴㅊㅔ	t͡ɕʰʌɲt͡ɕʰe
ㄷㅟㅂㅗㄷㅏ	tɥiboda
ㅅㅡㅍㅗㅇㅣㄹㄹㅓ	sɯpʰoiɭɭʌ
ㅌㅗㅅㅡㅌㅡ	tʰosʰɯtʰɯ
ㄱㅜㄴㄷㅗ	kundo
ㅊㅓㅅ	t͡ɕʰʌt̚
ㅊㅚㅊㅗ	t͡ɕʰwet͡ɕʰo
ㄱㅏㅁㅅㅏㅎㅏㄷㅏ	kamsʰaɦada
ㅈㅗㅅㅣㅁㅎㅏㄷㅏ	t͡ɕoɕʰimɦada
ㅅㅣㄹㅣㄷㅏ	ɕʰiɾida
ㅂㅏㅇㅅㅣㄱ	paŋɕʰik̚
ㄴㅜㄹㅣㄷㅏ	nuɾida
ㅅㅣㄹㄹㅕㄱ	ɕʰiʎʎjʌk̚
ㄱㅣㅎㅏㅁ	kiɦam
ㅇㅢㅈㅏㅇ	ɰid͡ʑaŋ
ㄹㅏㅇㅜㅌㅓ	ɾautʰʌ
ㅅㅣㄹㅈㅔ	ɕʰiʎt͡ɕe
ㅁㅔㅇㅏㄹㅣ	meaɾi
ㄷㅡㄹ	tɯɭ
ㅎㅓㄷㅜㅇㅈㅣㄷㅜㅇ	hʌduŋd͡ʑiduŋ
ㅍㅗ	pʰo
ㅂㅣㅇㅅㅏㄴ	piŋsʰan
ㅁㅏㄴㅣ	mani
ㅅㅏㅌㅏㄴㄱㅛ	sʰatʰanɡjo
ㄱㅡㄹㅣㅇㅜㅁ	kɯɾium
ㅇㅟㅇㅝㄴㅎㅚ	ɥiwʌnβwe
ㅍㅡㄹㄹㅓㅅㅡ	pʰɯɭɭʌsʰɯ
ㄱㅏㅁㄹㅣㄱㅛ	kamniɡjo
ㄹㅓㄱㅂㅣ	ɾʌk̚pi
ㅇㅜㅇㅕㄴ	ujʌn
ㅌㅏㄹㅊㅜㄹㄱㅣ	tʰaʎt͡ɕʰuɭɡi
ㄸㅟㄷㅏ	tɥida
ㅇㅜㅈㅜㄹㅗㄴ	ud͡ʑuɾon
ㅂㅏㄹㄷㅟㄲㅜㅁ	paɭtɥikum
ㅇㅖㅅㄴㅏㄹㅇㅣㅇㅑㄱㅣ	jennaʎʎijaɡi
ㅇㅏㄱㅅㅡㅂ	aksɯp̚
ㅇㅛㄷㅗ	jodo
ㅌㅗㄹㅡ	tʰoɾɯ
ㄷㅏㄷㅏㅁㅣ	tadami
ㅇㅏㅂㄷㅗㅎㅏㄷㅏ	ap̚toɦada
ㅍㅕㄷㅏ	pʰjʌda
ㅇㅐㅁㅜ	ɛmu
ㄴㅗㅂㅕㅇ	nobjʌŋ
ㅈㅏㄱㅇㅛㅇ	t͡ɕaɡjoŋ
ㅈㅓㅈㅣㄹㅡㄷㅏ	t͡ɕʌd͡ʑiɾɯda
ㅎㅔㄷㅡㅍㅗㄴ	hedɯpʰon
ㄱㅣㅂㅏㄴ	kiban
ㄱㅛㅍㅕㄴ	kjopʰjʌn
ㅊㅜㄴㅈㅓㄹ	t͡ɕʰuɲd͡ʑʌɭ
ㅇㅕㅅㅣㄴ	jʌɕʰin
ㅇㅔㅇㅓㅋㅜㅅㅕㄴ	eʌkʰuɕʰʌn
ㄸㅡㄷㄱㅣ	tɯt̚ki
ㅈㅓㅈㄱㅏㄱㅗㅇㅍㅜㅁ	t͡ɕʌt̚kaɡoŋpʰum
ㅍㅣㄴㅅㅔㅅ	pʰinsʰet̚
ㅂㅗㄸㅏㄹㅣ	potaɾi
ㄴㅔ	ne
ㅌㅗㅇㅎㅏㅂ	tʰoŋɦap̚
ㅇㅑㄱㅅㅏ	jaksa
ㅊㅏㅇㅈㅔ	t͡ɕʰaŋd͡ʑe
ㄱㅗㅇㅑㅇㅇㅣ	kojaŋi
ㅂㅣㅅㄷㅏ	pit̚ta
ㄱㅓㄲㅜㄹㅗ	kʌkuɾo
ㄱㅣㄷㅏㄹㅏㅎㄷㅏ	kidaɾatʰa
ㅅㅔㅌㅏㄱㄱㅣ	sʰetʰak̚ki
ㄷㅏㅀㄷㅏ	taɭtʰa
ㅇㅜㄴㄷㅗㅇㅎㅏㄷㅏ	undoŋɦada
ㄴㅜㅇㅔ	nue
ㅇㅣㅁㅅㅣㄴㅎㅏㄷㅏ	imɕʰinɦada
ㅈㅓㄴㄷㅏㅇㅍㅗ	t͡ɕɘndaŋpʰo
ㅇㅘㅅㅕ	waɕʰʌ
ㄱㅗㅇㅁㅣㄴ	koŋmin
ㄴㅐㅇㅛㅇ	nɛjoŋ
ㄱㅏㄴㅈㅏㅇ	kaɲd͡ʑaŋ
ㅈㅓㅂㄷㅜㅅㅏ	t͡ɕʌp̚tusʰa
ㅎㅏㄴㅡㄹㄷㅏㄹㅏㅁㅈㅟ	hanɯɭdaɾamd͡ʑɥi
ㄱㅏㄹㅂㅣㅌㅏㅇ	kaɭbitʰaŋ
ㅇㅓㅈㅣㄹㅓㅂㄷㅏ	ʌd͡ʑiɾʌp̚ta
ㅈㅏㅅㅏㄹ	t͡ɕasʰaɭ
ㅇㅏㅇㅋㅏㄹㅏ	aŋkʰaɾa
ㄷㅏㄴㄴㅕㅁ	tanɲjʌm
ㅅㅓㅇㅁㅏㅇ	sʰɘŋmaŋ
ㄷㅚㅊㅏㅈㄷㅏ	twet͡ɕʰat̚ta
ㅈㅗㅅㅓㄴㅇㅗㅅ	t͡ɕosʰʌnot̚
ㅞ	we
ㅅㅗㅇㅠㅁㅜㄹ	sʰojumuɭ
ㄴㅏㄹㅋㅏㄹㅗㅂㄷㅏ	naɭkʰaɾop̚ta
ㄷㅚㅇㄱㅕㅇㅁㅗㅊㅣ	tweŋɡjʌŋmot͡ɕʰi
ㄱㅣㅅㅓㄴ	kisʰʌn
ㅁㅕㄹㅅㅣ	mjʌɭɕʰi
ㅂㅏㄹㅗㄱㅏㄱㅣ	paɾoɡaɡi
ㅎㅏㅅㄹㅏㅇㅣㄴ	hannain
ㅅㅏㄴㅂㅗ	sʰanbo
ㄱㅏㅇㅈㅔ	kaŋd͡ʑe
ㅈㅗㅇㄱㅜㄱ	t͡ɕoŋɡuk̚
ㅁㅏㄴㅇㅓㄱ	manʌk̚
ㅂㅏㅇㅎㅑㅇ	paŋʝjaŋ
ㄱㅟ	kɥi
ㅈㅏㅈㅏㅇㅁㅕㄴ	t͡ɕad͡ʑaŋmjʌn
ㅅㅓㅅㅜㄹㅎㅏㄷㅏ	sʰɘsʰuɾɦada
ㄴㅖ	ɲje
ㅈㅣㄴㄹㅣ	t͡ɕiʎʎi
ㅇㅑㄱㅎㅗㄴㄴㅕ	jakʰonɲjʌ
ㅎㅚㄱㅖㅅㅏ	ɸweɡjesʰa
ㅅㅏㅇㅣㄴㅎㅏㄷㅏ	sʰainɦada
ㅇㅓㅇㄱㅓㅂㄱㅕㄹㅇㅔ	ʌŋɡʌp̚kjʌɾe
ㅇㅣㄴㄱㅗㅇ	inɡoŋ
ㄲㅏㅌㅏㄹㅡ	katʰaɾɯ
ㅋㅗㅁㅂㅏㅇㅣㄴ	kʰombain
ㄱㅕㅇㄱㅖㅎㅏㄷㅏ	kjɘŋɡjeɦada
ㅍㅣㄹㅏㅁㅣㄷㅡ	pʰiɾamidɯ
ㅈㅗㄴㅈㅜㅇㅎㅏㄷㅏ	t͡ɕoɲd͡ʑuŋɦada
ㅂㅔㅇㅣㅈㅣㅇ	peid͡ʑiŋ
ㅅㅓㄲㅇㅣㄷㅏ	sʰʌkida
ㅅㅗㅂㅏㄴ	sʰoban
ㅇㅏㄴㅑ	aɲja
ㄲㅏㄹㅔㄹㄹㅣㅇㅑ	kaɾeʎʎija
ㅂㅔㄱㅌㅓ	pek̚tʰʌ
ㅂㅏㅇㅁㅏㅇㅇㅣ	paŋmaŋi
ㄷㅏㅁㅜㄱㅈㅏㅇㅇㅓ	tamuk̚t͡ɕaŋʌ
ㅈㅓㅇㅇㅕㄱㅎㅏㄱ	t͡ɕʌŋɲjʌkʰak̚
ㅅㅗㅈㅔㅎㅏㄷㅏ	sʰod͡ʑeɦada
ㅇㅣㄹㅓㅎㄷㅏ	iɾʌtʰa
ㅁㅗㄱㅁㅏ	moŋma
ㄷㅐㄹㅠㄱ	tɛɾjuk̚
ㄷㅗㄱㅅㅓ	toksʌ
ㅁㅏㅇㅡㅁㅆㅡㄷㅏ	maɯmsɯda
ㅂㅣㅅㄱㅣㄷㅏ	pit̚kida
ㄱㅘㅇㅚ	kwawe
ㄲㅏㅁㅓㄱㄷㅏ	kamʌk̚ta
ㅅㅜㄹㅗ	sʰuɾo
ㅁㅕㅇㅅㅏ	mjʌŋsʰa
ㅂㅕㅇㄱㅣㅊㅏㅇ	pjʌŋɡit͡ɕʰaŋ
ㅂㅜㄴㄹㅣ	puʎʎi
ㅊㅜㅁㅣㄹㅇㅝㄴ	t͡ɕʰumiɾwʌn
ㅈㅏㅈㅓㄴ	t͡ɕad͡ʑʌn
ㅁㅣㅈㅏㅇㅇㅝㄴ	mid͡ʑaŋwʌn
ㄱㅡㄹㅣㅇㅝㅎㅏㄷㅏ	kɯɾiwʌɦada
ㅅㅏㅇㅈㅓㅁ	sʰaŋd͡ʑʌm
ㅊㅓㄴㅅㅏㄴㄱㅏㅂ	t͡ɕʰɘnsʰanɡap̚
ㅁㅣㄹㅣㅂㅗㄱㅣ	miɾiboɡi
ㅂㅗㅇㄱㅓㄴ	poŋɡʌn
ㅅㅡㅌㅡㄹㅔㅅㅡ	sʰɯtʰɯɾesɯ
ㅎㅏㄱㄱㅛ	hak̚kjo
ㅇㅏㅂㅔㅋㅡ	abekxɯ
ㄱㅏㅁㅏㄴㅎㅣ	kamanʝi
ㅁㅏㄹㄷㅏ	maɭda
ㅋㅔㅇㅣㄱ	kʰeik̚
ㄱㅏㄹㄲㅏㅁㅏㄱㅟ	kaɭkamaɡɥi
ㅈㅜㅇㅅㅔ	t͡ɕuŋsʰe
ㅇㅡㅁㅇㅕㄱㅈㅏ	ɯmjʌk̚t͡ɕa
ㅇㅚㄱㅖㅇㅓ	weɡjeʌ
ㅂㅗㄱㅁㅜ	poŋmu
ㅍㅕㄴㅂㅗㄱ	pʰjʌnbok̚
ㅇㅑㅎㅏㄷㅏ	jaɦada
ㅇㅑㅇㅁㅏㄹ	jaŋmaɭ
ㄱㅏㅁㅜㅁ	kamum
ㅍㅔㅇㅣㅈㅣ	pʰeid͡ʑi
ㅇㅗㅅㄱㅓㄹㅇㅣ	ot̚kʌɾi
ㄴㅘㄷㅜㄷㅏ	nwaduda
ㅇㅣㄹㅇㅛㅇㅣㄹ	iɾjoiɭ
ㄱㅜㄱㅜㄹㅁㅜㅊㅣ	kuɡuɭmut͡ɕʰi
ㅎㅗㅈㅜㅁㅓㄴㅣ	ɸʷod͡ʑumʌni
ㄱㅡㅁ	kɯm
ㄷㅗㅁㅏㅇ	tomaŋ
ㅇㅏㅈㅔㄹㅡㅂㅏㅇㅣㅈㅏㄴ	ad͡ʑeɾɯbaid͡ʑan
ㅊㅗㅂㅏㄴ	t͡ɕʰoban
ㄱㅏㅁㅏ	kama
ㅁㅗㄴㅣㅌㅓ	monitʰʌ
ㅂㅜㄹㅆㅏㅇㅎㅏㄷㅏ	puɭsaŋɦada
ㅍㅗㄱ	pʰok̚
ㅈㅜㅇㅅㅜㄴ	t͡ɕuŋsʰun
ㄱㅣㅊㅔ	kit͡ɕʰe
ㅅㅡㅋㅔㅈㅜㄹ	sʰɯkʰed͡ʑuɭ
ㅅㅏㄹㄹㅗㅇ	sʰaɭɭoŋ
ㄷㅡㅅㅎㅏㄷㅏ	tɯtʰada
ㅎㅘㅅㅣㄴ	ɸwaɕʰin
ㄱㅏㅅㅓㄹ	kasʰʌɭ
ㄱㅗㅈ	kot̚
ㅇㅣㄱㅛㄷㅗ	iɡjodo
ㅊㅏㄷㅡ	t͡ɕʰadɯ
ㅎㅜㅇ	ɸʷuŋ
ㅋㅡㄴㅁㅏㄹㄸㅗㅇㄱㅏㄹㅣ	kxɯnmaɭtoŋɡaɾi
ㅂㅏㄹㄲㅜㅁㅊㅣ	paɭkumt͡ɕʰi
ㅅㅡㅌㅔㄹㅗㅇㅣㄷㅡ	sʰɯtʰeɾoidɯ
ㄷㅓㄹㅓㅇㅝㅈㅣㄷㅏ	tɘɾʌwʌd͡ʑida
ㅅㅣㄴㅅㅜ	ɕʰinsʰu
ㅁㅏㄹㅂㅓㄹ	maɭbʌɭ
ㄹㅡㅇ	ɾɯŋ
ㅁㅏㅅㅡㄷㅏ	masʰɯda
ㄱㅏㅇㅓㄴㅈㅓㄱ	kaʌɲd͡ʑʌk̚
ㅍㅣㄹㅣ	pʰiɾi
ㅎㅘㅈㅔㅎㅏㄴㅇㅓ	ɸwad͡ʑeɦanʌ
ㄷㅗㅅㅣㄹㅏㄱ	toɕʰiɾak̚
ㅈㅓㄴㅈㅣ	t͡ɕɘɲd͡ʑi
ㅅㅣㄱㅁㅣㄴㅈㅜㅇㅢ	ɕʰiŋmiɲd͡ʑuɰi
ㅋㅗㅅㅁㅜㄹ	kʰonmuɭ
ㄱㅗㅇㅏㅇㅝㄴ	koawʌn
ㅃㅔㄷ	pet̚
ㅍㅜㅇㅈㅏㅁㅜㄴ	pʰuŋd͡ʑamun
ㅇㅚㅁㅗㅇㄱㅗ	wemoŋɡo
ㅂㅣㄴㄴㅛ	pinɲjo
ㅈㅔㅇㅏㄴㅎㅏㄷㅏ	t͡ɕeanɦada
ㅌㅏㄹ	tʰaɭ
ㅈㅜㄷㅜㅇㅊㅣ	t͡ɕuduŋt͡ɕʰi
ㄴㅡㅈㅈㅏㅁ	nɯt̚t͡ɕam
ㄱㅘㅇㄷㅗㅇㅇㅓ	kwaŋdoŋʌ
ㅇㅕㅇㅅㅓㅇㅊㅔ	jɘŋsʰʌŋt͡ɕʰe
ㄷㅏㅊㅣㄷㅏ	tat͡ɕʰida
ㅅㅏㅇㅜㄷㅣㅇㅏㄹㅏㅂㅣㅇㅏ	sʰaudiaɾabia
ㅈㅜㅇㄱㅜㄱㅎㅘ	t͡ɕuŋɡukʰwa
ㅇㅑㅇㅈㅗㅈㅏㅇ	jaŋd͡ʑod͡ʑaŋ
ㅅㅡㅍㅔㅇㅣㄴㅇㅓ	sʰɯpʰeinʌ
ㅎㅗㄱㅅㅣ	ɸʷokɕi
ㅂㅜㄴㄱㅘㅇㅎㅏㄱ	punɡwaŋɦak̚
ㄱㅗㅇㄱㅡㅂ	koŋɡɯp̚
ㄱㅕㅇㅇㅡㅁㄱㅣ	kjʌŋɯmɡi
ㅆㅡㅊㅘㄴ	sɯt͡ɕʰwan
ㄱㅜㅅㅓㄱㅊㅏㄱㅣ	kusʰʌk̚t͡ɕʰaɡi
ㅈㅜㅁㅣㄴ	t͡ɕumin
ㅇㅗㄹㄹㅕㄴㅗㅎㄷㅏ	oʎʎjʌnotʰa
ㅇㅕㅇㅜㅇㅝㄴㅅㅜㅇㅇㅣ	jʌuwʌnsʰuŋi
ㅇㅗㄻㄷㅏ	omta
ㅆㅏㅇㅈㅣㅇㅡㅈ	saŋd͡ʑiɯt̚
ㅅㅣㅁㄷㅏ	ɕʰimta
ㄱㅏㄹㄱㅕㄴㅣ	kaɭɡjʌni
ㅇㅗㄻㅇㅏㅇㅗㄷㅏ	oɭmaoda
ㅇㅣㄴㅊㅔ	iɲt͡ɕʰe
ㄱㅗㅅㄱㅗㅅ	kot̚kot̚
ㄱㅘㄴㄱㅖ	kwanɡje
ㅍㅡㄹㄹㅓㄱㅡ	pʰɯɭɭʌɡɯ
ㅇㅓㄹㅣㄴㅇㅣ	ʌɾini
ㅌㅣㅂㅔㄹㅣㅇㅜㅅㅡ	tʰibeɾiusʰɯ
ㅂㅜㄹㄲㅗㅊ	puɭkot̚
ㄱㅏㅅㅓㄹㅂㅓㅂ	kasʰʌɭpʌp̚
ㅊㅗㅇㅎㅘ	t͡ɕʰoŋβwa
ㅅㅣㄱㅌㅏㄱㅂㅗ	ɕʰik̚tʰak̚po
ㅎㅓㅇㄱㅏㄹㅣㅇㅓ	hʌŋɡaɾiʌ
ㅇㅓㅂㅅㅗ	ʌpso
ㅇㅕㄴㅍㅣㄹ	jʌnpʰiɭ
ㅈㅔㄷㅗㄱ	t͡ɕedok̚
ㄱㅜㅂㅜㄴ	kubun
ㅅㅏㅁㅅㅓㅇ	sʰamsʰʌŋ
ㅆㅏㅇㅜㄹㅇㅏㅂㅣ	sauɾabi
ㅂㅔㄹㅂㅔㅅ	peɭbet̚
ㄸㅏㄹㅏㅎㅏㄷㅏ	taɾaɦada
ㅅㅜㅋㅓㅅ	sʰukʰʌt̚
ㅅㅓㅂㅓ	sʌbʌ
ㅋㅡㄴㄴㅏㅅ	kxɯnnat̚
ㅅㅓㄴㄱㅡㄹㄹㅏㅅㅡ	sʰʌnɡɯɭɭasʰɯ
ㅅㅣㄱㅏㄱ	ɕʰiɡak̚
ㅇㅘㄴㅂㅕㄱㅎㅏㄷㅏ	wanbjʌkʰada
ㄱㅗㅇㅗㄴ	koon
ㅅㅡㅂ	sʰɯp̚
ㅎㅐㄱㅗ	hɛɡo
ㄹㅏㅎㅏㄴ	ɾaɦan
ㅁㅜㄱㅔ	muɡe
ㅅㅜㅈㅓㄱ	sʰut͡ɕʌk̚
ㄱㅓㄴㄱㅏㅇㅎㅏㄷㅏ	kɘnɡaŋɦada
ㄴㅗㄱ	nok̚
ㅁㅏㅇㅣㅋㅡ	maikxɯ
ㅇㅝㄴㅌㅗㅇ	wʌntʰoŋ
ㄴㅏㄱㅡㄴㅔ	naɡɯne
ㅍㅟㄿ	pʰɥip̚
ㅈㅣㅍㅏㅇㅇㅣ	t͡ɕipʰaŋi
ㄴㅓㄷㅓㅅ	nʌdʌt̚
ㅍㅜㄹㅍㅏㅇㅝ	pʰuɭpʰawʌ
ㅎㅏㄴㅌㅏㄴㅎㅏㄷㅏ	hantʰanɦada
ㅎㅘㅇㅈㅔ	ɸwaŋd͡ʑe
ㅅㅜㅎㅏㄱ	sʰuɦak̚
ㅇㅣㄹㅜㄷㅏ	iɾuda
ㄱㅕㅇㅎㅓㅁㅎㅏㄷㅏ	kjʌŋɦʌmɦada
ㄱㅏㄱㄷㅏㄱㅟ	kak̚taɡɥi
ㅍㅕㅇㅇㅝㄴ	pʰjʌŋwʌn
ㅂㅏㄹㅗㅈㅏㅂㄷㅏ	paɾod͡ʑap̚ta
ㅅㅣㄴㅈㅗㅇㅓ	ɕʰiɲd͡ʑoʌ
ㅇㅓㄹㅉㅏㅇ	ʌʎt͡ɕaŋ
ㅇㅜㄴㅈㅓㄴㅎㅏㄷㅏ	uɲd͡ʑʌnɦada
ㅅㅣㅁㅈㅓㅇ	ɕʰimd͡ʑʌŋ
ㄱㅘㄷㅡㄹㄹㅜㅍㅡ	kwadɯɭɭupʰɯ
ㅇㅏㄹㅋㅏㅇㅣㄴ	aɭkʰain
ㅇㅏㄹㄹㅜㅁㅣㄴㅠㅁ	aɭɭumiɲjum
ㅈㅓㄴㄹㅏㄴㅏㅁㄷㅗ	t͡ɕʌɭɭanamdo
ㅇㅓㄹㄱㅜㄹㅂㅣㅊ	ʌɭɡuɭpit̚
ㅅㅓㅇㄱㅏㅅㅣㄷㅏ	sʰʌŋɡaɕʰida
ㅇㅡㄴㅈㅏㅁㅔㄴㅏ	ɯɲd͡ʑamena
ㄴㅏㅁㅜㄲㅓㅂㅈㅣㄹ	namukʌp̚t͡ɕiɭ
ㅇㅜㄴㄷㅗㅇㅎㅘ	undoŋβwa
ㅈㅟㄷㅏ	t͡ɕɥida
ㅂㅕㅇㅍㅜㅇ	pjʌŋpʰuŋ
ㅈㅓㄴㄱㅜㄱ	t͡ɕɘnɡuk̚
ㄱㅓㄱㅣ	kʌɡi
ㅇㅣㅇㅂㅜ	iŋbu
ㅇㅗㄱㅏㄷㅏ	oɡada
ㅎㅏㅂㅊㅏㅇ	hap̚t͡ɕʰaŋ
ㅋㅟㄴㅗㄱㅅㅏㄹㄹㅣㄴ	kʰɥinoksaʎʎin
ㄹㅣㅁㅗㄴㅔㄴ	ɾimonen
ㅎㅏㄴㅈㅜㅇ	haɲd͡ʑuŋ
ㅅㅔㄹㅕㄱ	sʰeɾjʌk̚
ㄹㅗㅋㅔㅅ	ɾokʰet̚
ㅇㅑㄱㅎㅗㄴㅈㅏ	jakʰoɲd͡ʑa
ㄱㅣㄷㅗㄱㄱㅛㄷㅗ	kidok̚kjodo
ㅌㅏㅁㅅㅏ	tʰamsʰa
ㅈㅣㄴㅏㄴㅈㅜ	t͡ɕinaɲd͡ʑu
ㄱㅗㅇㅈㅜㅂㅕㅇ	koŋd͡ʑupjʌŋ
ㅎㅜㄱㅣ	ɸʷuɡi
ㅇㅓㄹㄹㅡㄴ	ʌɭɭɯn
ㄱㅏㅇㅇㅢ	kaŋɰi
ㅌㅔㄹㅓ	tʰeɾʌ
ㅎㅡㅂ	xɯp̚
ㅈㅔㅈㅏㄱㅎㅏㄷㅏ	t͡ɕed͡ʑakʰada
ㅍㅡㄹㄹㅔㄹㅗㅂㅠㅁ	pʰɯɭɭeɾobjum
ㄷㅗㄹ	toɭ
ㄱㅣㅊㅗㅇ	kit͡ɕʰoŋ
ㄱㅏㄲㅡㅁ	kakɯm
ㅁㅣㅅㅗ	misʰo
ㄴㅐㅇㅚ	nɛwe
ㅂㅏㄴㅈㅏㅇ	paɲd͡ʑaŋ
ㄱㅘㄴㅅㅡㅂ	kwansʰɯp̚
ㅂㅗㅅㅏㅇ	posʰaŋ
ㅈㅣㄹㅡㅁ	t͡ɕiɾɯm
ㅂㅏㄱㅗㄴ	paɡon
ㅇㅖㅅㅜㄴ	jesʰun
ㅇㅣㅌㅡㄹㅠㅁ	itʰɯɾjum
ㄱㅕㄹㅜㄷㅏ	kjʌɾuda
ㄱㅓㄴㄴㅓㄹㅁㅗㄱ	kɘnnʌɭmok̚
ㄷㅏㅈㅣㄷㅏ	tad͡ʑida
ㅈㅏㅇㄹㅡ	t͡ɕaŋnɯ
ㅈㅓㄱㄷㅗ	t͡ɕʌk̚to
ㅍㅜㅇㅅㅓㄴ	pʰuŋsʰʌn
ㄱㅚㄹㅗㅇㅜㅁ	kweɾoum
ㅁㅗㄴㅌㅔㄴㅔㄱㅡㄹㅗ	montʰeneɡɯɾo
ㅁㅕㄴㅇㅑㅇ	mjʌɲjaŋ
ㅈㅓㄱㅡㅁ	t͡ɕɘɡɯm
ㅇㅢㅎㅑㅇ	ɰiʝjaŋ
ㅇㅏㄹㅏㅅㅏ	aɾasʰa
ㄴㅏㄱㅟ	naɡɥi
ㅈㅓㄴㅕㄱㄴㅗㄹ	t͡ɕʌɲjʌŋnoɭ
ㅈㅏㄱㅡㄱ	t͡ɕaɡɯk̚
ㄴㅏㅁㅅㅓㅇㅈㅜㅇㅇㅡㅁ	namsʰʌŋd͡ʑuŋɯm
ㅅㅓㄲㄷㅏ	sʰʌk̚ta
ㅈㅜㅇㅇㅓㄹㄱㅓㄹㅣㄷㅏ	t͡ɕuŋʌɭɡʌɾida
ㅅㅜㄴㅅㅜㅎㅏㄷㅏ	sʰunsʰuɦada
ㅋㅗㅅㅡㅍㅡㄹㅔ	kʰosʰɯpʰɯɾe
ㅇㅣㅈㅜ	id͡ʑu
ㅊㅏㅁㅂㅜㅇㅇㅓ	t͡ɕʰambuŋʌ
ㅇㅏㄹㅏㅂㅣㅇㅏㅇㅣㄴ	aɾabiain
OK	okʰei
ㅎㅡㄱㄱㅣㄹㅓㄱㅣ	xɯk̚kiɾʌɡi
ㅇㅣㄹㅏㅋㅡ	iɾakxɯ
ㄴㅗㅇㅏㄴ	noan
ㄱㅏㄴㅡㄴㄷㅗㄹㄱㅗㄱㅣ	kanɯndoɭɡoɡi
ㅈㅓㄴㅂㅗㄱ	t͡ɕʌnbok̚
ㅎㅗㄱㄱㅗㄴㅣ	ɸʷok̚koni
ㅌㅏㅁㅎㅓㅁㄱㅏ	tʰamɦʌmɡa
ㄱㅜㄴㅂㅏㄹㅣ	kunbaɾi
ㅌㅗㅇㅑㅇ	tʰojaŋ
ㄱㅗㅇㅠㅁㅕㅇㅅㅏ	kojumjʌŋsʰa
ㅎㅘㄱㅣ	ɸwaɡi
ㄴㅏㄲ	nak̚
ㄱㅗㅁㅜㄴ	komun
ㅇㅗㄱㅅㅏㅇ	oksaŋ
ㅇㅓㄱㅜ	ɘɡu
ㅈㅏㅇㅇㅝㄴ	t͡ɕaŋwʌn
ㅋㅡㄴㄴㅗㄴㅂㅕㅇㅇㅏㄹㅣ	kxɯnnonbjʌŋaɾi
ㅅㅜㅅㅡㅂㅎㅏㄷㅏ	sʰusʰɯpʰada
ㅌㅏㅂㅅㅡㅇㄱㅝㄴ	tʰapsɯŋkwʌn
ㅅㅏㅅㅣㄴ	sʰaɕʰin
ㅈㅗㅇㅎㅚㅇ	t͡ɕoŋβweŋ
ㅍㅕㅇㅇㅣㄹ	pʰjʌŋiɭ
ㅁㅜㄴㅈㅓㄹㅁㅏㅇㄷㅜㄱ	muɲd͡ʑʌɭmaŋduk̚
ㅅㅜㅂㅓㅂ	sʰubʌp̚
ㅇㅢ	ɰi
ㅎㅗㄴㅅㅜ	ɸʷonsʰu
ㄴㅏㅇㅗㄷㅏ	naoda
ㅍㅏㅈㅏㅇ	pʰad͡ʑaŋ
ㄹㅗㅌㅗ	ɾotʰo
ㅁㅕㅊㅁㅕㅊ	mjʌnmjʌt̚
ㅈㅏㅇㄹㅗㄱㅛ	t͡ɕaŋnoɡjo
ㅁㅏㅇㅅㅏㅇ	maŋsʰaŋ
ㄱㅕㄹㅈㅓㅇㅅㅜ	kjʌʎt͡ɕʌŋsʰu
ㅈㅣㄻㄷㅏ	t͡ɕimta
ㅁㅕㅇㄹㅏㄴ	mjʌŋnan
ㅋㅗㄹㅗㄴㅏㅂㅏㅇㅣㄹㅓㅅㅡ	kʰoɾonabaiɾʌsɯ
ㅈㅓㅈㅏㄱㄱㅝㄴ	t͡ɕɘd͡ʑak̚kwʌn
ㄷㅗㄹㅇㅏㅅㅓㄷㅏ	toɾasʰʌda
ㅍㅔㄹㅓㅅ	pʰeɾʌt̚
ㄲㅏㄱㄷㅜㄱㅣ	kak̚tuɡi
ㅁㅗㄹㅡㄷㅏ	moɾɯda
ㅎㅗㄴㅗㄹㄹㅜㄹㄹㅜ	ɸʷonoɭɭuɭɭu
ㅎㅚㅇㅢ	ɸweɰi
ㅇㅝㅅㅣㅇㅌㅓㄴ	wʌɕʰiŋtʰʌn
ㅇㅕㅇㅅㅏㄱㅘㄴ	jʌŋsʰaɡwan
ㄱㅛㅁㅣ	kjomi
ㅈㅜㅅㅏ	t͡ɕusʰa
ㅅㅚㅂㅜㅌㅇㅣ	sʰwebut͡ɕʰi
ㅇㅝㄹㅅㅣㄱ	wʌɭɕik̚
ㅇㅓㄴㅜㄹㅎㅏㄷㅏ	ɘnuɾɦada
ㄹㅣㅁㅜㅈㅣㄴ	ɾimud͡ʑin
ㄴㅏㅎㅏㄴ	naɦan
ㅅㅏㄹ	sʰaɭ
ㄷㅜㅇㅡㅁ	tuɯm
ㅇㅕㄹㅅㅔㅅ	jʌɭset̚
ㅅㅣㄹㅅㅜㅎㅏㄷㅏ	ɕʰiɭsuɦada
ㄹㅗㄹㅔㄴㅅㅠㅁ	ɾoɾenɕʰum
ㅌㅣㅇㅏㅈㅣㄴ	tʰiad͡ʑin
ㅎㅏㄴㅍㅏ	hanpʰa
ㄴㅗㄱㄷㅜㄴㅏㅁㅜㄹ	nok̚tunamuɭ
ㄴㅏㅌ	nat̚
ㄱㅏㅄ	kap̚
ㅎㅗㄹㅅㅡㅌㅓ	ɸʷoɭsʰɯtʰʌ
ㄱㅣㅂ	kip̚
ㅅㅏㅇㅎㅘㅇ	sʰaŋβwaŋ
ㅇㅓㅄㅇㅣ	ɘpɕi
ㅈㅓㄴㅁㅜㄴㅇㅣㄹㄱㅜㄴ	t͡ɕʌnmuniɭɡun
ㅇㅡㅁㅁㅗ	ɯmmo
ㅅㅏㅇㅏㄴ	sʰaan
ㅇㅗㄹㅏㄱ	oɾak̚
ㄹㅔㄴㅈㅡ	ɾeɲd͡ʑɯ
ㅅㅜㅍㄷㅡㄹㅈㅟ	sʰup̚tɯʎd͡ʑɥi
ㅇㅕㄴㅇㅏㄴ	jʌnan
ㅇㅖㅅㅎㅏㄴㄱㅡㄹ	jetʰanɡɯɭ
ㄱㅘㄴㅈㅓㅁ	kwaɲt͡ɕʌm
ㅇㅑㄹㅔ	jaɾe
ㄱㅜㄻㄱㅣㄷㅏ	kumɡida
ㄷㅗㅇㄴㅔ	toŋne
ㅅㅠㅍㅓㅁㅏㅋㅔㅅ	ɕʰupʰʌmakʰet̚
ㅁㅣㄴㅊㅓㅂㅅㅓㅇ	miɲt͡ɕʰʌpsʌŋ
ㄱㅣㅅㅜㄹ	kisʰuɭ
ㄱㅣㅃㅡㄷㅏ	kipɯda
ㅅㅓㅇㅂㅜ	sʰɘŋbu
ㅇㅓㅈㅓㄲㅔ	ʌd͡ʑʌke
ㅂㅏㄴㄷㅡㅅㅇㅣ	pandɯɕʰi
ㅈㅔㅇㅢ	t͡ɕeɰi
ㅇㅏㅇㅣㅅㅡㄹㄹㅏㄴㄷㅡㅇㅓ	aisʰɯɭɭandɯʌ
ㅇㅠㄴㅎㅚ	junβwe
ㅇㅓㄴㅡ	ʌnɯ
ㄴㅏㅁㅊㅔ	namt͡ɕʰe
ㄱㅏㄹㅗ	kaɾo
ㅇㅡㅁㅎㅑㅇ	ɯmʝjaŋ
ㅂㅐㄷㅏㄹ	pɛdaɭ
ㄱㅜㄱㅇㅘㅇ	kuɡwaŋ
ㄱㅣㅅㅣㄱㅏㅁ	kiɕʰiɡam
ㅅㅏㄹㅏㅇㅅㅡㄹㅓㅂㄷㅏ	sʰaɾaŋsʰɯɾʌp̚ta
ㅈㅔㅊㅕㄴㅗㅎㄷㅏ	t͡ɕet͡ɕʰʌnotʰa
ㅇㅓㅁ	ʌm
ㅉㅡㄴㅗㅁ	t͡ɕɯnom
ㅍㅣㄹㅗ	pʰiɾo
ㅇㅑㅇㅅㅣㄱ	jaŋɕʰik̚
ㅇㅚㅊㅜㄹㅎㅏㄷㅏ	wet͡ɕʰuɾɦada
ㄴㅔㅁㅗ	nemo
ㅋㅗㅁㅍㅡㄹㄹㅔㄱㅅㅡ	kʰompʰɯɭɭeksɯ
ㅅㅜㅇㅢㅅㅏ	sʰuɰisʰa
ㄱㅜㄱㅇㅠㅎㅘ	kuɡjuβwa
ㅅㅣㅈㅏㄱ	ɕʰid͡ʑak̚
ㄷㅗㄷㅇㅜㄷㅏ	toduda
ㅂㅕㅇㅇㅏ	pjɘŋa
ㄱㅝㄴㄹㅣ	kwʌʎʎi
ㅊㅜㅈㅣㄴㅎㅏㄷㅏ	t͡ɕʰud͡ʑinɦada
ㅇㅓㄺㄷㅏ	ʌk̚ta
ㅉㅏ	t͡ɕa
ㅇㅣㄹㅇㅝㄹ	iɾwʌɭ
ㄱㅡㅁㅏㄴ	kɯman
ㅇㅕㅇㅇㅝㄴ	jɘŋwʌn
ㄱㅟㅁㅣㅌ	kɥimit̚
ㅇㅗㄹㅂㅏㄹㅡㄷㅏ	oɭbaɾɯda
ㅇㅗㅌㅏㅋㅜ	otʰakʰu
ㅈㅓㄹㅁㅏㅇ	t͡ɕʌɭmaŋ
ㅈㅓㅇㅋㅡㅍㅜㄷㅡ	t͡ɕʌŋkxɯpʰudɯ
ㄱㅏㅈㄷㅏ	kat̚ta
ㅈㅣㅇㅡㅈ	t͡ɕiɯt̚
ㅁㅜㄷㅓㅁ	mudʌm
ㅋㅓㄷㅏㄹㅏㅎㄷㅏ	kʰɘdaɾatʰa
ㄴㅔㅍㅏㄹ	nepʰaɭ
ㅁㅏㄹㄱㅣ	maɭɡi
ㅁㅗㅇㄱㅗㄹ	moŋɡoɭ
ㅃㅜㄹㅣ	puɾi
ㄹㅖ	ɾje
ㅂㅕㄱㄹㅕㄱ	pjʌŋɲjʌk̚
ㅅㅔㅍㅗ	sʰepʰo
ㅍㅔㄴㅣㄹㄱㅣ	pʰeniɭɡi
ㅈㅜㅂㅕㄴ	t͡ɕubjʌn
ㅊㅔㄹㅣ	t͡ɕʰeɾi
ㅇㅜㅅㅡㅇ	usʰɯŋ
ㅈㅣㄴㅅㅣㄹ	t͡ɕinɕʰiɭ
ㄷㅜㄹ	tuɭ
ㄸㅡㄱㅓㅂㄷㅏ	tɯɡʌp̚ta
ㅊㅜㄱㅊㅜㄱㅎㅏㄷㅏ	t͡ɕʰuk̚t͡ɕʰukʰada
ㅇㅏㅊㅓㅁㅎㅏㄷㅏ	at͡ɕʰʌmɦada
ㄷㅡㄱㅈㅓㅁ	tɯk̚t͡ɕʌm
ㄱㅛㅍㅗ	kjopʰo
ㅈㅗㄹㄹㅣㄷㅏ	t͡ɕoʎʎida
ㅃㅕㅋ	pjʌk̚
ㄷㅏ	ta
ㄱㅏㅅㅜ	kasʰu
ㄴㅏㅈㄷㅏ	nat̚ta
ㅂㅏㄱㄹㅏㅁㅎㅚ	paŋnamβwe
ㄴㅗㄴㅎㅏㄷㅏ	nonɦada
ㄱㅗㅇㅌㅗㅇㅈㅓㅁ	koŋtʰoŋt͡ɕʌm
ㅇㅣㄹㅆㅜ	iɭsu
ㅇㅏㅇㅛ	ajo
ㅂㅔㄴㅈㅔㄴ	peɲd͡ʑen
ㅈㅜㅈㅔ	t͡ɕud͡ʑe
ㅇㅕㄱㅘㄱㅣ	jɘɡwaɡi
ㅊㅣㅁㅇㅣㅂ	t͡ɕʰimip̚
ㅇㅟㅅ	ɥit̚
ㅊㅏㄱㅗ	t͡ɕʰaɡo
ㄱㅗㅈㅗ	kod͡ʑo
ㅊㅏㄹㅂㅏㅂ	t͡ɕʰaɭbap̚
ㅇㅡㄴㅇㅓ	ɯnʌ
ㅅㅣㄴㅂㅜㄴㅈㅡㅇ	ɕʰinbuɲt͡ɕɯŋ
ㄴㅡㄺㄷㅏ	nɯk̚ta
ㄱㅜㅈㅗ	kud͡ʑo
ㅇㅚㅅㅣㅁ	weɕʰim
ㅅㅣㅈㅏㅇ	ɕʰid͡ʑaŋ
ㅅㅡㄹㅍㅡㅁ	sʰɯɭpʰɯm
ㅆㅝㅇㅣㄹㅓㅇㅜ	swʌiɾʌu
ㅈㅣㅅㅣㄱㅇㅣㄴ	t͡ɕiɕʰiɡin
ㅁㅕㄴㅎㅓㅈㅡㅇ	mjɘnɦʌt͡ɕɯŋ
ㅂㅐㄱㅕㅇ	pɛɡjʌŋ
ㄷㅏㅇㅁㅕㄴ	taŋmjʌn
ㅌㅡㄹㅓㅅㅡㅌㅡ	tʰɯɾʌsʰɯtʰɯ
ㅋㅏㄴㅏㄹㅣㅇㅏ	kʰanaɾia
ㅎㅡㄷ	xɯt̚
ㅎㅗㅈㅜ	ɸʷod͡ʑu
ㅇㅜㅎㅘ	uβwa
ㅂㅏㄴㅇㅗㄹㄹㅣㅁ	panoʎʎim
ㅇㅠㄱㅍㅣㄹ	juk̚pʰiɭ
ㅂㅗㅁ	pom
ㅇㅕㄱㅅㅏㄱㅏ	jʌksaɡa
ㅂㅜㅇㅕㅎㅏㄷㅏ	pujʌɦada
ㅃㅜㅇㅕㅎㄷㅏ	pujʌtʰa
ㄷㅏㅁㅂㅕㄹㅏㄱ	tampjʌɾak̚
ㅇㅕㅇㅎㅗㄴ	jʌŋβon
ㅌㅔㄹㄹㅜㄹㅠㅁ	tʰeɭɭuɾjum
ㄲㅏㅁㅏㅎㄷㅏ	kamatʰa
ㅇㅏㅇㅜㅅ	aut̚
ㅇㅠㅌㅏㄴ	jutʰan
ㅇㅖㅁㅜㄴ	jemun
ㄷㅜㅂㅏㄹ	tubaɭ
ㅇㅕㄹㄷㅡㅇ	jʌɭdɯŋ
ㄱㅏㅁㅅㅏ	kamsʰa
ㅌㅏㄱㄱㅜ	tʰak̚ku
ㅎㅗㄱㅂㅜㄹㅣㅇㅗㄹㅣ	ɸʷok̚puɾioɾi
ㅁㅣㄴㅅㅗㄱ	minsʰok̚
ㄱㅏㄱㅗㅇ	kaɡoŋ
ㄱㅏㄴㅊㅓㅂ	kaɲt͡ɕʰʌp̚
ㅋㅔㄴㅑ	kʰeɲja
ㅂㅕㄴㅎㅗㅅㅏ	pjɘnβosʰa
ㅊㅣㅇㅓㄹㅣㄷㅓ	t͡ɕʰiʌɾidʌ
ㅌㅐㄷㅗ	tʰɛdo
ㅂㅗㄱㅗㅅㅓ	poɡosʰʌ
ㅁㅗㅌㅓ	motʰʌ
ㅈㅜㅁㅓㄴㅣㅋㅏㄹ	t͡ɕumʌnikʰaɭ
ㅂㅓㅂㄹㅕㅇ	pʌmɲjʌŋ
ㅁㅓㄹㅜ	mʌɾu
ㅇㅛㅊㅜㅇ	jot͡ɕʰuŋ
ㄱㅜㅊㅔㅈㅓㄱ	kut͡ɕʰed͡ʑʌk̚
ㅊㅏㅁㅎㅚ	t͡ɕʰamβwe
ㅌㅡㄹㅗㅇㅣㅋㅏ	tʰɯɾoikʰa
ㄱㅏㅈㅔㄸㅏ	kad͡ʑeta
ㅇㅣㅂㅕㄹ	ibjʌɭ
ㅈㅓㅇㅅㅏㅇㅇㅟ	t͡ɕʌŋsʰaŋɥi
ㄱㅜㄱㅈㅏ	kuk̚t͡ɕa
ㄱㅡㄹㅣㅁㅈㅏ	kɯɾimd͡ʑa
ㅎㅚㅈㅏㅇ	ɸwed͡ʑaŋ
ㅍㅗㄱㅡㄴㅎㅏㄷㅏ	pʰoɡɯnɦada
ㄱㅜㅂㄷㅏ	kup̚ta
ㅊㅕㄷㅏㅂㅗㄷㅏ	t͡ɕʰɘdaboda
ㅈㅓㅇㅈㅏ	t͡ɕʌŋd͡ʑa
ㅊㅏㅁㄱㅗ	t͡ɕʰamɡo
ㅎㅘㅍㅕㅇ	ɸwapʰjʌŋ
ㅈㅓㄴㅅㅣㅎㅏㄷㅏ	t͡ɕɘnɕʰiɦada
ㅇㅣㅌㅓㅂㅠㅁ	itʰʌbjum
ㅊㅓㅇㅊㅓㅂㅈㅏㅇ	t͡ɕʰɘŋt͡ɕʰʌp̚t͡ɕaŋ
ㅂㅕㄱㅈㅏㅇ	pjʌk̚t͡ɕaŋ
ㅅㅗㄱㅅㅗㄱㄷㅡㄹㅇㅣ	sʰoksok̚tɯɾi
ㅅㅓㅇㅌㅏㄴㅈㅓㄹ	sʰɘŋtʰaɲd͡ʑʌɭ
ㄱㅡㄹㅓㅎㅈㅣ	kɯɾʌt͡ɕʰi
ㅇㅣㄱㅓㅅ	iɡʌt̚
ㄷㅜㅇㄱㅡㄹㄷㅏ	tuŋɡɯɭda
ㅇㅛㄱㅡㅁ	joɡɯm
ㅍㅏㄷㅗㅇㅎㅏㅁㅅㅜ	pʰadoŋɦamsʰu
ㅈㅏㄱㅅㅓㅇㅎㅏㄷㅏ	t͡ɕaksʌŋɦada
ㅇㅗㅁㅆㅏㄹ	omsaɭ
ㅌㅗㅇㅊㅣㅇ	tʰoŋt͡ɕʰiŋ
ㅅㅓㅇㅈㅏ	sʰɘŋd͡ʑa
ㄷㅗㅈㅓㅎㅣ	tod͡ʑʌʝi
ㅈㅓㅈㅓㄹㄹㅗ	t͡ɕʌd͡ʑʌɭɭo
ㅈㅣㅎㅖㅅㅓ	t͡ɕiʝjesʰʌ
ㅇㅠㅂㅣㅁㅜㅎㅘㄴ	jubimuβwan
ㄷㅗㄹㅇㅕㄴ	toɾjʌn
ㄱㅘㄸㅔㅁㅏㄹㄹㅏ	kwatemaɭɭa
ㅆㅚㄷㅏ	sweda
ㄴㅏㅁㅅㅓㅂㅜ	namsʰʌbu
ㄱㅡㅁㅅㅗㄱ	kɯmsʰok̚
ㄱㅏㅁㅅㅏㅎㅏㅂㄴㅣㄷㅏ	kamsʰaɦamnida
ㅅㅡㅌㅣㅋㅓ	sʰɯtʰikʰʌ
ㅅㅏㅁㅇㅟㅇㅣㄹㅊㅔ	sʰamɥiiʎt͡ɕʰe
ㅎㅏㄴㄷㅏㅁ	handam
ㄱㅕㅇㅎㅓㅁ	kjʌŋɦʌm
ㅌㅟㄱㅣㄷㅏ	tʰɥiɡida
ㄴㅜㄷㅡㄹ	nudɯɭ
ㅇㅝㄴㅊㅣㄱ	wʌɲt͡ɕʰik̚
ㅇㅚㅇㅏㄷㅡㄹ	weadɯɭ
ㅅㅏㅇㄷㅏㅁ	sʰaŋdam
ㅇㅜㄹㅣㄴㅏㄹㅏ	uɾinaɾa
ㅇㅛㅇㄱㅏㅁ	joŋɡam
ㅇㅝㄹㅅㅔ	wʌɭse
ㅎㅡㄱㄷㅜㄹㅜㅁㅣ	xɯk̚tuɾumi
ㅅㅔㄱㅏㄹㅏㄱㅁㅔㅊㅜㄹㅏㄱㅣ	sʰeɡaɾaŋmet͡ɕʰuɾaɡi
ㅎㅔㄹㅅㅡ	heɭsʰɯ
ㅇㅕㄹㅓ	jʌɾʌ
ㅅㅣㄴㅍㅗ	ɕʰinpʰo
ㅊㅓ	t͡ɕʰʌ
ㄱㅗㄷㅗㄱ	kodok̚
ㅍㅡㄴㅗㅁㅍㅔㄴ	pʰɯnompʰen
ㅇㅣㅈㅓㄴ	id͡ʑʌn
ㅅㅡㅍㅏㄱㅔㅌㅣ	sʰɯpʰaɡetʰi
ㅂㅔㄴㅈㅣㄹㄱㅣ	peɲd͡ʑiɭɡi
ㄱㅣㄷㅗㄱㄱㅛ	kidok̚kjo
ㅇㅑㅇㄱㅜㄱ	jaŋɡuk̚
ㅇㅗㅅㅔㅇㅏㄴㅣㅇㅏ	osʰeania
ㅅㅏㄹㅏㅁ	sʰaɾam
ㅈㅗㅅㅏㄴㅅㅏ	t͡ɕosʰansʰa
ㄹㅏㅊㅣㅁㅂㅏㄴ	ɾat͡ɕʰimban
ㅈㅜㅇㅇㅛㅅㅓㅇ	t͡ɕuŋjosʰʌŋ
ㅊㅏㅇㅁㅜㄴ	t͡ɕʰaŋmun
ㅁㅏㄴㅈㅗㄱㅎㅏㄷㅏ	maɲd͡ʑokʰada
ㄴㅗㅇㅅㅏ	noŋsʰa
ㅅㅟㅂㅅㅏㄹㅣ	ʃʰɥipsaɾi
ㅍㅡㅌㅏㄹㄹㅔㅇㅣㄴ	pʰɯtʰaɭɭein
ㅅㅓㅇㄱㅜ	sʰʌŋku
ㅁㅣㄱㅜㄱㅇㅗㄹㅣ	miɡuɡoɾi
ㅎㅏㄴㅇㅑㅇ	haɲjaŋ
ㄱㅣㅃㅡㅁㅈㅗ	kipɯmd͡ʑo
ㄱㅏㄹㅡㅁ	kaɾɯm
ㄴㅗㅇㅓ	noʌ
ㄹㅓㅅㅣㅇㅏㅇㅓ	ɾʌɕʰiaʌ
ㄱㅜㄱㅎㅚ	kukʰwe
ㅅㅣㄴㅏㄹㅣㅇㅗ	ɕʰinaɾio
ㅈㅔ	t͡ɕe
ㅈㅗㅅㅏ	t͡ɕosʰa
ㅇㅕㄷㅡㄹㅔ	jʌdɯɾe
ㅌㅏㄴㅈㅏㄴㅣㅇㅏ	tʰaɲd͡ʑania
ㄱㅘㄴㄱㅖㅇㅓ	kwanɡjeʌ
ㅂㅚㄷㅏ	pweda
ㅍㅣㅅㅡㅌㅏㅊㅣㅇㅗ	pʰisʰɯtʰat͡ɕʰio
ㅉㅗㄱㅂㅏㄹㅇㅣ	t͡ɕok̚paɾi
ㄱㅓㅁㅈㅡㅇ	kɘmd͡ʑɯŋ
ㅊㅜㅊㅓㄴ	t͡ɕʰut͡ɕʰʌn
ㄷㅏ	ta
ㅊㅏㅁㄱㅏ	t͡ɕʰamɡa
ㄱㅘㅈㅡㅂ	kwad͡ʑɯp̚
ㅇㅖㅅㅣㄱ	jeɕʰik̚
ㅇㅏㄹㄹㅔㄱㅗㄹㅣ	aɭɭeɡoɾi
ㅍㅏㄹㄱㅏㄱ	pʰaɭɡak̚
ㅁㅣㅌ	mit̚
ㅅㅓㅂㅓㅂ	sʰʌbʌp̚
ㅂㅏㅋㅟ	pakʰɥi
ㅇㅕㄹㅎㅘㅎㅏㄱ	jɘɾβwaɦak̚
ㄱㅜㄷㅓㅇㅇㅣ	kudʌŋi
ㅊㅗㅇㄱㅏㄱㄱㅣㅁㅊㅣ	t͡ɕʰoŋɡak̚kimt͡ɕʰi
ㄴㅓㅁㄷㅏ	nɘmta
ㄴㅓㅁㅊㅣㄷㅏ	nɘmt͡ɕʰida
ㅅㅣㅇㅣㄴ	ɕʰiin
ㅅㅓㄴㅎㅘ	sʰʌnβwa
ㅇㅣㄴㄷㅗㄴㅔㅅㅣㅇㅏ	indoneɕʰia
ㅅㅔㄹㄹㅗㅍㅏㄴ	sʰeɭɭopʰan
ㄷㅏㄺㄱㅏㄹㅂㅣ	tak̚kaɭbi
ㅅㅏㄴㅑㅇㄲㅜㄴ	sʰaɲjaŋkun
ㅂㅏㄴㅏㄴㅏ	panana
ㄷㅗㅅㅏㄹㅈㅏㅇ	tosʰaʎt͡ɕaŋ
ㄷㅗㄴㅏㄴ	tonan
ㅂㅣㄱㅗㄹ	piɡoɭ
ㄴㅜㅇㅏㄱㅅㅛㅌㅡ	nuakɕotʰɯ
ㅈㅓㄱㅇㅛㅇㅎㅏㄷㅏ	t͡ɕʌɡjoŋɦada
ㅊㅏㅁㅈㅓㄴ	t͡ɕʰamd͡ʑʌn
ㅇㅏㅅㅣㄹㄱㅣ	aɕʰiɭɡi
ㅇㅗㄱㅌㅏㅂ	ok̚tʰap̚
ㅇㅝㄴㅏㄱ	wʌnak̚
ㅇㅏㅁㅅㅏㄹ	amsʰaɭ
ㅇㅓㅁㄴㅣ	ɘmni
ㅇㅣㅂㅁㅏㅈㅊㅜㄷㅏ	immat̚t͡ɕʰuda
ㄱㅖㄹㅑㅇㄱㅣ	kjeɾjaŋɡi
ㄱㅜㅅㅣㅂ	kuɕʰip̚
ㄱㅏㄹㄱㅗ	kaɭɡo
ㅇㅏㅇㅠ	aju
ㅁㅏㅋㅡ	makxɯ
ㄷㅏㄹㅣ	taɾi
ㅊㅓㄱㅊㅜㄷㅗㅇㅁㅜㄹ	t͡ɕʰʌk̚t͡ɕʰudoŋmuɭ
ㅎㅜㅂㅗ	ɸʷubo
ㄱㅓㅈㅜ	kʌd͡ʑu
ㅈㅗㄴㄱㅕㅇㅎㅏㄷㅏ	t͡ɕonɡjʌŋɦada
ㄹㅣㄱㅡ	ɾiɡɯ
ㄴㅐㅅㅣㅁ	nɛɕʰim
ㅁㅓㅈㅓㄹㅣ	mʌd͡ʑʌɾi
ㅌㅏㄹㅊㅜㄹㅎㅏㄷㅏ	tʰaʎt͡ɕʰuɾɦada
ㅈㅓㄻㄷㅏ	t͡ɕɘmta
ㄱㅏㅈㅓㅇ	kad͡ʑʌŋ
ㄱㅜㄴ	kun
ㅎㅔㄹㅡㅊㅡ	heɾɯt͡ɕʰɯ
ㅈㅓㅅㅡㅇ	t͡ɕʌsʰɯŋ
ㄷㅡㄹㄹㅣㄷㅏ	tɯʎʎida
ㄲㅞㄷㅏ	kweda
ㅁㅓㄹㅉㅓㅇㅎㅏㄷㅏ	mʌʎt͡ɕʌŋɦada
ㅅㅏㄹㅍㅕㅂㅗㄷㅏ	sʰaɭpʰjʌboda
ㅂㅏㄱㅌㅔㄹㅣㅇㅏ	pak̚tʰeɾia
ㅁㅗㅌㅜㅇㅇㅣ	motʰuŋi
ㄲㅣㄷㅏ	kida
ㅇㅕㅇㄷㅗㅈㅏ	jʌŋdod͡ʑa
ㅎㅏㄱㅅㅡㅂ	haksɯp̚
ㅈㅓㅁㅍㅗ	t͡ɕɘmpʰo
ㄱㅕㅇㄱㅗㅎㅏㄷㅏ	kjɘŋɡoɦada
ㅈㅏㄱㅇㅛㅇㅎㅏㄷㅏ	t͡ɕaɡjoŋɦada
ㅂㅡㄹㄹㅏㅇㅜㅅㅡ	pɯɭɭausʰɯ
ㅇㅑㅎㅚ	jaβwe
ㅈㅏㅇㄱㅜㄴ	t͡ɕaŋɡun
ㄸㅏㅁ	tam
ㅂㅓㅉㅣ	pʌt͡ɕi
ㄱㅏㅈㅏ	kad͡ʑa
ㅅㅏㅎㅚㅈㅜㅇㅢ	sʰaβwed͡ʑuɰi
ㅇㅕㄴㄹㅜ	jʌɭɭu
ㅇㅗㅋㅡㄹㅗㅅㅣㅋㅏ	okxɯɾoɕʰikʰa
ㅊㅜㅂㄷㅏ	t͡ɕʰup̚ta
ㅇㅗㅎㅣㄹㅕ	oʝiɾjʌ
ㅇㅜㄷㅗㅇ	udoŋ
ㅊㅜㄹㅎㅕㄹ	t͡ɕʰuɾʝjʌɭ
ㅈㅣㅍㅣㄷㅏ	t͡ɕipʰida
ㅁㅏㅇㅇㅏㅈㅣ	maŋad͡ʑi
ㅂㅗㅅㅣㄴㅌㅏㅇ	poɕʰintʰaŋ
ㄱㅘㅇㅈㅏㅇ	kwaŋd͡ʑaŋ
ㅇㅣㄴㅅㅣㄱㅎㅏㄷㅏ	inɕʰikʰada
ㅅㅓㄹㅎㅘ	sʰʌɾβwa
ㅁㅏㄹㅡㅋㅡㅅㅡㅈㅜㅇㅢ	maɾɯkxɯsʰɯd͡ʑuɰi
ㅇㅜㄹㅓㄹㅡㄷㅏ	uɾʌɾɯda
ㄴㅏㅍㅡㅌㅏ	napʰɯtʰa
ㅊㅔㅍㅗ	t͡ɕʰepʰo
ㅇㅕㅊㅣㄴ	jʌt͡ɕʰin
ㅌㅗㄱㅗ	tʰoɡo
ㅇㅚ	we
ㅈㅣㅅㅗㄱㅈㅓㄱ	t͡ɕisʰok̚t͡ɕʌk̚
ㅢ	ɰi
ㄱㅣㅇㅓㄱㅎㅏㄷㅏ	kiʌkʰada
ㅍㅡㄹㅓㄴㅌㅡ	pʰɯɾʌntʰɯ
ㅋㅏㅂㅏㄹㅔ	kʰabaɾe
ㅊㅣㄴㅅㅓㄴㄷㅗㅅㅣ	t͡ɕʰinsʰʌndoɕʰi
ㅇㅣㄴㅁㅕㅇ	inmjʌŋ
ㅂㅓㄹㄱㅣㄷㅏ	pʌɭɡida
ㅁㅔ	me
ㄱㅡㄹㅍㅣ	kɯɭpʰi
ㅇㅏㄴㅣㅇㅑ	anija
ㄹㅑㄱㅇㅓ	ɾjaɡʌ
ㄱㅏㄹㅏㄱ	kaɾak̚
ㅁㅣㅊㅣㄱㅘㅇㅇㅣ	mit͡ɕʰiɡwaŋi
ㅎㅏㄴㄱㅕㄹㅔ	hanɡjʌɾe
ㅇㅏㄴㅁㅗㄱ	anmok̚
ㄱㅟㅅㄱㅕㄹ	kɥit̚kjʌɭ
ㅇㅏㄹㅕㄴㅎㅣ	aɾjʌnʝi
ㅇㅕㄷㅏㅇ	jɘdaŋ
ㅇㅣㄴㅌㅣㅍㅏㄷㅏ	intʰipʰada
ㅇㅕㄱㅎㅏㄹ	jʌkʰaɭ
ㅍㅗㄹㅡㅌㅜㄱㅏㄹ	pʰoɾɯtʰuɡaɭ
ㅁㅣㄴㄴㅏㅊ	minnat̚
ㅍㅗㄱㅍㅏ	pʰok̚pʰa
ㄱㅣㅇㅏ	kia
ㅌㅏㄹㄹㅠㅁ	tʰaʎʎjum
ㅁㅏㅅㅡㅋㅡ	masʰɯkxɯ
ㅍㅡㄹㅏㅇㅅㅡㅇㅓ	pʰɯɾaŋsʰɯʌ
ㅌㅣㄹㅏㄴㅗㅅㅏㅇㅜㄹㅜㅅㅡ	tʰiɾanosʰauɾusʰɯ
ㅂㅜㅋㅜㄹㅔㅅㅠㅌㅣ	pukʰuɾeɕʰutʰi
ㅈㅣㅈㅓㄱㄷㅚㄷㅏ	t͡ɕid͡ʑʌk̚tweda
ㄱㅣㅎㅏㄱ	kiɦak̚
ㅚ	we
ㅅㅓㄹ	sʰʌɭ
ㅂㅜㅇㅟ	puɥi
ㅎㅏㅁㅜㄹ	hamuɭ
ㄱㅗㅇㅌㅗㅇ	koŋtʰoŋ
ㅇㅘㅌㅡ	watʰɯ
ㄹㅏㄱㅗ	ɾaɡo
ㅇㅏㅌㅣㅊㅗㅋㅡ	atʰit͡ɕʰokxɯ
ㄱㅝㄴㄱㅗㅎㅏㄷㅏ	kwɘnɡoɦada
ㄹㅣㅁ	ɾim
ㅅㅏㄴㅎㅗ	sʰanβo
ㅇㅏㅀㅇㅣ	aɾi
ㅈㅗㄹㅖ	t͡ɕoɾje
ㄷㅐㄱㅓㅁㅈㅣㅂ	tɛɡʌmd͡ʑip̚
ㅇㅏㄹㄹㅔㄱㅅㅏㄴㄷㅡㄹㅣㅇㅏ	aɭɭeksandɯɾia
ㅅㅔㄹㅗ	sʰeɾo
ㅇㅜㅈㅜㅇㅣㄴ	ud͡ʑuin
ㅅㅗㅈㅣㅎㅏㄷㅏ	sʰod͡ʑiɦada
ㅌㅗㅇㅛㄱㅎㅗㄴ	tʰojokʰon
ㅍㅏㄴㄷㅗㄹㅏ	pʰandoɾa
ㄴㅗㄱㅇㅡㅁㄱㅣ	noɡɯmɡi
ㅅㅏㄹㅏㅇㅖㅂㅗ	sʰaɾajebo
ㅆㅡㄹㅣ	sɯɾi
ㅅㅡㅇㅞㄹㅣㅇㅖ	sʰɯweɾije
ㅍㅕㅇㅇㅑ	pʰjʌŋja
ㅁㅏㅊㅣㅁ	mat͡ɕʰim
ㅅㅏㄱㅜ	sʰaɡu
ㅇㅣㄴㅁㅜㄴㅎㅏㄱ	inmunɦak̚
ㄷㅟㅅㄷㅏㄹㅣ	tɥit̚taɾi
ㄷㅐㅈㅏㅇ	tɛd͡ʑaŋ
ㅎㅗㅍㅡ	ɸʷopʰɯ
ㅁㅣㄹㅋㅡ	miɭkxɯ
ㄱㅏㅎㅏㄷㅏ	kaɦada
ㄹㅜㅅㅣ	ɾuɕʰi
ㅇㅞㄴㅇㅣㄹ	wenniɭ
ㅂㅜㅌㅏㄱ	putʰak̚
ㅅㅗㅂㅏㅇㅅㅓ	sʰobaŋsʰʌ
ㅌㅡㄹㅗㄹㄹㅣㅂㅓㅅㅡ	tʰɯɾoʎʎibʌsʰɯ
ㅍㅏㄹㅏㅇㅗ	pʰaɾao
ㅅㅏㅇㅎㅗ	sʰaŋβo
ㅇㅓㄹㄹㅜㄱ	ʌɭɭuk̚
ㅆㅏㅇㅅㅣㅇㅗㅅ	saŋɕʰiot̚
ㅍㅏㄹㅏㅅㅗㄹ	pʰaɾasʰoɭ
ㄴㅓㅎㅢ	nʌʝi
ㅂㅣㅇ	piŋ
ㄱㅗㅈㅣㅂ	kod͡ʑip̚
ㅁㅏㄹㄸㅜㄱㅁㅏㅇㄷㅜㅇㅇㅓ	maɭtuŋmaŋduŋʌ
ㄱㅡㄹㅡㄷㅏ	kɯɾɯda
ㅅㅜㅁㅅㅟㄷㅏ	sʰumʃʰɥida
ㅁㅜㄹㅈㅣㄹ	muʎt͡ɕiɭ
ㄱㅏㄴㅈㅣㄹ	kaɲd͡ʑiɭ
ㅎㅓㄹㅏㄱ	hʌɾak̚
ㅋㅏㅂㅗㄱㅅㅣㄹㅅㅏㄴ	kʰabokɕiɭsʰan
ㄴㅕㅅㅣㄴ	ɲjʌɕʰin
ㅇㅣㄴㄷㅗㅊㅏㅇㅣㄴㅏ	indot͡ɕʰaina
ㅍㅗㅎㅘ	pʰoβwa
ㅍㅕㅇㅈㅣ	pʰjʌŋd͡ʑi
ㅍㅣㅅㅣ	pʰiɕi
ㄱㅕㄲㄷㅏ	kjʌk̚ta
ㄷㅗㅇㄱㅓ	toŋɡʌ
ㄱㅡㄱㄷㅗㅇ	kɯk̚toŋ
ㄱㅘㅅㅣㄱ	kwaɕʰik̚
ㅇㅑㅇㄱㅗㄴ	jaŋɡon
ㅆㅏㅇㅜㅁㅌㅓ	saumtʰʌ
ㄱㅏㄷㅏ	kada
ㅇㅏㄹㅍㅏ	aɭpʰa
ㅁㅏㅈㅏㄱ	mad͡ʑak̚
ㄴㅏㄱㅇㅕㅂ	naɡjʌp̚
ㄷㅓㅇㅜㄱ	tʌuk̚
ㅂㅏㅁㄴㅏㅈ	pamnat̚
ㄷㅜㄲㅓㅂㅣ	tukʌbi
ㅊㅏㅁㅇㅡㄹㅅㅓㅇ	t͡ɕʰamɯɭsʰʌŋ
ㅇㅔㅁㅣㄹㅣㅌㅡ	emiɾitʰɯ
ㅁㅗㅇㄱㅜㅅㅡ	moŋɡusʰɯ
ㅎㅘㅍㅖ	ɸwapʰje
ㅎㅜㄱㅘ	ɸʷuɡwa
ㅌㅔㄱㅜㅅㅣㄱㅏㄹㅍㅏ	tʰeɡuɕʰiɡaɭpʰa
ㅇㅓㄴㄱㅡㅂㅎㅏㄷㅏ	ʌnɡɯpʰada
ㄴㅔㅇㅗㄴ	neon
ㅅㅗㄴㅏㅌㅏ	sʰonatʰa
ㅇㅜㄹㅗㅇㅊㅏ	uɾoŋt͡ɕʰa
ㅁㅏㄴㅅㅓㅇ	mansʰʌŋ
ㄱㅕㅇㄹㅗ	kjʌŋno
ㅎㅐㅇㅑㅇ	hɛjaŋ
ㄷㅟㅅㅁㅕㄴ	tɥinmjʌn
ㄸㅗㄱㅂㅏㄹㅗ	tok̚paɾo
ㅇㅝㄴㅈㅏㅇ	wʌɲd͡ʑaŋ
ㅂㅗㄱㅅㅡㄹㅓㅂㄷㅏ	poksɯɾʌp̚ta
ㅂㅣㅈㅏㄴㅌㅣㅇㅗㄴ	pid͡ʑantʰion
ㄱㅡㄹㅣㄹ	kɯɾiɭ
ㅋㅏㅍㅔㅌㅔㄹㅣㅇㅏ	kʰapʰetʰeɾia
ㄱㅡㄹㄹㅏㅅㅡㄴㅗㅅㅡㅌㅡ	kɯɭɭasʰɯnosʰɯtʰɯ
ㅈㅗㅅㅓㄴ	t͡ɕosʰʌn
ㄱㅕㅇㄱㅘㄴ	kjʌŋɡwan
ㄱㅏㄷㅡㄱ	kadɯk̚
ㅁㅓㄹㅣㄸㅣ	mʌɾiti
ㅍㅣㄹㅅㅜㅈㅓㄱ	pʰiɭsud͡ʑʌk̚
ㄴㅏㅁㅜㄹ	namuɭ
ㄱㅗㄹㅅㅏㅇㅎㅏㄱ	koɭsʰaŋɦak̚
ㅂㅕㄴㅅㅜ	pjɘnsʰu
ㅌㅜㄹㅡㅋㅡㅁㅔㄴㅇㅓ	tʰuɾɯkxɯmenʌ
ㅍㅡㄹㅗㅅㅔㅅㅡ	pʰɯɾosʰesʰɯ
ㅈㅏㅈㅗㄴㅅㅣㅁ	t͡ɕad͡ʑonɕʰim
ㅋㅜㅇㅞㅇㅣㅌㅡ	kʰuweitʰɯ
ㄱㅓㄷㅜㄷㅏ	kʌduda
ㅎㅚㅈㅓㄴㅁㅗㄱㅁㅏ	ɸwed͡ʑʌnmoŋma
ㅂㅡㄹㅏㅇㅜㅈㅓ	pɯɾaud͡ʑʌ
ㅍㅣㄹㅇㅛㅎㅏㄷㅏ	pʰiɾjoɦada
ㅋㅗㄴㄷㅗㅁ	kʰondom
ㅇㅕㅂㅗ	jʌbo
ㄷㅣㅂㅏㅇㅣㅅㅡ	tibaisʰɯ
ㅇㅗㅅㅣㅂ	oɕʰip̚
ㅣ	i
ㅎㅗㅅㅏ	ɸʷosʰa
ㄷㅗㄹㅛ	toɾjo
ㄱㅓㄴㅊㅜㄱㅎㅏㄱ	kɘɲt͡ɕʰukʰak̚
ㅁㅜㄴㅎㅘ	munβwa
ㅃㅕㄱ	pjʌk̚
ㅁㅏㄹㄸㅗㅇㄱㅏㄹㅣ	maɭtoŋɡaɾi
ㅃㅕㅊ	pjʌt̚
ㄱㅕㅈㅏ	kjʌd͡ʑa
ㄷㅡㄹㄲㅝㅇ	tɯɭkwʌŋ
ㅉㅣㄹㅡㄷㅏ	t͡ɕiɾɯda
ㅂㅗㅅㅜ	posʰu
ㅇㅟㅎㅕㅂ	ɥiʝjʌp̚
ㅈㅜㄹㅁㅏㅇㄷㅜㄱ	t͡ɕuɭmaŋduk̚
ㅈㅜㄱㅛㄱㅘㄴ	t͡ɕuɡjoɡwan
ㅌㅏㄱ	tʰak̚
ㅌㅔㄴ	tʰen
ㅃㅗㅇ	poŋ
ㅅㅏㅇㅅㅡㄹㅓㅂㄷㅏ	sʰaŋsʰɯɾʌp̚ta
ㄱㅣㄱㅘㄴ	kiɡwan
ㅈㅣㅁㅈㅏㄱㅎㅏㄷㅏ	t͡ɕimd͡ʑakʰada
ㅅㅣㄴㄹㅏ	ɕʰiɭɭa
ㄷㅗㅇㅖ	toje
ㅁㅏㄹㅕㄴㄷㅚㄷㅏ	maɾjʌndweda
ㄱㅏㅁㅜㄹㅊㅣ	kamuʎt͡ɕʰi
ㅇㅕㄹㅁㅗㄱㅇㅓ	jʌɭmoɡʌ
ㅊㅗㄹㅗㄱㅂㅣㅊ	t͡ɕʰoɾok̚pit̚
ㅅㅜㄴㅕ	sʰuɲjʌ
ㅊㅚㅎㅜ	t͡ɕʰweβu
ㅁㅣㄴㅣㅅㅡㅋㅓㅌㅡ	minisʰɯkʰʌtʰɯ
ㅇㅓㄷㅣ	ʌdi
ㄷㅗㄹㅈㅏㅂㅇㅣ	toʎd͡ʑabi
ㄷㅗㄷㅗㅁㅏ	todoma
ㄱㅗㄹㅍㅡ	koɭpʰɯ
ㄲㅡㅀㄷㅏ	kɯɭtʰa
ㄱㅏㄹㅏㅇㅏㄵㄷㅏ	kaɾaanta
ㄱㅜㅅㅗㄱ	kusʰok̚
ㄱㅏㄸㅏㄲㅏㄴㅏ	katakana
ㄷㅡㄱㄴㅕ	tɯŋɲjʌ
ㅇㅏㅍㅗㅅㅡㅌㅡㄹㅗㅍㅣ	apʰosʰɯtʰɯɾopʰi
ㄴㅏㅇㅣㄹㅗㅂㅣ	naiɾobi
ㅎㅘㅂㅕㅇ	ɸwapjʌŋ
ㅆㅡㄸㅗㄹ	sɯtoɭ
ㅎㅏㅁㅏ	hama
ㅅㅗㅇㄹㅣㅁ	sʰoŋnim
ㄷㅗㅇㅇㅣㄹ	toŋiɭ
ㅈㅜㄱㅗㅂㅏㄷㄷㅏ	t͡ɕuɡobat̚ta
ㅇㅣㄴㅈㅣㄹ	iɲd͡ʑiɭ
ㅂㅗㄹㅣ	poɾi
ㄱㅖㅅㅏㄴㅎㅏㄷㅏ	kjesʰanɦada
ㅅㅣㅅㅓㄹ	ɕʰisʰʌɭ
ㅅㅓㅇㄴㅕㄴ	sʰʌŋɲjʌn
ㅈㅜㅈㅏㅇ	t͡ɕud͡ʑaŋ
ㅎㅏㄴㅈㅗㄱ	haɲd͡ʑok̚
ㅇㅑㄷㅡ	jadɯ
ㅅㅣㄹㄹㅗ	ɕʰiɭɭo
ㅁㅜㅎㅏㄴ	muɦan
ㅎㅚㅇ	ɸweŋ
ㄷㅏㅂㅏㄹ	tabaɭ
ㅇㅏㄹㅡㅌㅔㅁㅣㅅㅡ	aɾɯtʰemisʰɯ
ㄱㅏㄹㄹㅣ	kaʎʎi
ㅇㅣㄷㅡㄱ	idɯk̚
ㅈㅜㅇㄱㅜㄱㅎㅏㄱ	t͡ɕuŋɡukʰak̚
ㅇㅠㄷㅗㅌㅏㄴ	judotʰan
ㅌㅡㄹㅣㅁ	tʰɯɾim
ㄱㅚㅎㅏㄴ	kweɦan
ㅁㅏㅅㅂㅗㄷㅏ	mat̚poda
ㅂㅗㄹㅌㅡ	poɭtʰɯ
ㅎㅘㄹㅅㅓㅇㅌㅏㄴ	ɸwaɭsʌŋtʰan
ㅅㅏㅇㄱㅝㄴ	sʰaŋkwʌn
ㅎㅐㄱㅡㅁ	hɛɡɯm
ㅁㅗㄱㄹㅗㄱ	moŋnok̚
ㅁㅔㅅㅂㅏㅌㅈㅟ	met̚pat̚t͡ɕɥi
ㅅㅏㅇㅎㅏㄷㅏ	sʰaŋɦada
ㅂㅣㅂㅣㅁㅂㅏㅂ	pibimpap̚
ㅇㅗㅇㅗㄴ	oon
ㅈㅏㄷㅏ	t͡ɕada
ㅇㅣㄹㄱㅏㄱㅅㅜ	iɭɡaksu
ㅎㅏㄹㅋㅟㄷㅏ	haɭkʰɥida
ㅈㅡㅇㅅㅓㄹㅎㅏㄷㅏ	t͡ɕɯŋsʰʌɾɦada
ㅇㅗㄹㄹㅣㄷㅏ	oʎʎida
ㄲㅣㅊㅣㄷㅏ	kit͡ɕʰida
ㅇㅘㄴㄱㅗㄱㅇㅓㅂㅓㅂ	wanɡoɡʌbʌp̚
ㅅㅓㄹㅁㅜㄴㅈㅣ	sʰʌɭmuɲd͡ʑi
ㅅㅔㅅㅏㅇㅇㅔ	sʰesʰaŋe
ㅇㅏㄹㄷㅏ	aɭda
ㅇㅕㅂㅗㅅㅔㅇㅛ	jʌbosʰejo
ㄱㅘㅇㅅㅣ	kwaŋɕʰi
ㄱㅜㅊㅣㅅㅗ	kut͡ɕʰisʰo
ㅇㅣㄱㄷㅏ	ik̚ta
ㅋㅡㄹㅣㅋㅔㅅ	kxɯɾikʰet̚
ㅇㅏㄴㅣㅎㅏㄷㅏ	aniɦada
ㄱㅝㄴㄹㅕㄱ	kwɘʎʎjʌk̚
ㅅㅜㅇㅕㅁ	sʰujʌm
ㅅㅜㄱㅗ	sʰuɡo
ㅊㅓㄴㅕㅅㅓㅇ	t͡ɕʰʌɲjʌsʰʌŋ
ㅎㅏㅂㅂㅓㅂ	hap̚pʌp̚
ㅌㅏㄹㅊㅜㄹ	tʰaʎt͡ɕʰuɭ
ㅈㅓㄻㅇㅡㅁ	t͡ɕɘɭmɯm
ㅈㅏㄹㅠㅅㅓㄱ	t͡ɕaɾjusʰʌk̚
ㅎㅡㄹㄹㅓㄱㅏㄷㅏ	xɯɭɭʌɡada
ㅍㅗㄱㅌㅏㄴ	pʰok̚tʰan
ㅌㅓㅂㅣㄴ	tʰʌbin
ㅇㅗㄹㅔㄴㅈㅣ	oɾeɲd͡ʑi
ㅇㅒㄱㅣ	jɛɡi
ㅇㅔㅇㅣㅅ	eit̚
ㄱㅏㅇㅅㅏ	kaŋsʰa
ㄱㅗㅊㅣㄷㅏ	kot͡ɕʰida
ㅎㅗㅈㅜㅇㅣㄴ	ɸʷod͡ʑuin
ㅅㅣㄴㅇㅛㅇ	ɕʰiɲjoŋ
ㅅㅣㅂㅈㅏㅅㅓㄴ	ɕʰip̚t͡ɕasʰʌn
ㅂㅓㄹㄹㅔ	pʌɭɭe
ㅇㅏㅁㅎㅡㄱ	amɣɯk̚
ㅇㅕㄴㅁㅏㄹ	jʌnmaɭ
ㅇㅣㅇㅡㄱㄱㅗ	iɯk̚ko
ㅇㅏㅍㅡㅁ	apʰɯm
ㅈㅏㄴㄹㅠ	t͡ɕaʎʎju
ㅂㅕㄹㅏㄱ	pjʌɾak̚
ㄱㅓㄹㅣㄷㅏ	kʌɾida
ㅇㅜㅇㅇㅓ	uŋʌ
ㅎㅘㅇㅇㅓ	ɸwaŋʌ
ㅆㅏㅇㅣㄷㅏ	saida
ㅇㅏㅋㅏㄷㅔㅁㅣ	akʰademi
ㅈㅓㅎㅢ	t͡ɕʌʝi
ㅎㅘㄹㅕㅎㅏㄷㅏ	ɸwaɾjʌɦada
ㅍㅗㄹㅓㅁ	pʰoɾʌm
ㅈㅏㅁ	t͡ɕam
ㄷㅜㅂㅏㄴㅈㅏㅇ	tubaɲd͡ʑaŋ
ㄴㅡㄹㅣㄷㅏ	nɯɾida
ㅅㅏㅇㅎㅘㄴㄷㅚㄷㅏ	sʰaŋβwandweda
ㅍㅔㅈㅣ	pʰed͡ʑi
ㅋㅗㄹㄹㅏㅂㅗㄹㅔㅇㅣㅅㅕㄴ	kʰoɭɭaboɾeiɕʰʌn
ㅊㅓㅇㅅㅗ	t͡ɕʰʌŋsʰo
ㅍㅠㄹㅏㅈㅏㄴ	pʰjuɾad͡ʑan
ㅇㅏㄹㅂㅏ	aɭba
ㄱㅗㅊㅜㅅㄱㅏㄹㅜ	kot͡ɕʰut̚kaɾu
ㅈㅓㄱㅎㅘㄱㅎㅏㄷㅏ	t͡ɕʌkʰwakʰada
ㄱㅏㅁㄱㅡㅁ	kamɡɯm
ㅇㅓㅊㅏㅍㅣ	ʌt͡ɕʰapʰi
ㄱㅛㅅㅏ	kjosʰa
ㅇㅕㅁㄹㅕㅎㅏㄷㅏ	jɘmɲjʌɦada
ㅎㅓㅁㅜㄹㄷㅏ	hʌmuɭda
ㄱㅏㅇ	kaŋ
ㅅㅜㄹㅠㅌㅏㄴ	sʰuɾjutʰan
ㄷㅠㅇㅗ	tjuo
ㅅㅏㅁㄹㅣㅁ	sʰamnim
ㅎㅏㄴㅉㅗㄱ	haɲt͡ɕok̚
ㅂㅏㄱㅅㅜㅎㅏㄷㅏ	paksuɦada
ㅍㅣㅋㅡㄴㅣㄱ	pʰikxɯnik̚
ㅉㅏㅁ	t͡ɕam
ㅁㅗㅌㅓㅂㅗㅌㅡ	motʰʌbotʰɯ
ㅅㅣㄴㅁㅜㄴ	ɕʰinmun
ㅇㅏㄷㅡㄴㅣㅁ	adɯnim
ㄴㅏㅁㅂㅓㄹ	nambʌɭ
ㄱㅏㅂㅕㅇㅝㅈㅣㄷㅏ	kabjʌwʌd͡ʑida
ㄱㅖㄷㅏㄴ	kjedan
ㄲㅡㄶㅇㅣㄷㅏ	kɯnida
ㅅㅡㅂㄷㅡㄱ	sʰɯp̚tɯk̚
ㅎㅡㄹㅡㅂㅏㅉㅡㄲㅏ	xɯɾɯbat͡ɕɯka
ㅊㅓㄴㅎㅏ	t͡ɕʰʌnɦa
ㄲㅡㅈㅣㅂㄷㅏ	kɯd͡ʑip̚ta
ㅌㅏㅁㅈㅓㅇ	tʰamd͡ʑʌŋ
ㄷㅚㅍㅜㄹㅇㅣ	twepʰuɾi
ㅇㅓㅂㅈㅣㄴ	ʌp̚t͡ɕin
ㅅㅓㄱㄹㅠㅅㅓㄱ	sʰʌŋɲjusʰʌk̚
ㅅㅗㄱㅅㅗㄱ	sʰoksok̚
ㅎㅏㄱㅇㅟ	haɡɥi
ㄱㅡㄱㅂㅗㄱㅎㅏㄷㅏ	kɯk̚pokʰada
ㅅㅏㅇㅇㅝㄴ	sʰaŋwʌn
ㅁㅏㄴㄹㅠ	maʎʎju
ㅁㅗㅅㅈㅣㅇㅏㄶㄷㅏ	mot̚t͡ɕiantʰa
ㅈㅓㅍㅕㄴ	t͡ɕʌpʰjʌn
ㅎㅐㅂㅏㅇㅎㅏㄷㅏ	hɛbaŋɦada
ㅇㅓㅂㅁㅜ	ʌmmu
ㅊㅜㅊㅡㄱㅎㅏㄷㅏ	t͡ɕʰut͡ɕʰɯkʰada
ㅋㅓㄹㅣ	kʰʌɾi
ㅇㅠㄱㅈㅏㅈㅣㄴㅇㅓㄴ	juk̚t͡ɕad͡ʑinʌn
ㅁㅓㄱㅡㅈㅏㄴ	mʌɡɯd͡ʑan
ㅂㅓㄹ	pʌɭ
ㄱㅘㄴㅅㅏ	kwansʰa
ㅎㅓㅅㅂㅏㅇㄱㅟ	hʌt̚paŋɡɥi
ㄷㅗㄱㅅㅏ	toksa
ㅅㅡㅁㅏㅌㅡㅍㅗㄴ	sʰɯmatʰɯpʰon
ㄷㅏㄴㅕㄱㅏㄷㅏ	taɲjʌɡada
ㅅㅗㅇㅈㅏㅇ	sʰoŋd͡ʑaŋ
ㅍㅡㄹㅣㅌㅏㅇㅜㄴ	pʰɯɾitʰaun
ㄹㅏㅇㅜㄴㅈㅣ	ɾauɲd͡ʑi
ㅇㅛㅅㅏㅇㅣ	josʰai
ㅅㅜㅅㅗㅌㅏㄴ	sʰusʰotʰan
ㅇㅏㄹㅡㄱㅗㄴ	aɾɯɡon
ㄷㅣㄹㄹㅣ	tiʎʎi
ㅌㅔㅎㅔㄹㅏㄴ	tʰeɦeɾan
ㅊㅐㄱㅈㅏ	t͡ɕʰɛk̚t͡ɕa
ㅇㅟㅈㅜ	ɥid͡ʑu
ㅈㅔㅊㅜㄹ	t͡ɕet͡ɕʰuɭ
ㄱㅘㅇㅁㅕㅇㅅㅓㅇㅈㅓㄹ	kwaŋmjʌŋsʰʌŋd͡ʑʌɭ
ㅂㅕㅇㅎㅏㅂ	pjʌŋɦap̚
ㅎㅏㅇㅑ	haja
ㅁㅏㅅㅏㅈㅣ	masʰad͡ʑi
ㅁㅗㅈㅏㅇㅣㅋㅡ	mod͡ʑaikxɯ
ㅂㅜㄱㅂㅣㅇㅇㅑㅇ	puk̚piŋɲjaŋ
ㄸㅟㅇㅓㄷㅏㄴㅣㄷㅏ	tɥiʌdanida
ㄷㅐㅇㅕㅅㅓㅅ	tɛjʌsʰʌt̚
ㅇㅣㄱㅔ	iɡe
ㅃㅏㄹㄱㅏㅇ	paɭɡaŋ
ㄱㅓㄹㅅㅣㄴ	kʌɭɕin
ㄴㅏㄹㄷㅜㅎㅏㄷㅏ	naɭduɦada
ㄹㅏㅂㅏㅌㅡ	ɾabatʰɯ
ㅇㅣㅂㅁㅏㅅ	immat̚
ㅇㅑㅇㅈㅏㅈㅓㄴㄱㅣㅇㅕㄱㅎㅏㄱ	jaŋd͡ʑad͡ʑʌnɡijʌkʰak̚
ㄱㅡㄹㅇㅝㄹ	kɯɾwʌɭ
ㅅㅜㄱ	sʰuk̚
ㅅㅜㅅㅓ	sʰusʰʌ
ㅇㅏㅋㅡㄹㅏ	akxɯɾa
ㄷㅡㄹㄹㅓㄹㅣ	tɯɭɭʌɾi
ㅁㅣㄹㅡ	miɾɯ
ㄱㅏㅄㅇㅓㅊㅣ	kabʌt͡ɕʰi
ㅈㅗㅇㅇㅣ	t͡ɕoŋi
ㅂㅜㄹㅂㅣㅊ	puɭpit̚
ㅈㅣㅎㅏㅅㅣㄹ	t͡ɕiɦaɕʰiɭ
ㅇㅓㄱㅡㅁㄴㅣ	ʌɡɯmni
ㅊㅏㄹㅏㄹㅣ	t͡ɕʰaɾaɾi
ㄸㅗ	to
ㄱㅡㅁㅡㅁㄴㅏㄹ	kɯmɯmnaɭ
ㄴㅗㅅㅚ	nosʰwe
ㄷㅜㄱㅓㄴ	tuɡʌn
ㅍㅣㅂㅜ	pʰibu
ㄱㅗㄴㅊㅜㅇㅎㅏㄱ	koɲt͡ɕʰuŋɦak̚
ㄱㅏㅈㅜㄱㄲㅡㄴ	kad͡ʑuk̚kɯn
ㅇㅜㄴㅅㅜ	unsʰu
ㄱㅏㅈㅜㄱ	kad͡ʑuk̚
ㄱㅗㅅㅗㄱ	kosʰok̚
ㄴㅔㅇㅗㄴㅏㅊㅣ	neonat͡ɕʰi
ㅁㅏㅅㅏㅈㅣㅎㅏㄷㅏ	masʰad͡ʑiɦada
ㅅㅣㄴㄱㅕㅇㅎㅏㄱ	ɕʰinɡjʌŋɦak̚
ㄱㅗㄴㄷㅗㄹㄹㅏ	kondoɭɭa
ㅍㅏㄹㄹㅣㄷㅏ	pʰaʎʎida
ㅇㅝㄴㄱㅗㄱ	wʌnɡok̚
ㅈㅏㅁㄷㅡㄹㄷㅏ	t͡ɕamdɯɭda
ㅂㅏㄹㅇㅣㄴ	paɾin
ㅂㅣㅊㄴㅏㄷㅏ	pinnada
ㅅㅡㄹㄹㅣㅍㅓ	sʰɯʎʎipʰʌ
ㅇㅓㅂㄱㅡㄹㅔㅇㅣㄷㅡ	ʌp̚kɯɾeidɯ
ㅁㅏㅇㅑㄱ	majak̚
ㅊㅣㅇㅜ	t͡ɕʰiu
ㅈㅏㅁㅅㅜㅎㅏㅁ	t͡ɕamsʰuɦam
ㄱㅛㄹㅠ	kjoɾju
ㅇㅔㅅㅡㅌㅓ	esʰɯtʰʌ
ㅇㅠㅎㅕㄹㅁㅗㄱㅇㅣ	juʝjʌɭmoɡi
ㅌㅏㄴㅎㅘㅅㅜㅅㅗ	tʰanβwasʰusʰo
ㅎㅏㄱㅇㅝㄴ	haɡwʌn
ㅇㅑㅇㅎㅏ	jaŋɦa
ㄱㅏㄴㅊㅔ	kaɲt͡ɕʰe
ㅇㅠㅁㅕㅇㅎㅏㄷㅏ	jumjʌŋɦada
ㄱㅏㄹㅕㅇ	kaɾjʌŋ
ㅁㅜㅈㅚ	mud͡ʑwe
ㅅㅜㄴㅂㅏㄱ	sʰunbak̚
ㄲㅡㄷㅏ	kɯda
ㅁㅣㅅㅜㄹㄱㅘㄴ	misʰuɭɡwan
ㄷㅜ	tu
ㅇㅡㅁㄱㅕㅇㄱㅗㄹ	ɯmɡjʌŋɡoɭ
ㅂㅜㄴㄱㅘㅇㄱㅣ	punɡwaŋɡi
ㅍㅖㅇㅓ	pʰjeʌ
ㅎㅘㅈㅔ	ɸwad͡ʑe
ㅊㅣㄴㅅㅓㄴ	t͡ɕʰinsʰʌn
ㅇㅕㅅㄷㅡㄷㄷㅏ	jɘt̚tɯt̚ta
ㅃㅕㅎ	pjʌt̚
ㅎㅡㅀ	xɯɭ
ㄱㅏㅇㅛ	kajo
ㅎㅏㄴㅁㅜㄹ	hanmuɭ
ㅇㅝㄴㅈㅏㄱ	wʌɲd͡ʑak̚
ㅇㅗㄱㅅㅓㄱ	oksʌk̚
ㅁㅓㄹㅣㅋㅏㄹㅏㄱ	mʌɾikʰaɾak̚
ㅇㅏㅍㅗㄹㄹㅗㄴ	apʰoɭɭon
ㄱㅖㅅㅣㄷㅏ	kjeɕʰida
ㅈㅏㅁㅗㅇ	t͡ɕamoŋ
ㅊㅣ	t͡ɕʰi
ㅌㅏㅇㅣㄱㅏ	tʰaiɡa
ㄷㅓㄴㅈㅣㄷㅏ	tʌɲd͡ʑida
ㄱㅐㅇㅣㄴㅈㅓㄱ	kɛiɲd͡ʑʌk̚
ㅇㅏㄱㅌㅣㄴㅠㅁ	ak̚tʰiɲjum
ㄱㅡㄹㅣㅅㅡㄷㅗ	kɯɾisʰɯdo
ㄱㅏㄷㅡㄱㄱㅏㄷㅡㄱ	kadɯk̚kadɯk̚
ㅎㅏㄹㅏㄱㅎㅏㄷㅏ	haɾakʰada
ㅇㅛㅈㅡㅇㅡㅁ	jod͡ʑɯɯm
ㅊㅓㅇㅅㅓㄹㅁㅗ	t͡ɕʰʌŋsʰʌɭmo
ㅅㅗㄱㄴㅜㄴㅆㅓㅂ	sʰoŋnunsʌp̚
ㄱㅣㄹㄷㅏ	kiɭda
ㄱㅏㄹㅁㅏㅇ	kaɭmaŋ
ㄱㅡㅂㄱㅕㄱㅎㅏㄷㅏ	kɯp̚kjʌkʰada
ㅅㅓㅇㅅㅣㄹ	sʰʌŋɕʰiɭ
ㅅㅐㄷㅏ	sʰɛda
ㅅㅜㅇㅡㅁ	sʰuɯm
ㅇㅜㅅㅇㅡㅁㅅㅗㄹㅣ	usʰɯmsoɾi
ㅇㅣㅈㅓㅁ	id͡ʑʌm
ㅇㅣㅂㅂㅓㅂ	ip̚pʌp̚
ㄱㅣㅊㅣ	kit͡ɕʰi
ㄷㅓㄷㅡㅁㅇㅣ	tʌdɯmi
ㅊㅏㅁㅁㅏㄹ	t͡ɕʰammaɭ
ㅈㅓㄴㅎㅘㄴ	t͡ɕɘnβwan
ㄱㅓㄹㅇㅣㄴ	kʌɾin
ㅂㅜㅈㅗㄹㅣ	pud͡ʑoɾi
ㅂㅏㅂ	pap̚
ㄴㅜㄴㅇㅜㅅㅇㅡㅁ	nunusʰɯm
ㅈㅑㅂㅏ	t͡ɕaba
ㄱㅛㅌㅏㄱ	kjotʰak̚
ㅇㅢㅇㅛㄱ	ɰijok̚
ㅇㅕㅇㅢㅈㅏ	jʌɰid͡ʑa
ㅎㅜㅊㅜ	ɸʷut͡ɕʰu
ㄹㅜㄹㄹㅔㅅ	ɾuɭɭet̚
ㅅㅜㅁㅈㅣㄷㅏ	sʰumd͡ʑida
ㅋㅗㄴㄷㅗㅁㅣㄴㅣㅇㅓㅁ	kʰondominiʌm
ㅅㅓㅇㅑㅇㅈㅏㄷㅜ	sʰʌjaŋd͡ʑadu
ㄱㅔㄹㅣㄹㄹㅏ	keɾiɭɭa
ㅅㅛ	ɕo
ㅇㅣㄴㅍㅡㄹㄹㅔㅇㅣㅅㅕㄴ	inpʰɯɭɭeiɕʰʌn
ㅊㅔㄱㅖ	t͡ɕʰeɡje
ㅎㅐㄷㅗ	hɛdo
ㅅㅗㅂㅏㅇㄱㅘㄴ	sʰobaŋɡwan
ㄷㅐㅈㅣ	tɛd͡ʑi
ㄴㅏㄹㅈㅣㅁㅅㅡㅇ	naʎt͡ɕimsʰɯŋ
ㅂㅜㅊㅜㄱㅣㄷㅏ	put͡ɕʰuɡida
ㄲㅗㅇㅊㅣ	koŋt͡ɕʰi
ㅎㅔㅅㄱㅏㄹㄹㅣㄷㅏ	het̚kaʎʎida
ㅂㅏㄷㅏㅂㅣㅇㅗㄹㅣ	padabioɾi
ㅁㅣㅂㄷㅏ	mip̚ta
ㄷㅐㄹㅕㅇ	tɛɾjʌŋ
ㅊㅓㄹㄱㅏㅂ	t͡ɕʰʌɭɡap̚
ㅁㅗㅇㅗㅋㅔ	mookʰe
ㄴㅏㅁㅜㅅㄱㅏㅈㅣ	namut̚kad͡ʑi
ㄷㅗㄴ	ton
ㅍㅏㄷㅗㅇ	pʰadoŋ
ㅅㅏㄹㅣㅂ	sʰaɾip̚
ㅎㅜㅎㅚ	ɸʷuβwe
ㅁㅜㄹㄹㅗㄴ	muɭɭon
ㅂㅓㄴㅇㅕㄱㄱㅏ	pʌɲjʌk̚ka
ㄱㅣㅈㅓ	kid͡ʑʌ
ㄱㅓㅂㅜㄱ	kʌbuk̚
ㅈㅗㄹㅇㅓㅂ	t͡ɕoɾʌp̚
ㅈㅓㄴㅅㅓㄴ	t͡ɕɘnsʰʌn
ㄱㅕㄹㄱㅘ	kjʌɭɡwa
ㅇㅏㄴㅉㅗㄱ	aɲt͡ɕok̚
ㅎㅏㅇㅣㄷㅡㄹㅗㄱㅅㅣㄹㅇㅏㅁㅣㄴ	haidɯɾokɕiɾamin
ㄷㅟㅅㅁㅗㅅㅡㅂ	tɥinmosʰɯp̚
ㅅㅏㄹㄱㅕㄹㅁㅜㄹ	sʰaɭkjʌɭmuɭ
ㅇㅣㄷㅏㄴ	idan
ㅂㅗㄱㄷㅗ	pok̚to
ㅇㅜㅍㅛ	upʰjo
ㅁㅜㅇㅣㄴㅈㅓㅁㅍㅗ	muiɲd͡ʑʌmpʰo
ㄱㅗㅈㅣ	kod͡ʑi
ㅇㅝ	wʌ
ㅅㅡㅍㅜㅌㅡㄴㅣㅋㅡ	sʰɯpʰutʰɯnikxɯ
ㅁㅣㄹㅏ	miɾa
ㅂㅣㄹㅜㅅㅡ	piɾusʰɯ
ㄷㅜㄲㅔ	tuke
ㅂㅓㅅㄷㅏ	pʌt̚ta
ㅇㅣㅅㅡㅁㅏㅇㅔㄹ	isʰɯmaeɭ
ㅅㅏㄹㄹㅣㅁ	sʰaʎʎim
ㄱㅣㄹㅖㄱㅣ	kiɾjeɡi
ㄱㅠㄴㅎㅕㅇ	kjunʝjʌŋ
ㄹㅣㅇㅗㅇ	ɾioŋ
ㄷㅏㅂㅏㅇ	tabaŋ
ㅈㅣㄹㅏ	t͡ɕiɾa
ㅁㅏㅁㅓㄹㄹㅔㅇㅣㄷㅡ	mamʌɭɭeidɯ
ㅅㅗㄴㅗㅇ	sʰonoŋ
ㅌㅗㅁㅏㅅㅡ	tʰomasʰɯ
ㅎㅘㄴㅈㅓㄴ	ɸwaɲd͡ʑʌn
ㅊㅓㄴㅅㅣㄱ	t͡ɕʰɘnɕʰik̚
ㅂㅜㅅㄷㅏ	put̚ta
ㄱㅛㅇㅑㅇ	kjojaŋ
ㄱㅗㅇㄱㅜ	koŋɡu
ㅊㅓㄴㅕㅁㅏㄱ	t͡ɕʰɘɲjʌmak̚
ㅅㅏㅇㅇㅘㄴㅇㅣㄷㅜㄱㅡㄴ	sʰaŋwaniduɡɯn
ㅅㅣㄴㅅㅓㅇ	ɕʰinsʰʌŋ
ㅂㅣㄴㅡㄹ	pinɯɭ
ㅅㅏㅈㅣㄴㅅㅜㄹ	sʰad͡ʑinsʰuɭ
ㅅㅜㅈㅜㅂㄷㅏ	sʰud͡ʑup̚ta
ㅈㅔㅈㅜㅅㅣ	t͡ɕed͡ʑuɕʰi
ㅍㅔㄱ	pʰek̚
ㅉㅏㅎㅏㄷㅏ	t͡ɕaɦada
ㄱㅡㄹㅣㄷㅏ	kɯɾida
ㄱㅗㅇㅑㄱㅎㅏㄷㅏ	kojakʰada
ㅈㅏㅇㅅㅡㅇ	t͡ɕaŋsʰɯŋ
ㄱㅗㅃㅣ	kopi
ㅋㅡㄴㅂㅏㄷㅏㅅㅏㅈㅏ	kxɯnbadasʰad͡ʑa
ㅂㅕㄴㅎㅘ	pjɘnβwa
ㄷㅜㄱㅡㄴㄱㅓㄹㅣㄷㅏ	tuɡɯnɡʌɾida
ㄴㅜㅂㄷㅏ	nup̚ta
ㅁㅜㄹㅖ	muɾje
ㅈㅓㄴㄱㅣㅈㅗㅇㅎㅏㅂㅇㅏㄱㄱㅣ	t͡ɕʌnɡid͡ʑoŋɦabak̚ki
ㄷㅔㄹㅕㄱㅏㄷㅏ	teɾjʌɡada
ㅈㅣㄴㅏㅁㅅㅓㄱ	t͡ɕinamsʰʌk̚
ㅆㅡㅂㅆㅡㄹㅎㅏㄷㅏ	sɯpsɯɾɦada
ㄷㅐㅊㅜㅇ	tɛt͡ɕʰuŋ
ㅉㅏㄱ	t͡ɕak̚
ㄱㅗㅅㅣ	koɕʰi
ㄷㅔㅁㅔㅌㅔㄹㅡ	temetʰeɾɯ
ㅁㅔㄱㅣ	meɡi
ㄴㅔㄷㅓㄹㄹㅏㄴㄷㅡ	nedʌɭɭandɯ
ㄹㅓㄴㄷㅓㄴ	ɾʌndʌn
ㄴㅔㅂㅌㅜㄴㅠㅁ	nep̚tʰuɲjum
ㅎㅔㅍㅡㄷㅏ	hepʰɯda
ㅋㅏㅇㅣㅅㅏㄹㅡ	kʰaisʰaɾɯ
ㄴㅗㄹㅡㄷㅏ	noɾɯda
ㅆㅏㅇㅂㅏㄴㅈㅓㅁ	saŋbaɲd͡ʑʌm
ㄱㅣㅁㅜㄹ	kimuɭ
ㅂㅏㄴㅈㅓㄹ	paɲd͡ʑʌɭ
ㅍㅖㅎㅚㅅㅣㄱ	pʰjeβweɕʰik̚
ㅎㅗㅁ	ɸʷom
ㅅㅓㅇㄱㅛㅎㅏㄷㅏ	sʰɘŋɡjoɦada
ㄸㅗㅇㄴㅏㅁㅇㅏ	toŋnama
ㅇㅠㅇㅛㅇㅎㅏㄷㅏ	jujoŋɦada
ㅇㅓㅄㅇㅓㅆㄷㅏ	ʌpsʌt̚ta
ㅈㅏㅂㅊㅗ	t͡ɕap̚t͡ɕʰo
ㅅㅏㅇㅏㄱ	sʰaak̚
ㅈㅗㅅㅓㄴ	t͡ɕosʰʌn
ㄱㅕㄹㅅㅣㅁㅎㅏㄷㅏ	kjʌɭɕimɦada
ㅈㅣㅈㅜ	t͡ɕid͡ʑu
ㄱㅏㄹㅅㅜㄹㅗㄱ	kaɭsuɾok̚
ㅂㅣㄷㅔㅇㅗ	pideo
ㅇㅕㄴ	jʌn
ㅍㅜㅁㅅㅏ	pʰumsʰa
ㅂㅜㅇㅕㅈㅏ	pujʌd͡ʑa
ㅇㅣㅈㄷㅏ	it̚ta
ㅈㅜㅂㅏㅇㅈㅏㅇ	t͡ɕubaŋd͡ʑaŋ
ㅌㅏㅂㅅㅡㅇ	tʰapsɯŋ
ㄷㅡㅇㄷㅡㅇ	tɯŋdɯŋ
ㅍㅜㅇㄱㅡㅁ	pʰuŋɡɯm
ㅇㅠㄱㅅㅓ	juksʌ
ㅎㅏㄴㅅㅣㄱㅈㅣㅂ	hanɕik̚t͡ɕip̚
ㅅㅏㅂ	sʰap̚
ㅇㅕㅅ	jɘt̚
ㅎㅏㄴㄱㅖ	hanɡje
ㅎㅘㅂㅗ	ɸwabo
ㅅㅡㅇㅟㅊㅣ	sʰɯɥit͡ɕʰi
ㅂㅏㄷㅇㅏㅆㅡㄱㅣ	padasɯɡi
ㄱㅏㄴㅇㅏㄱㅎㅏㄷㅏ	kanakʰada
ㅌㅏㅇㅣㅌㅡㄹㄱㅗㄱ	tʰaitʰɯɭɡok̚
ㅅㅜㅅㅏㄴ	sʰusʰan
ㄱㅘㅁ	kwam
ㅂㅐㅊㅜ	pɛt͡ɕʰu
ㅈㅣㄴㅎㅏㄷㅏ	t͡ɕinɦada
ㅎㅚㅇㅍㅏ	ɸweŋpʰa
ㅅㅣㄴㅋㅏㄴㅅㅔㄴ	ɕʰinkʰansʰen
ㄷㅐㅅㅓㅇㄷㅏㅇ	tɛsʰʌŋdaŋ
ㅂㅜㄷㅗ	pudo
ㄱㅓㄹ	kʌɭ
ㄱㅜㅎㅕㄴ	kuʝjʌn
ㅃㅣㄸㅜㄹㄷㅏ	pituɭda
ㄱㅖㅅㅗㄱㅎㅏㄷㅏ	kjesʰokʰada
ㅊㅗㄴㅅㅡㄹㅓㅂㄷㅏ	t͡ɕʰonsʰɯɾʌp̚ta
ㅅㅟㄴ	ʃʰɥin
ㅃㅛㅈㅗㄱㅎㅏㄷㅏ	pjod͡ʑokʰada
ㄱㅏㅈㅣㄷㅏ	kad͡ʑida
ㅅㅗㅇ	sʰoŋ
ㅂㅔㄹㄹㅏㄹㅜㅅㅡ	peɭɭaɾusʰɯ
ㅊㅏㅇㅝㄴ	t͡ɕʰawʌn
ㅊㅓㄱㅎㅏㄷㅏ	t͡ɕʰʌkʰada
ㅂㅓㅅㅡ	pʌsʰɯ
ㄷㅗㅇㅇㅣ	toŋi
ㅃㅔㅎ	pet̚
ㅎㅏㄱㄱㅜ	hak̚ku
ㅎㅓㅅ	hʌt̚
ㄴㅏㅈㅓㄹ	nad͡ʑʌɭ
ㅎㅐㅂㅏㅇ	hɛbaŋ
ㅅㅜㅇㅣㄱ	sʰuik̚
ㅋㅓㅁㅍㅠㅌㅓ	kʰʌmpʰjutʰʌ
ㄱㅡㅁㅅㅓㅇ	kɯmsʰʌŋ
ㅇㅣㅁㅁㅜ	immu
ㅇㅏㄹㅣㄸㅏㅂㄷㅏ	aɾitap̚ta
ㅂㅗㄷㅡ	podɯ
ㅂㅕㄹㅇㅣㄹ	pjʌɾiɭ
ㅇㅠㅁㅗㄱㅁㅣㄴ	jumoŋmin
ㅂㅓㅌㅓㅇ	pʌtʰʌŋ
ㅇㅣㅇㅝㄴ	iwʌn
ㅁㅏㅇㅠㄱ	majuk̚
ㅅㅔㄹㄹㅔㄴㅠㅁ	sʰeɭɭeɲjum
ㅇㅏㅁㅁㅏㄹ	ammaɭ
ㅍㅜㅇㅅㅡㅂ	pʰuŋsʰɯp̚
ㄱㅘㄴㄱㅘㅇㅎㅏㄱ	kwanɡwaŋɦak̚
ㅅㅣㅇㅗㅅ	ɕʰiot̚
ㄸㅡㅅㅂㅏㄲ	tɯt̚pak̚
ㅁㅏㄴㅗ	mano
ㅂㅏㄴㅊㅜ	paɲt͡ɕʰu
ㅅㅏㅇㅜㄹ	sʰauɭ
ㄴㅐㄴㅗㅎㄷㅏ	nɛnotʰa
ㅎㅗㅇㅇㅓㅎㅚ	ɸʷoŋʌβwe
ㅇㅢㅅㅣㅁㅉㅓㄱㄷㅏ	ɰiɕʰimt͡ɕʌk̚ta
ㄷㅓㄴㅈㅣㄹㅓㅂㄷㅏ	tɘɲd͡ʑiɾʌp̚ta
ㅍㅗㄹㄹㅣㅍㅡㄹㅗㅍㅣㄹㄹㅔㄴ	pʰoʎʎipʰɯɾopʰiɭɭen
ㅍㅏㅇㅣㅍㅡ	pʰaipʰɯ
ㅈㅏㅇㅅㅣㄱㅎㅏㄷㅏ	t͡ɕaŋɕʰikʰada
ㄱㅣㄱㅖㄷㅏㄴㅈㅓㅇ	kiɡjedaɲd͡ʑʌŋ
ㄴㅡㄹㄷㅏ	nɯɭda
ㅈㅓㅇㅅㅜㄹㅣ	t͡ɕʌŋsʰuɾi
ㅂㅏㄱㅅㅜ	paksu
ㅌㅏㄹㅇㅕㅇㅂㅕㅇ	tʰaɾjʌŋbjʌŋ
ㅂㅔㅇㅗㄱㅡㄹㅏㄷㅡ	peoɡɯɾadɯ
ㅂㅗㅊㅜㅇㅎㅏㄷㅏ	pot͡ɕʰuŋɦada
ㄱㅡㄱㅗㅅ	kɯɡot̚
ㅇㅚㄴㅅㅗㄴㅈㅏㅂㅇㅣ	wensʰoɲd͡ʑabi
ㄷㅏㅁㅂㅏㄱ	tambak̚
ㅈㅓㄱㅇㅛㅇ	t͡ɕʌɡjoŋ
ㅊㅜㄱㅇㅡㅁㄱㅣ	t͡ɕʰuɡɯmɡi
ㄱㅣㄱㅜ	kiɡu
ㅇㅏㅅㅡㅌㅏㅌㅣㄴ	asʰɯtʰatʰin
ㄱㅏㅂㅈㅏㄱㅅㅡㄹㅓㅂㄷㅏ	kap̚t͡ɕaksɯɾʌp̚ta
ㄱㅣㅇㅜㄹㅇㅣㄷㅏ	kiuɾida
ㅇㅗㄷㅣㄴ	odin
ㅈㅓㅈㅜㅎㅏㄷㅏ	t͡ɕɘd͡ʑuɦada
ㅇㅗㄱㅈㅜㅇ	ok̚t͡ɕuŋ
ㅊㅗㅇㅓ	t͡ɕʰoʌ
ㄱㅏㅁㅇㅗㄱ	kamok̚
ㄱㅏㅁㅅㅜㅎㅏㄷㅏ	kamsʰuɦada
ㄷㅏㄹㅣㅁㅣㅍㅏㄴ	taɾimipʰan
ㅇㅢㅁㅜㄴㅅㅏ	ɰimunsʰa
ㅁㅏㅇㅣㅋㅡㄹㅗㅍㅡㄹㅗㅅㅔㅅㅓ	maikxɯɾopʰɯɾosʰesʰʌ
ㅇㅏㅍㄷㅏㄹㅣ	ap̚taɾi
ㅁㅗㅎㅗㅎㅏㄷㅏ	moβoɦada
ㅅㅓㅇㄴㅑㅇ	sʰʌŋɲjaŋ
ㄱㅓㅅㅣㄱㅣ	kʌɕʰiɡi
ㅁㅜㄴㅈㅣㄴ	muɲd͡ʑin
ㄱㅣㄹㄱㅓㄹㅣ	kiɭkʌɾi
ㅂㅜㅈㅏ	pud͡ʑa
ㅈㅜㅇㅠㅅㅗ	t͡ɕujusʰo
ㅈㅔㅇㅠㅂㅓㅂ	t͡ɕejubʌp̚
ㄷㅡㄹㄹㅡㄷㅏ	tɯɭɭɯda
ㅎㅚㅇㄹㅕㅇ	ɸweŋɲjʌŋ
ㅎㅚㄱㅖㅎㅏㄱ	ɸweɡjeɦak̚
ㅁㅗㅅㅡㅋㅗㅂㅠㅁ	mosʰɯkʰobjum
ㅂㅏㅁ	pam
ㅈㅣㅈㅣㅈㅏ	t͡ɕid͡ʑid͡ʑa
ㅎㅐㄱㅕㄹㄷㅚㄷㅏ	hɛɡjʌɭdweda
ㅅㅣㄱ	ɕʰik̚
ㄴㅠㄹㅓㄴ	ɲjuɾʌn
ㅎㅏㄴㄷㅗㅇㅇㅏㄴ	handoŋan
ㄴㅣㅋㅔㄹ	nikʰeɭ
ㅂㅜㅇㅔㄴㅗㅅㅡㅇㅏㅇㅣㄹㅔㅅㅡ	puenosʰɯaiɾesʰɯ
ㅁㅏㅂㅓㅂㅅㅏ	mabʌpsa
ㅆㅏㄹㅂㅏㅂ	saɭbap̚
ㅊㅗㄱ	t͡ɕʰok̚
ㅁㅏㄹㄹㅣ	maʎʎi
ㄴㅏㄹㅣ	naɾi
ㄱㅣㅅㅜㅅㅏ	kisʰusʰa
ㅈㅓㅈ	t͡ɕʌt̚
ㅎㅜㅇㅖ	ɸʷuje
ㅍㅢㄱ	pʰik̚
ㅁㅗㄱㅌㅗㅇ	mok̚tʰoŋ
ㅈㅓㄴㄱㅜㄱㅈㅓㄱ	t͡ɕʌnɡuk̚t͡ɕʌk̚
ㅇㅣㄴㅅㅣㄱ	inɕʰik̚
ㅁㅏㄹㅡㅁㅔㄹㄹㅗ	maɾɯmeɭɭo
ㅁㅏㄴㅏㄱㅘ	manaɡwa
ㅂㅏㄱㅅㅏ	paksa
ㅇㅖㅈㅓㄴ	jed͡ʑʌn
ㄷㅗㄹㅇㅏㅂㅗㄷㅏ	toɾaboda
ㅂㅜㅎㅘㄹ	puβwaɭ
ㅌㅔㅁㅏ	tʰema
ㅈㅣㅍㅕㅇㅅㅓㄴ	t͡ɕipʰjʌŋsʰʌn
ㄷㅡㄹㅗㄴ	tɯɾon
ㅈㅜㅁㅗㄱㅎㅏㄷㅏ	t͡ɕumokʰada
ㅇㅗㅈㅗㄴ	od͡ʑon
ㅋㅗㄹㄹㅗㅁㅂㅣㅇㅏ	kʰoɭɭombia
ㄱㅜㄷㅜ	kudu
ㅅㅡㅌㅡㄹㅗ	sʰɯtʰɯɾo
ㅎㅜㅂㅗㅈㅏ	ɸʷubod͡ʑa
ㄷㅔㄹㅣㄷㅏ	teɾida
ㅌㅗㄹ	tʰoɭ
ㅁㅜㄹㅂㅓㅁ	muɭbʌm
ㄱㅡㄹㄹㅜㅌㅔㄴ	kɯɭɭutʰen
ㅂㅜㄹㄱㅡㅁ	puɭɡɯm
ㅇㅕㄲㄷㅏ	jʌk̚ta
ㅈㅓㅅㅜㅈㅣ	t͡ɕɘsʰud͡ʑi
ㄲㅜㅁㅣㄷㅏ	kumida
ㄱㅕㅇㄱㅣㄷㅗ	kjʌŋɡido
ㅇㅚㅁㅗ	wemo
ㅍㅏㅁㅏ	pʰama
ㅃㅗㅂㄷㅏ	pop̚ta
ㅁㅜㄹㄱㅕㄹㄱㅣㄹㅇㅣ	muɭɡjʌɭɡiɾi
ㅊㅓㄴㅈㅜ	t͡ɕʰʌɲd͡ʑu
ㄹㅛㄱㅡㅁ	ɾjoɡɯm
ㄱㅜㅅㅓㅇㅎㅏㄷㅏ	kusʰʌŋɦada
ㅇㅓㄷㅜㅂㄷㅏ	ʌdup̚ta
ㅎㅓㄹㄹㅓㅇㅎㅏㄷㅏ	hʌɭɭʌŋɦada
ㅇㅓㄹㅡㅁㅊㅣ	ʌɾɯmt͡ɕʰi
ㅅㅜㄹㅕㅇ	sʰuɾjʌŋ
ㅈㅜㄷㅏ	t͡ɕuda
ㅍㅏㄷㅏㄴ	pʰadan
ㅅㅡㅍㅡㄹㅣㅇㅋㅡㄹㄹㅓ	sʰɯpʰɯɾiŋkxɯɭɭʌ
ㅌㅡㄹ	tʰɯɭ
ㄴㅗㄱㅁㅏㄹ	noŋmaɭ
ㄹㅏㅇㅣㅅㅓㄴㅅㅡ	ɾaisʰʌnsʰɯ
ㅂㅗㄹㅍㅔㄴ	poɭpʰen
ㄱㅗㅌㅜ	kotʰu
ㄸㅟㅇㅓㄷㅡㄹㄷㅏ	tɥiʌdɯɭda
ㅇㅠㄹㅣㅈㅏㄴ	juɾid͡ʑan
ㄷㅐㅊㅜㄹ	tɛt͡ɕʰuɭ
ㄱㅣㄱㅏㄴ	kiɡan
ㄱㅗㄷㅈㅏㅇ	kot̚t͡ɕaŋ
ㄱㅘㅌㅔㅁㅏㄹㄹㅏ	kwatʰemaɭɭa
ㄱㅕㅇㅅㅏㅇㄴㅏㅁㄷㅗ	kjɘŋsʰaŋnamdo
ㄱㅏㄴㅈㅓㅂㅎㅘㅂㅓㅂ	kaɲd͡ʑʌpʰwabʌp̚
ㅇㅠㄴㅣㅋㅗㄷㅡ	junikʰodɯ
ㅎㅘㄹㄷㅗㅇ	ɸwaɭtoŋ
ㄹㅗ	ɾo
ㅁㅏㅅㅔㄹㅜ	masʰeɾu
ㅅㅣㅅㅓㄴ	ɕʰisʰʌn
ㅅㅣㅍ	ɕʰip̚
ㅅㅔㄹㅡㅂㅗㅋㅡㄹㅗㅇㅏㅌㅡㅇㅓ	sʰeɾɯbokxɯɾoatʰɯʌ
ㅅㅜㄱㅈㅔㅎㅏㄷㅏ	sʰuk̚t͡ɕeɦada
ㄱㅜㄱㅡㅂㅊㅏ	kuɡɯp̚t͡ɕʰa
ㅁㅗㅅㅜㄴ	mosʰun
ㄱㅏㅉㅏ	kat͡ɕa
ㅍㅣㄷ	pʰit̚
ㅂㅏㄷㅏㅅㄱㅏ	padat̚ka
ㄹㅏㅇㅣㅂㅓㄹ	ɾaibʌɭ
ㄷㅗㅇㄱㅡㄹㅏㅁㅣ	toŋɡɯɾami
ㄴㅔㅂㅏㄹㄱㅏㄹㅏㄱㄷㅗㄹㅗㅇㄴㅛㅇ	nebaɭkaɾak̚toɾoŋɲjoŋ
ㄱㅖㅈㅣㅂㅇㅏㅇㅣ	kjed͡ʑibai
ㅇㅕㄴㅎㅕㄱ	jɘnʝjʌk̚
ㅁㅕㅇㅁㅕㅇ	mjɘŋmjʌŋ
ㅎㅗㄱㅅㅓㅇ	ɸʷoksʌŋ
ㅂㅏㅇㄱㅘㅇㅇㅏㅁ	paŋɡwaŋam
ㅂㅏㅊㅣㄷㅏ	pat͡ɕʰida
ㅇㅕㅁㅈㅜ	jɘmd͡ʑu
ㅁㅏㄹㅕㄴㅎㅏㄷㅏ	maɾjʌnɦada
ㄱㅏㅅㅣㄴㅏ	kaɕʰina
ㅊㅣㅇㅎㅗ	t͡ɕʰiŋβo
ㅇㅜㄴㅁㅕㅇ	unmjʌŋ
ㄹㅏㅌㅡㅂㅣㅇㅏㅇㅓ	ɾatʰɯbiaʌ
ㄸㅜㄱㅅㅓㅁ	tuksʌm
ㅁㅓㅈㄷㅏ	mʌt̚ta
ㄱㅕㅇㅇㅗㄱ	kjʌŋok̚
ㅇㅣㄴㄹㅠㅎㅏㄱ	iʎʎjuɦak̚
ㅎㅘㄴㅏㄷㅏ	ɸwanada
ㅂㅜㅌㅇㅣㄷㅏ	put͡ɕʰida
ㄱㅓㅇㅜㄹ	kʌuɭ
ㄱㅘㄷㅡㄹㄹㅜㅃㅡ	kwadɯɭɭupɯ
ㄷㅚㅍㅜㄹㅇㅣㅎㅏㄷㅏ	twepʰuɾiɦada
ㅍㅣㄹㅏㅈㅣㄴ	pʰiɾad͡ʑin
ㅎㅔㅅㅡㅌㅣㅇㅏ	hesʰɯtʰia
ㅁㅏㄹㄱㅗㄱㅣ	maɭɡoɡi
ㅂㅗㄴㅌㅗ	pontʰo
ㅁㅕㄴㄷㅗ	mjɘndo
ㅍㅗㄱㅣ	pʰoɡi
ㅈㅏㅇㅂㅣ	t͡ɕaŋbi
ㅁㅕㄴㅅㅓ	mjʌnsʰʌ
ㅂㅓㄹㄱㅡㅁ	pʌɭɡɯm
ㄱㅡㅁㅅㅣㅊㅗㅁㅜㄴ	kɯmɕʰit͡ɕʰomun
ㅊㅜㅁㄲㅜㄴ	t͡ɕʰumkun
ㄱㅟㅊㅏㄶㄷㅏ	kɥit͡ɕʰantʰa
ㄹㅣㅇㅝㄴ	ɾiwʌn
ㅇㅣㅇㅛㅇㅎㅏㄷㅏ	ijoŋɦada
ㅇㅣㅅㅡㄹㄹㅏㅁㄱㅜㄱㄱㅏ	isʰɯɭɭamɡuk̚ka
ㅃㅕㅂ	pjʌp̚
ㄱㅣㄹㅏㅅㅓㅇ	kiɾasʰʌŋ
ㅁㅜㅅㅗㄱㅇㅣㄴ	musʰoɡin
ㄱㅡㄹㅈㅏ	kɯʎt͡ɕa
ㄱㅖㅅㅣㅍㅏㄴ	kjeɕʰipʰan
ㅇㅏㅇㄱㅗㄹㄹㅏ	aŋɡoɭɭa
ㅇㅓㅁㄱㅕㄱ	ʌmkjʌk̚
ㄱㅣㄴㅕㅁㄱㅘㄴ	kiɲjʌmɡwan
ㅎㅏㅇㅇㅏㅁㅈㅔ	haŋamd͡ʑe
ㅁㅏㅁㅁㅏ	mamma
ㅁㅏㄴㅅㅣㄴ	manɕʰin
ㅇㅖㄹㅜㅅㅏㄹㄹㅔㅁ	jeɾusʰaɭɭem
ㅅㅗㄹㄱㅣㅅㅎㅏㄷㅏ	sʰoɭɡitʰada
ㄱㅏㄹㅗㄷㅡㅇ	kaɾodɯŋ
ㅌㅗㅇㅛㅇㅣㄹ	tʰojoiɭ
ㅇㅏㅂㅔㄹ	abeɭ
ㅂㅗㅈㅡㅇ	pod͡ʑɯŋ
ㅅㅜㄹㅗㄱ	sʰuɾok̚
ㅅㅏㅅㅡ	sʰasʰɯ
ㅂㅓㄴㅇㅕㄱㅈㅏ	pʌɲjʌk̚t͡ɕa
ㄴㅡㄲㅣㅎㅏㄷㅏ	nɯkiɦada
ㅈㅓㅇㅅㅏㅇ	t͡ɕʌŋsʰaŋ
ㅇㅏㅅㅣㅇㅏ	aɕʰia
ㄱㅓㅊㅣㅈㅓㄱㄱㅓㄹㅣㄷㅏ	kʌt͡ɕʰid͡ʑʌk̚kʌɾida
ㅅㅡㅇㅎㅏㅂㅊㅏ	sʰɯŋɦap̚t͡ɕʰa
ㅁㅣㅇㅛㅇㅇㅝㄴ	mijoŋwʌn
ㅅㅔㄹㅡㅂㅣㅇㅏㅇㅓ	sʰeɾɯbiaʌ
ㄷㅐㅎㅘ	tɛβwa
ㅎㅏㅇㅑㅎㄷㅏ	hajatʰa
ㅁㅗㄱㅍㅛ	mok̚pʰjo
ㅇㅓㅇㄷㅓㅇㅂㅏㅇㅇㅏ	ɘŋdʌŋbaŋa
ㅈㅣㄱㄱㅏㅁ	t͡ɕik̚kam
ㅇㅣㄹㅂㅗㄴㄱㅜㄱ	iɭbonɡuk̚
ㅍㅓㅈㅡㄹ	pʰʌd͡ʑɯɭ
ㅋㅓ	kʰʌ
ㅅㅡㅁㅕㄷㅡㄹㄷㅏ	sʰɯmjʌdɯɭda
ㅈㅓㄴㅈㅏ	t͡ɕɘɲd͡ʑa
ㅇㅠㅋㅏㅌㅏ	jukʰatʰa
ㅅㅏㅇㅣㅂㅗㄱㅡ	saiboɡɯ
ㅅㅏㄹㄱㅏㅊ	sʰaɭɡat̚
ㅂㅜㄹㅅㅏㅇㅅㅏ	puɭsaŋsʰa
ㅅㅏㄻ	sʰam
ㅇㅣㄴㅌㅓㅍㅔㅇㅣㅅㅡ	intʰʌpʰeisʰɯ
ㅇㅑㅈㅏㄴㅏㅁㅜ	jad͡ʑanamu
ㄱㅕㄴㅇㅠ	kjʌɲju
ㄷㅜㅁㅏ	tuma
ㅋㅗㅂㅡㄹㅏ	kʰobɯɾa
ㄷㅟㅉㅗㅊㄷㅏ	tɥit͡ɕot̚ta
ㅁㅗㄹㄷㅗㅂㅏ	moɭdoba
ㄷㅣㅈㅏㅇㅣㄴ	tid͡ʑain
ㄱㅏㅁㅜㄴ	kamun
ㅅㅗㅁㅕㄹ	sʰomjʌɭ
ㅅㅓㄹㅅㅏ	sʰʌɭsa
ㄹㅗㅂㅗㅅ	ɾobot̚
ㅈㅏㄲㅜ	t͡ɕaku
ㅇㅡㅁㅅㅣㄱㄱㅏㅄ	ɯmɕʰik̚kap̚
ㅎㅏㄱㅅㅡㅂㅎㅏㄷㅏ	haksɯpʰada
ㅈㅗ	t͡ɕo
ㅊㅟㄱㅡㅂ	t͡ɕʰɥiɡɯp̚
ㅂㅜㄹㅓㅁㅇㅓㅄㄷㅏ	puɾʌmʌp̚ta
ㅂㅗㄱㅈㅏㅂㅎㅏㄷㅏ	pok̚t͡ɕapʰada
ㄷㅏㅋㅏㄹㅡ	takʰaɾɯ
ㅂㅏㅅㅜㄷㅏ	pasʰuda
ㅅㅜㅅㅏㅇㅎㅏㄷㅏ	sʰusʰaŋɦada
ㄱㅡㄹㄹㅣㅅㅔㄹㅗㄹ	kɯʎʎisʰeɾoɭ
ㅌㅡㄹㅗㄹㄹㅣ	tʰɯɾoʎʎi
ㄱㅡㅁㅜㄹ	kɯmuɭ
ㅅㅓㅇ	sʰɘŋ
ㅂㅏㄴㅇㅕㅇㅎㅏㄷㅏ	paɲjʌŋɦada
ㄱㅝㄴㅌㅜ	kwʌntʰu
ㅂㅗㄴㅅㅏ	ponsʰa
ㄸㅗㅁㅇㅑㅁ	tomjam
ㅎㅐㅅㅓㄱㅈㅏ	hɛsʰʌk̚t͡ɕa
ㅇㅜㅂㅅㅏㄹㄹㅏ	upsaɭɭa
ㅅㅏㅇㅓㅂㅈㅜ	sʰaʌp̚t͡ɕu
ㅈㅣㄴㅅㅣㄹㅎㅏㄷㅏ	t͡ɕinɕʰiɾɦada
ㅂㅜㄹㄲㅏㄷㅏ	puɭkada
ㄷㅏㄴㅇㅡㅁ	tanɯm
ㅅㅡㄹㅅㅡㄹ	sʰɯɭsʰɯɭ
ㅌㅏㄱㅈㅏ	tʰak̚t͡ɕa
ㄴㅗㄴㄹㅣ	noʎʎi
ㄱㅏㄱㅕㄱ	kaɡjʌk̚
ㅈㅜㄹㅇㅓㄷㅡㄹㄷㅏ	t͡ɕuɾʌdɯɭda
ㅅㅣㅈㅔ	ɕʰid͡ʑe
ㅅㅣㅁㅍㅔㄹㅗㅍㅗㄹ	ɕʰimpʰeɾopʰoɭ
ㄱㅝㄴㅇㅟ	kwʌnɥi
ㅅㅓㄱㄹㅠ	sʰʌŋɲju
ㅊㅏㅇㅍㅗㄱㅓㅁ	t͡ɕʰaŋpʰoɡʌm
ㄴㅔㄱㅌㅏㅇㅣ	nek̚tʰai
ㅅㅓㅇㅅㅓ	sʰɘŋsʰʌ
ㅋㅔㅇㅣㅂㅡㄹ	kʰeibɯɭ
ㄴㅗㄱㅗㅈㅣㄹㅣ	noɡod͡ʑiɾi
ㄸㅟㅇㅓㄱㅏㄷㅏ	tɥiʌɡada
ㅈㅗㅅㅓㄴㅂㅗㅇㄱㅓㄴㅇㅘㅇㅈㅗ	t͡ɕosʰʌnboŋɡʌnwaŋd͡ʑo
ㅆㅡㄹㅇㅓㅇㅣㄹㅇㅓㄴㅏㄷㅏ	sɯɾʌiɾʌnada
ㅅㅣㅍㅕㄴ	ɕʰipʰjʌn
ㅁㅓㄴㅈㅣ	mʌɲd͡ʑi
ㅂㅜㄷㅜ	pudu
ㅇㅜㅁ	um
ㄹㅜㅅㅏㅋㅏ	ɾusʰakʰa
ㅊㅏㄱㄹㅠㄱ	t͡ɕʰaŋɲjuk̚
ㅇㅓㅁㅣ	ʌmi
ㅇㅓㅇㅝㄴ	ɘwʌn
ㅇㅕㄹㅈㅓㅇ	jʌʎd͡ʑʌŋ
ㄴㅏㅁㅇㅏㅁㅔㄹㅣㅋㅏ	namameɾikʰa
ㅍㅡㄹㄹㅏㅅㅡㅋㅡ	pʰɯɭɭasʰɯkxɯ
ㅂㅜㅊㅓ	put͡ɕʰʌ
ㄸㅏㄹㅏㅅㅓ	taɾasʰʌ
ㅈㅣㅂㅌㅗㄲㅣ	t͡ɕip̚tʰoki
ㅁㅏㅈㅂㅓㄹㅇㅣ	mat̚pʌɾi
ㅁㅜㄹㄱㅗㅇㅇㅝㄴ	muɭɡoŋwʌn
ㅈㅏㅁㅈㅏㄷㅏ	t͡ɕamd͡ʑada
ㄴㅓㅁㄱㅣㄷㅏ	nʌmɡida
ㅈㅓㄱㅇㅚㅅㅓㄴ	t͡ɕʌɡwesʰʌn
ㅇㅏㄴㅎㅜㅇㅣ	anβui
ㅁㅏㄹㅜ	maɾu
ㅂㅏㄹㅍㅛㄷㅚㄷㅏ	paɭpʰjodweda
ㅇㅕㄷㅡㄴ	jʌdɯn
ㅂㅜㄹㅍㅣㄹㅇㅛㅎㅏㄷㅏ	puɭpʰiɾjoɦada
ㄲㅏㄹㄲㅡㅁㅎㅏㄷㅏ	kaɭkɯmɦada
ㅇㅟㅇㅏㄴㅂㅜ	ɥianbu
ㅊㅓㄹㄷㅗㅇㅕㄱ	t͡ɕʰʌɭtojʌk̚
ㄴㅗㅎㅊㅣㄷㅏ	not̚t͡ɕʰida
ㅅㅏㅈㅓㄴ	sʰad͡ʑʌn
ㅁㅏㅅㅡㅌㅓㅂㅔㅇㅣㅅㅕㄴ	masʰɯtʰʌbeiɕʰʌn
ㅍㅕㄴㄱㅕㄴ	pʰjʌnɡjʌn
ㅇㅚㅇㅣㄴ	wein
ㄸㅏㅅㅈㅟ	tat̚t͡ɕɥi
ㅁㅗㅍㅔㄷㅡ	mopʰedɯ
ㅂㅔㄹㅌㅡ	peɭtʰɯ
ㅍㅡㄱ	pʰɯk̚
ㅇㅕㄴㄱㅕㄹㄷㅚㄷㅏ	jʌnɡjʌɭdweda
ㅇㅣㄴㅈㅜㅇ	iɲd͡ʑuŋ
ㅅㅏㅁㄱㅖㅌㅏㅇ	sʰamɡjetʰaŋ
ㅁㅗㄱㅇㅛㅇㅣㄹ	moɡjoiɭ
ㅊㅓㄹㅌㅚ	t͡ɕʰʌɭtʰwe
ㅂㅜㅇㅏ	pua
ㅁㅣㄱㅜㄱ	miɡuk̚
ㅍㅣㄱ	pʰik̚
ㅈㅣㄴㅇㅏㅂㅎㅏㄷㅏ	t͡ɕinapʰada
ㅊㅓㄹㅈㅏㅂㅓㅂ	t͡ɕʰʌʎt͡ɕapʌp̚
ㅉㅣㄱㄷㅏ	t͡ɕik̚ta
ㅇㅡㅁㅇㅏㄱㅎㅚ	ɯmakʰwe
ㅇㅗㅃㅏ	opa
ㅇㅣㅌㅏㄴ	itʰan
ㅈㅣㄹㄴㅕ	t͡ɕiʎʎjʌ
ㅊㅓㅇㅅㅗㄱㅣ	t͡ɕʰʌŋsʰoɡi
ㅅㅔㅁ	sʰem
ㅎㅗㄹㅇㅓㅁㅣ	ɸʷoɾʌmi
ㄷㅗㅇㅅㅏㄹㅣ	toŋsʰaɾi
ㅋㅗㄴㅏㅋㅡㄹㅣ	kʰonakxɯɾi
ㄴㅗㄹㅕㄱ	noɾjʌk̚
ㄷㅚㄷㅏ	tweda
ㅅㅣㅁㄹㅣ	ɕʰimni
ㅊㅓㅇㅊㅓㄴ	t͡ɕʰʌŋt͡ɕʰʌn
ㄱㅏㅅㅏ	kasʰa
ㅇㅓㄹㅡㄷㅏ	ɘɾɯda
ㅇㅟㅅㅓㅇ	ɥisʰʌŋ
ㅊㅣㅇㅎㅏㅇㅣ	t͡ɕʰiŋɦai
ㅂㅏㅇㅟ	paɥi
ㅂㅣㄱㅗ	piɡo
ㅇㅜㄴㄴㅏㅁ	unnam
ㅅㅏㅂㅏㅇ	sʰabaŋ
ㅇㅝㄴㅇㅣㄴ	wʌnin
ㅇㅣㅁㅁㅏㄴㅜㅇㅔㄹ	immanueɭ
ㅅㅡㅇㅘㅈㅣㄹㄹㅏㄴㄷㅡ	sʰɯwad͡ʑiɭɭandɯ
ㄱㅓㄹㅜㄱㅎㅏㄷㅏ	kɘɾukʰada
ㅇㅓㄴㅉㅏㄶㄷㅏ	ʌɲt͡ɕantʰa
ㅁㅏㅇㅇㅕㄴㅎㅏㄷㅏ	maŋjʌnɦada
ㅇㅕㄴㅇㅓ	jʌnʌ
ㅁㅏㅋㅔㅅ	makʰet̚
ㅈㅣㄴㅂㅗ	t͡ɕinbo
ㄱㅏㅁㄹㅏㅁ	kamnam
ㄱㅕㅇㅁㅏ	kjɘŋma
ㄴㅗㅍㅇㅏㅈㅣㄷㅏ	nopʰad͡ʑida
ㅇㅡㅅㅡㅅㅡㅎㅏㄷㅏ	ɯsʰɯsʰɯɦada
ㅁㅏㅇㅅㅓㄹㅇㅣㄷㅏ	maŋsʰʌɾida
ㅅㅏㄹㄱㅜ	sʰaɭɡu
ㅇㅣㅂㄷㅓㅅ	ip̚tʌt̚
ㅍㅛㅁㅕㄴ	pʰjomjʌn
ㅁㅏㄴㅣㄹㄹㅏ	maniɭɭa
ㄹㅔㅇㅏㄹㄹㅣㅈㅡㅁ	ɾeaʎʎid͡ʑɯm
ㅋㅏㄹㄹㅠㅁ	kʰaʎʎjum
ㄱㅜㄱㅃㅗㅇ	kuk̚poŋ
ㄱㅣㄹ	kiɭ
ㅌㅗㅁㅏㅌㅗ	tʰomatʰo
ㅇㅡㅅㅡㄹㅓㄸㅡㄹㅣㄷㅏ	ɯsʰɯɾʌtɯɾida
ㅅㅏㄹㅍㅣㄷㅏ	sʰaɭpʰida
ㅈㅓㅅㄷㅏ	t͡ɕɘt̚ta
ㄱㅡㄴㅏㅁㅏ	kɯnama
ㅇㅗㅎㅜ	oβu
ㅂㅏㅇㅅㅗㅇㅎㅏㄷㅏ	paŋsʰoŋɦada
ㅇㅘㄴㅅㅓㅇ	wansʰʌŋ
ㄴㅕㄴㄱㅡㅁ	ɲjʌnɡɯm
ㄱㅓㅊㅣㄹㄷㅏ	kʌt͡ɕʰiɭda
ㅂㅏㄴㅇㅣㅂㅈㅏ	panip̚t͡ɕa
ㅇㅣㅇㅓㅈㅣㄷㅏ	iʌd͡ʑida
ㅎㅐㅅㅓㄱ	hɛsʰʌk̚
ㅈㅓㅇㅎㅘㅇ	t͡ɕʌŋβwaŋ
ㅍㅕㄴㅈㅗㅇ	pʰjʌɲd͡ʑoŋ
ㄱㅏㅁㄷㅏㅇㅎㅏㄷㅏ	kamdaŋɦada
ㅂㅣㄱㅣㄷㅏ	piɡida
ㅋㅏㅍㅡㄹ	kʰapʰɯɭ
ㅁㅜㄹㄱㅗㄱㅣㄸㅓㄱ	muɭɡoɡitʌk̚
ㄷㅓㅅㅂㅜㅌㄷㅏ	tʌt̚put̚ta
ㅂㅏㄴㅂㅏㄴ	panban
ㄱㅣㅇㅗㄴ	kion
ㅂㅏㅁㅊㅏㅁ	pamt͡ɕʰam
ㅇㅑㅂㅣㅎㅏㄷㅏ	jabiɦada
ㅋㅗㅎㅔㄹㄹㅔㅅ	kʰoɦeɭɭet̚
ㅈㅓㅇㄱㅣ	t͡ɕɘŋɡi
ㅈㅓㅇㅅㅓㅇ	t͡ɕʌŋsʰʌŋ
ㄹㅏㅇㅣㅌㅓ	ɾaitʰʌ
ㄱㅘㄴㄹㅣㅈㅏ	kwaʎʎid͡ʑa
ㅈㅗㅋㅏ	t͡ɕokʰa
ㅈㅏㅈㅏㄱ	t͡ɕad͡ʑak̚
ㅂㅐㄱㅅㅏㅌㅏㅇ	pɛksatʰaŋ
ㅅㅗㄷㅜ	sʰodu
ㅇㅑㅇㅅㅜㅅㅏ	jaŋsʰusʰa
ㄴㅗㅇ	noŋ
ㅋㅋㅋ	kxɯkxɯkxɯ
ㄱㅗㅁㅣㄴ	komin
ㅈㅜㅇㅣㄴ	t͡ɕuin
ㄱㅏㄹㅏㅇㅗㅋㅔ	kaɾaokʰe
ㅅㅜㅍㅣㄹ	sʰupʰiɭ
ㄱㅏㅁㅏㅇㅜㅈㅣ	kamaud͡ʑi
ㅎㅘㅇㅎㅏ	ɸwaŋɦa
ㄷㅗㅇㅣㅊㅟㄹㄹㅏㄴㄷㅡ	toit͡ɕʰɥiɭɭandɯ
ㄱㅣㄴㅡㅇ	kinɯŋ
ㄲㅜㄹㅓㅁㅣ	kuɾʌmi
ㅈㅜㅂㅏ	t͡ɕuba
ㅂㅏㅇㅅㅗㅇㅅㅏㄱㅗ	paŋsʰoŋsʰaɡo
ㄲㅓㄲㅇㅓㅈㅣㄷㅏ	kʌkʌd͡ʑida
ㄱㅜㅇㅛ	kujo
ㅋㅜㅅㅕㄴ	kʰuɕʰʌn
ㅇㅣㄴㅈㅡㅇ	iɲd͡ʑɯŋ
ㅎㅘㅁㅜㄹ	ɸwamuɭ
ㄷㅗㄷㅏㄹ	todaɭ
ㄱㅗㄹㅌㅏㄴ	koɭtʰan
ㄱㅡㄹㄹㅏㅅㅡ	kɯɭɭasʰɯ
ㄱㅏㄴㅣㅅ	kanit̚
ㄹㅏㅍㅏㅅㅡ	ɾapʰasʰɯ
ㄱㅏㅇㅟㅂㅏㅇㅟㅂㅗ	kaɥibaɥibo
ㅈㅣㅎㅖ	t͡ɕiʝje
ㄱㅔㄹㅡㅁㅏㄴ	keɾɯman
ㅁㅏㅈㅊㅜㅁ	mat̚t͡ɕʰum
ㅇㅣㅁㅅㅣㄴㅂㅜ	imɕʰinbu
ㄱㅗㅇㅏ	koa
ㅁㅏㅇㅣㄴㅓㅅㅡ	mainʌsʰɯ
ㅁㅜㄹㄷㅡㄹㅇㅣㄷㅏ	muɭdɯɾida
ㅅㅏㅇㅍㅛ	sʰaŋpʰjo
ㄴㅏㅈㅜㅇ	nad͡ʑuŋ
ㅂㅣㅅㅡㅋㅔㅅ	pisʰɯkʰet̚
ㅎㅘㄴㄷㅗ	ɸwando
ㄱㅓㅌㅎㅏㄾㄷㅏ	kʌtʰaɭta
ㅅㅜㄹㅇㅓ	sʰuɾʌ
ㄷㅗㄱㅅㅣㄴㅈㅏ	tokɕiɲd͡ʑa
ㅊㅜㄹㅈㅏㅇ	t͡ɕʰuʎt͡ɕaŋ
ㅂㅜㄴㅁㅗ	punmo
ㅅㅜㅈㅓ	sʰud͡ʑʌ
ㅌㅜ	tʰu
ㅊㅣㅇㅡㅊ	t͡ɕʰiɯt̚
ㅂㅏㄴㅂㅗㄱㅎㅏㄷㅏ	panbokʰada
ㅈㅣㄱㅇㅓㅂ	t͡ɕiɡʌp̚
ㅇㅣㅈㅎㅕㅈㅣㄷㅏ	it͡ɕʰʌd͡ʑida
ㅇㅓㄹㅕㅇㅜㅁ	ʌɾjʌum
ㅍㅕㅇㅅㅓㅇ	pʰjʌŋsʰʌŋ
ㅂㅣㄷㅏㄴㅌㅓㄹㄷㅡㅇㅈㅜㄹㅈㅟ	pidantʰʌɭdɯŋd͡ʑuʎd͡ʑɥi
ㅇㅖㅁㅜㄹ	jemuɭ
ㄷㅐㄱㅣ	tɛɡi
ㅇㅣㄴㅇㅕㄴ	iɲjʌn
ㅅㅣㄴㅅㅔㄱㅖ	ɕʰinsʰeɡje
ㄷㅏㄴㅁㅜㄹ	tanmuɭ
ㅂㅗ	po
ㅈㅏㅇㅅㅏ	t͡ɕaŋsʰa
ㅂㅜㄴㅅㅜㄹㅕㅇ	punsʰuɾjʌŋ
ㄱㅗㄹㅣㅉㅏㄱ	koɾit͡ɕak̚
ㅈㅣㄴㄹㅛㅅㅗ	t͡ɕiʎʎjosʰo
ㅂㅡㄹㅏㅌㅣㅅㅡㄹㄹㅏㅂㅏ	pɯɾatʰisʰɯɭɭaba
ㅈㅓㄱㅈㅏ	t͡ɕʌk̚t͡ɕa
ㅂㅜㄹㄹㅏㄴㅅㅓ	puɭɭansʰʌ
ㅅㅛㅇㅟㄴㄷㅗ	ɕʰoɥindo
ㄴㅗㄹㅇㅣㄱㅗㅇㅇㅝㄴ	noɾiɡoŋwʌn
ㅇㅗㄴㄷㅗㄱㅖ	ondoɡje
ㄴㅜㄹㅣㅈㅣㅂ	nuɾid͡ʑip̚
ㅂㅜㄷㅡㄹㅓㅂㄷㅏ	pudɯɾʌp̚ta
ㅅㅓㄹㄱㅖㄷㅗ	sʰʌɭɡjedo
ㅁㅣㄹㅗ	miɾo
ㅈㅣㄱㅂㅏㄹ	t͡ɕik̚paɭ
ㅅㅣㄱㅇㅛㄱ	ɕʰiɡjok̚
ㅁㅓㅅㅈㅣㄷㅏ	mʌt̚t͡ɕida
ㅇㅣㄱㅡㄹㅇㅣㄱㅡㄹ	iɡɯɾiɡɯɭ
ㅁㅓㅅㅡㅁ	mʌsʰɯm
ㅎㅗㄹㅅㅗㄹㅣ	ɸʷoɭsoɾi
ㄲㅜㄹㅣㄷㅏ	kuɾida
ㅈㅏㄱㅇㅡㄴㄱㅘㄴㅋㅗㅂㅏㄱㅈㅟ	t͡ɕaɡɯnɡwankʰobak̚t͡ɕɥi
ㅈㅓㅈㅣ	t͡ɕʌd͡ʑi
ㅍㅕㄴㅈㅏ	pʰjʌɲd͡ʑa
ㅊㅗㄱㄱㅏㄱ	t͡ɕʰok̚kak̚
ㅁㅓㅇㅎㅏㄷㅏ	mɘŋɦada
ㅟ	ɥi
ㅅㅏㄴㅏㅇㅣ	sʰanai
ㄱㅜㄴㅊㅔ	kuɲt͡ɕʰe
ㄱㅔㄴㅗㅁ	kenom
ㅃㅏㅈㅕㄴㅏㄱㅏㄷㅏ	pad͡ʑʌnaɡada
ㅅㅣㅁㅎㅗㄴ	ɕʰimβon
ㅊㅜㅇㄷㅗㄹ	t͡ɕʰuŋdoɭ
ㅂㅏㄴ	pan
ㅎㅏㅅㅠㅁ	haɕʰum
ㄷㅗㅇㅎㅘ	toŋβwa
ㅇㅗㅅㅏㅈㅗㄴ	osʰad͡ʑon
ㅇㅏㅁㅜㄹㅓㄴ	amuɾʌn
ㄴㅕㅁ	ɲjʌm
ㅇㅏㅁㅅㅣㄹ	amɕʰiɭ
ㅂㅏㅂㅗ	pabo
ㄷㅏㄹㅡㅁㅅㅠㅌㅏㅌㅠㅁ	taɾɯmɕʰutʰatʰjum
ㄲㅡㄹㅡㄷㅏ	kɯɾɯda
ㅈㅣㅇㅝㄴㅎㅏㄷㅏ	t͡ɕiwʌnɦada
ㅇㅗㅂㅡㄹㄹㅏㅅㅡㅌㅣ	obɯɭɭasʰɯtʰi
ㅇㅑㅅㅣㅁ	jaɕʰim
ㅇㅝㄴㅁㅜㄴ	wʌnmun
ㅇㅐ	ɛ
ㄱㅡㅁㅅㅔ	kɯmsʰe
ㄴㅗㄹㅕㅂㅗㄷㅏ	noɾjʌboda
ㅎㅚㄹㅕㅇ	ɸweɾjʌŋ
ㅂㅜㄹㅜㅌㅜㅇㅇㅣ	puɾutʰuŋi
ㄷㅗㄹㄱㅗㄱㅣ	toɭɡoɡi
ㅂㅗㅇㄱㅣ	poŋɡi
ㅆㅏㅇㄷㅣㄱㅡㄷ	saŋdiɡɯt̚
ㅅㅡㄹㄹㅗㅂㅔㄴㅣㅇㅏ	sʰɯɭɭobenia
ㅌㅗㄹㅠㅁ	tʰoɾjum
ㅇㅑㅇㅇㅜ	jaŋu
ㄷㅐㅇㅡㅇㅎㅏㄷㅏ	tɛɯŋɦada
ㅅㅏㄺ	sʰak̚
ㅋㅏㄴㄷㅔㄹㄹㅏ	kʰandeɭɭa
ㄱㅖㅅㅏㄴ	kjesʰan
ㅂㅗㅅㅡㄴㅣㅇㅏ	posʰɯnia
ㄷㅡㄹㅓㄴㅏㄷㅏ	tɯɾʌnada
ㅅㅗㅇㅟ	sʰoɥi
ㅅㅗㅂㅣㅈㅏ	sʰobid͡ʑa
ㅂㅕㅇㄱㅣㄱㅗ	pjʌŋɡiɡo
ㄴㅏㅇㅂㅣ	naŋbi
ㅍㅕㄹ	pʰjʌɭ
ㅈㅜㅇㄹㅣㅂ	t͡ɕuŋnip̚
ㅌㅜㅍㅛ	tʰupʰjo
ㅎㅗㄹㅣ	ɸʷoɾi
ㅅㅣㄹㅅㅣㄷㅚㄷㅏ	ɕʰiɭɕʰidweda
ㄱㅛㅎㅚ	kjoβwe
ㅈㅏㄹㅁㅗㅅㅎㅏㄷㅏ	t͡ɕaɭmotʰada
ㅎㅏㄴㄱㅡㄹㄴㅏㄹ	hanɡɯɭɭaɭ
ㅉㅏㅂㅉㅏㄹㅎㅏㄷㅏ	t͡ɕap̚t͡ɕaɾɦada
ㅁㅗㄱㅅㅓㅇ	moksʌŋ
ㅅㅗㄴㅕㄴㄱㅜㅇㅈㅓㄴ	sʰoɲjʌnɡuŋd͡ʑʌn
ㄱㅏㅁㄱㅏㄱ	kamɡak̚
ㄱㅏㄲㅏㅂㄷㅏ	kakap̚ta
ㅅㅣㄹㅁㅏㅇ	ɕʰiɭmaŋ
ㅎㅏㄹㅏㄹㅔ	haɾaɾe
ㅅㅣㅁㄱㅏㄱㅎㅏㄷㅏ	ɕʰimɡakʰada
ㅅㅗㄲㅜㅂㄷㅗㅇㅁㅜ	sʰokup̚toŋmu
ㄴㅗㄱㅊㅏ	nok̚t͡ɕʰa
ㅇㅓㅁㅊㅣㄴㅇㅏ	ʌmt͡ɕʰina
ㅂㅏㄹㅏㄷㅏ	paɾada
ㅅㅗㄴㄱㅏㅂㅏㅇ	sʰonɡabaŋ
ㅇㅑㅁㅏㄴㅇㅣㄴ	jamanin
ㅈㅜㅅㅣㄱ	t͡ɕuɕʰik̚
ㅊㅣㅁㅅㅜㄹ	t͡ɕʰimsʰuɭ
ㅅㅑㅉㅡ	ɕʰat͡ɕɯ
ㄱㅣㅈㅓㄱㅟ	kid͡ʑʌɡɥi
ㄷㅗㄹㄹㅕㅈㅜㄷㅏ	toʎʎjʌd͡ʑuda
ㄴㅡㄺㄷㅏㄹㅣ	nɯk̚taɾi
ㅎㅘㄴㅈㅏ	ɸwaɲd͡ʑa
ㅁㅓㄹㅉㅣㄱㅏㅁㅊㅣ	mʌʎt͡ɕiɡamt͡ɕʰi
ㄱㅗㅊㅜ	kot͡ɕʰu
ㅁㅏㅇㅅㅣㅁㅣㄴ	maŋɕʰimin
ㅋㅜ	kʰu
ㅈㅏㅇㅠㅇㅢㅈㅣㅈㅜㅇㅢ	t͡ɕajuɰid͡ʑid͡ʑuɰi
ㅅㅏㅁㅊㅗ	sʰamt͡ɕʰo
ㅁㅣㄹㅌㅗㅇ	miɭtʰoŋ
ㅋㅏㄹㅔㄴㄷㅓ	kʰaɾendʌ
ㅅㅗㄷㅡㄱ	sʰodɯk̚
ㅋㅏㄹㅅㅏㅇㅇㅓ	kʰaɭsʰaŋʌ
ㅈㅣㅅㅣ	t͡ɕiɕʰi
ㄱㅏㅁㅏ	kama
ㅁㅗㄱㅛ	moɡjo
ㅈㅏㅇㅁㅏ	t͡ɕaŋma
ㅎㅡㅇ	xɯŋ
ㅊㅗㄱㅗㅅㅗㄱ	t͡ɕʰoɡosʰok̚
ㅎㅘㅇㄹㅗ	ɸwaŋno
ㅈㅏㅍㅏㄴ	t͡ɕapʰan
ㄱㅜㄱㅁㅕㄴ	kuŋmjʌn
ㅌㅏㅁ	tʰam
ㅅㅡㅂㄱㅣ	sʰɯp̚ki
ㅎㅏㅂㅊㅣㄷㅏ	hap̚t͡ɕʰida
ㄱㅣㅌㅏ	kitʰa
ㅂㅣㅅㅡㅁㅜㅌㅡ	pisʰɯmutʰɯ
ㅂㅏㄴㅂㅏㄹ	panbaɭ
ㅇㅛㅇㅈㅣ	joŋd͡ʑi
ㅅㅏㄱㅕㄱ	sʰaɡjʌk̚
ㅈㅜㅅㅡ	t͡ɕusʰɯ
ㅁㅣㅎㅗㄴㅁㅗ	miβonmo
ㅁㅗㅇㅣㅁ	moim
ㅍㅏㅌ	pʰat̚
ㅇㅛㄱㅅㅣㄹ	jokɕiɭ
ㄱㅏㄴㅅㅏㅎㅏㄷㅏ	kansʰaɦada
ㅁㅗㄱㅊㅓㅇㄲㅓㅅ	mok̚t͡ɕʰʌŋkʌt̚
ㅍㅔㄴ	pʰen
ㅇㅞㅇㅣㅌㅓ	weitʰʌ
ㅇㅗㄹㅇㅕㄹㅡㅁ	oʎʎjʌɾɯm
ㅅㅏㅅㅣㄹㅅㅏㅇ	sʰaɕʰiɭsaŋ
ㅍㅕㄹㅊㅣㄷㅏ	pʰjʌʎt͡ɕʰida
ㅂㅗㄱㅅㅜㅇㅇㅏ	poksuŋa
ㄱㅘㅇㅇㅓㅂ	kwaŋʌp̚
ㅇㅏㅂㄸㅗㅂㅜㅅㅡ	ap̚tobusʰɯ
ㅈㅣㅎㅏㅊㅓㄹ	t͡ɕiɦat͡ɕʰʌɭ
ㄲㅗㅁㅏㅊㅓㅇㅎㅘㅇ	komat͡ɕʰʌŋβwaŋ
ㅎㅐㅇㅚ	hɛwe
ㅁㅏㅎㅡㄴ	maɣɯn
ㅁㅏㄴㅎㅘㄱㅏ	manβwaɡa
ㅈㅗㅈㅏㄱ	t͡ɕod͡ʑak̚
ㅅㅣㄱㅏㄱ	ɕʰiɡak̚
ㄱㅘㄱㅓ	kwaɡʌ
ㄲㅗㅊㅁㅣㄴㅏㅁ	konminam
ㄱㅗㄹ	koɭ
ㅎㅘㅇㅣㅌㅣㅇ	ɸwaitʰiŋ
ㄱㅘㄴㅂㅗㄱ	kwanbok̚
ㄱㅜㅂㅕㄹ	kubjʌɭ
ㄱㅘㄷㅜ	kwadu
ㅂㅏㄴㅈㅣㄹㅡㅁ	paɲd͡ʑiɾɯm
ㄷㅡㄹㅓㅁ	tɯɾʌm
ㅂㅜㅅㅓㅈㅣㄷㅏ	pusʰʌd͡ʑida
ㄱㅏㅌㅈㅏㄶㄷㅏ	kat̚t͡ɕantʰa
ㅊㅗㅂㅗㅈㅏ	t͡ɕʰobod͡ʑa
ㅁㅜㄴㄱㅘ	munɡwa
ㄱㅏㅁㅏㅅㅗㅌ	kamasʰot̚
ㅂㅓㅂㅇㅏㄴ	pʌban
ㅈㅓㅇㅈㅗ	t͡ɕʌŋd͡ʑo
ㅎㅡㅈㅣㅂㅜㅈㅣ	xɯd͡ʑibud͡ʑi
ㅂㅏㅂㅅㅗㅌ	papsot̚
ㅈㅓㄱㅇㅓㄷㅗ	t͡ɕɘɡʌdo
ㅈㅚㄷㅏ	t͡ɕweda
ㅇㅡㅇㄷㅏㅂ	ɯŋdap̚
ㅈㅏㄷㅗㅇㅊㅏ	t͡ɕadoŋt͡ɕʰa
ㅎㅓㅍㅏ	hʌpʰa
ㄲㅣㄱㅂㅏㄴㅎㅏㄷㅏ	kik̚panɦada
ㅊㅗㅈㅣ	t͡ɕʰod͡ʑi
ㅈㅣㄷㅗ	t͡ɕido
ㅁㅣㄹㅡㄱㅂㅗㅅㅏㄹ	miɾɯk̚posʰaɭ
ㅍㅔㄹㅁㅔㄴㅣ	pʰeɭmeni
ㅎㅏㄴㄷㅔ	hande
ㅇㅏㅇㅅㅏㅇㅂㅡㄹ	aŋsʰaŋbɯɭ
ㅈㅓㄴㄹㅕㄱ	t͡ɕɘʎʎjʌk̚
ㅊㅓㅇㄱㅜㄱㅈㅏㅇ	t͡ɕʰʌŋɡuk̚t͡ɕaŋ
ㅅㅗㅈㅜㅇㅎㅏㄷㅏ	sʰod͡ʑuŋɦada
ㅂㅏㅇㅅㅜ	paŋsʰu
ㅅㅡㅌㅔㅍㅏㄴㅗ	sʰɯtʰepʰano
ㄱㅓㄹㅇㅓ	kʌɾʌ
ㅈㅜㅇㄷㅗㅇ	t͡ɕuŋdoŋ
ㄷㅏㅇㄴㅛㅂㅕㅇ	taŋɲjopjʌŋ
ㅋㅡㄴㄱㅣㄹㅓㄱㅣ	kxɯnɡiɾʌɡi
ㅅㅓㄹㅍㅗㄴ	sʰʌɭpʰon
ㅅㅗㅅㅜㅁㅣㄴㅈㅗㄱ	sʰosʰumiɲd͡ʑok̚
ㅇㅓㅂㅠㅁ	ʌbjum
ㅇㅡㅁㅎㅜㄴ	ɯmβun
ㅅㅜㅅㅗㅇ	sʰusʰoŋ
ㅇㅕㅂㄹㅗㄱㅅㅗ	jʌmnokso
ㅅㅔㅇㅣㅂㅈㅏ	sʰeip̚t͡ɕa
ㅎㅏㅈㅡ	had͡ʑɯ
ㄴㅕㅅㅓㅇㄱㅗㅇㅡㅁ	ɲjʌsʰʌŋɡoɯm
ㅅㅣㄹㅊㅓㄴ	ɕʰiʎt͡ɕʰʌn
ㅅㅣㄱㄱㅣㅅㅔㅊㅓㄱㄱㅣ	ɕʰik̚kisʰet͡ɕʰʌk̚ki
ㅆㅔㄴㅌㅓ	sentʰʌ
ㅂㅏㄷㅏ	pada
ㅁㅜㅅㅏㄴㅅㅚㅈㅗㄱㅈㅔㅂㅣ	musʰansʰwed͡ʑok̚t͡ɕebi
ㅁㅣㅇㅓ	miʌ
ㅅㅗㅇㅇㅣ	sʰoŋi
ㅌㅏㅇㅣㄹ	tʰaiɭ
ㅂㅣㄴㅌㅡㅎㅜㅋㅡ	pintʰɯβukxɯ
ㅇㅏㅎㅠ	aʝju
ㅁㅗㅈㅏㄹㅏㄷㅏ	mod͡ʑaɾada
ㄱㅔㅌㅗㅂㅊㅣ	ketʰop̚t͡ɕʰi
ㅎㅚㄱㅘㄴ	ɸweɡwan
ㅁㅣㄷㅣㅇㅓ	midiʌ
ㅌㅣㅂㅔㅌㅡ	tʰibetʰɯ
ㅊㅜㄹㅌㅚㄱㅡㄴㅎㅏㄷㅏ	t͡ɕʰuɭtʰweɡɯnɦada
ㄷㅏㅇㅅㅣㄴ	taŋɕʰin
ㅎㅏㅁㄱㅕㅇ	hamɡjʌŋ
ㅈㅏㅊㅣㅅㅎㅏㅁㅕㄴ	t͡ɕat͡ɕʰitʰamjʌn
ㅅㅚㄱㅏㅁㅏㅇㅜㅈㅣ	sʰweɡamaud͡ʑi
ㅊㅏㄴ	t͡ɕʰan
ㅌㅏㅇㅝ	tʰawʌ
ㅅㅣㄱㄹㅛㅍㅜㅁㅈㅓㅁ	ɕʰiŋɲjopʰumd͡ʑʌm
ㅂㅐㅅㅗㅇ	pɛsʰoŋ
ㄴㅗㅇㅇㅓㅂ	noŋʌp̚
ㅂㅐㅂㅏㄴㅎㅏㄷㅏ	pɛbanɦada
ㄱㅕㅂㄴㅗㅎㄷㅏ	kjʌmnotʰa
ㄱㅡㄴㅅㅏㅎㅏㄷㅏ	kɯnsʰaɦada
ㅇㅢㅈㅣ	ɰid͡ʑi
ㅇㅑㄱㅗㅂ	jaɡop̚
ㅈㅓㅇㅇㅛㄱ	t͡ɕʌŋjok̚
ㅈㅓㄴㅎㅏㄷㅏ	t͡ɕʌnɦada
ㅎㅏㄴㄷㅔ	hande
ㅍㅔㄷㅏㄹ	pʰedaɭ
ㅈㅗㅈㅁㅗㄱ	t͡ɕonmok̚
ㄱㅏㅂ	kap̚
ㄱㅏㄷㅗㄹㄹㅣㄴㅠㅁ	kadoʎʎiɲjum
ㄲㅏㅈㅏㅎㅡㅅㅡㄸㅏㄴ	kad͡ʑaɣɯsʰɯtan
ㄱㅖㄹㅑㅇㄱㅕㅇㅈㅔㅎㅏㄱ	kjeɾjaŋɡjʌŋd͡ʑeɦak̚
ㅂㅜㄹㄹㅣㄷㅏ	puʎʎida
ㅈㅣㅂㅏㅇㅈㅗㄱ	t͡ɕibaŋd͡ʑok̚
ㄹㅜㅁㅔㄴ	ɾumen
ㅃㅏㄹㅇㅏㅁㅓㄱㄷㅏ	paɾamʌk̚ta
ㅂㅏㅇㅌㅏㄴ	paŋtʰan
ㅊㅔㅇㅣㄴ	t͡ɕʰein
ㅇㅓㅅㅂㅣㅅㅡㅅㅎㅏㄷㅏ	ʌt̚pisʰɯtʰada
ㅍㅓㅈㅣㄷㅏ	pʰɘd͡ʑida
ㄴㅣㅋㅗㅌㅣㄴ	nikʰotʰin
ㄱㅜㅇㅝㄴ	kuwʌn
ㅂㅜㄹㅜㄴㄷㅣ	puɾundi
ㅅㅏㅁㅅㅓㄴ	sʰamsʰʌn
ㅈㅡㄹㄱㅓㅂㄷㅏ	t͡ɕɯɭɡʌp̚ta
ㅇㅛㅇㄱㅣ	joŋɡi
ㅇㅏㄴㅣㄷㅏ	anida
ㄴㅡㅍ	nɯp̚
ㅇㅟㅊㅣㅎㅏㄷㅏ	ɥit͡ɕʰiɦada
ㅂㅏㅇㅇㅏ	paŋa
ㅇㅠㅊㅜㅇ	jut͡ɕʰuŋ
ㅇㅟㅂㅕㅇ	ɥibjʌŋ
ㅅㅛㅍㅣㅇㅎㅏㄷㅏ	ɕʰopʰiŋɦada
ㅅㅏㄴㅍㅏ	sʰanpʰa
ㅃㅕㅍ	pjʌp̚
ㅅㅚㅃㅜㄹㅓㄱㅣ	sʰwepuɾʌɡi
ㄴㅗㅅㅏ	nosʰa
ㄷㅐㄷㅏㅅㅜ	tɛdasʰu
ㅎㅘㅇㅂㅗㄱ	ɸwaŋbok̚
ㅇㅏㅊㅣㅁㄴㅗㄹ	at͡ɕʰimnoɭ
ㅇㅏㄲㅣㄷㅏ	akida
ㅁㅏㄱ	mak̚
ㅎㅚㅅㅏㅇㅝㄴ	ɸwesʰawʌn
ㅈㅔㅂㅏㄹ	t͡ɕebaɭ
ㅂㅜㅁㅗ	pumo
ㅇㅏㄹㅋㅔㅇㅣㄴ	aɭkʰein
ㅅㅗㅍㅜㅁ	sʰopʰum
ㅇㅖㅅㄴㅏㄹ	jennaɭ
ㅁㅏㄹ	maɭ
ㅌㅗㅇㄱㅘㅎㅏㄷㅏ	tʰoŋɡwaɦada
ㅂㅓㄹㅆㅓ	pʌɭsʌ
ㄱㅣㄹㅗㄱ	kiɾok̚
ㅌㅔㄹㄹㅜㄹㅡ	tʰeɭɭuɾɯ
ㅅㅗㅂㅏㅇㅊㅏ	sʰobaŋt͡ɕʰa
ㅁㅕㅇ	mjʌŋ
ㅌㅏㄴㅅㅜㅎㅘㅁㅜㄹ	tʰansʰuβwamuɭ
ㄱㅟㅎㅘㄴ	kɥiβwan
ㅇㅚㅂㅜ	webu
ㅂㅏㄱㅇㅕㅂㅈㅣ	paɡjʌp̚t͡ɕi
ㄹㅡㅇㅘㄴㄷㅏ	ɾɯwanda
ㅅㅔㅍㅗㅈㅣㄹ	sʰepʰod͡ʑiɭ
ㅅㅏㅈㅣㄴㅅㅏ	sʰad͡ʑinsʰa
ㅍㅗㄷㅗ	pʰodo
ㅎㅏㄴㅡㄹ	hanɯɭ
ㅅㅓㅇㅁㅕㅇ	sʰɘŋmjʌŋ
ㅂㅜㄱㅟㅇㅕㅇㅎㅘ	puɡɥijʌŋβwa
ㅍㅣㄹㅈㅏ	pʰiʎt͡ɕa
ㄸㅟㅇㅓㄴㅏㄷㅏ	tɥiʌnada
ㅇㅓㅂㅊㅔ	ʌp̚t͡ɕʰe
ㅍㅓㅅㅔㄴㅌㅡ	pʰʌsʰentʰɯ
ㅁㅗㅇ	moŋ
ㄱㅘㅇㅇㅡㅁㅅㅏㅈㅓㄴ	kwaŋɯmsʰad͡ʑʌn
ㅍㅡㄹㅣㅈㅣㅇㅓ	pʰɯɾid͡ʑiʌ
ㅈㅡㅇㄱㅝㄴ	t͡ɕɯŋkwʌn
ㅅㅣㄴㅅㅏ	ɕʰinsʰa
ㅁㅗㅇㅌㅏㅈㅜ	moŋtʰad͡ʑu
ㄷㅏㄱㅡㅊㅣㄷㅏ	taɡɯt͡ɕʰida
ㄱㅏㅈㅔㄹ	kad͡ʑeɭ
ㅋㅜㄹㅋㅜㄹ	kʰuɭkʰuɭ
ㅇㅕㄴㅈㅜㄴㅁㅗㅊㅣ	jʌɲd͡ʑunmot͡ɕʰi
ㅇㅐㅈㅓㅇ	ɛd͡ʑʌŋ
TMI	tʰiemai
ㄴㅗㅇㄷㅏㅁㅎㅏㄷㅏ	noŋdamɦada
ㅇㅗㄷㅓㄱㅎㅜ	odʌkʰu
ㅅㅗㅅㅗㅇ	sʰosʰoŋ
ㅍㅗㅌㅡㅁㅗㄹㅡㅈㅡㅂㅣ	pʰotʰɯmoɾɯd͡ʑɯbi
ㅍㅡㄹㅗㅅㅔㅅㅓ	pʰɯɾosʰesʰʌ
ㅇㅏㄴㅏㅇㅜㄴㅅㅓ	anaunsʰʌ
ㄱㅗㅇㅅㅗㄴ	koŋsʰon
ㅎㅘㄹㄱㅣ	ɸwaɭɡi
ㅇㅘㅇㅈㅗ	waŋd͡ʑo
ㅎㅘㄱㅈㅓㅇㅎㅏㄷㅏ	ɸwak̚t͡ɕʌŋɦada
ㅂㅏㅇㅎㅘ	paŋβwa
ㅈㅏㄴㅅㅗㄹㅣ	t͡ɕansʰoɾi
ㅌㅜㅁㅕㅇㅎㅏㄷㅏ	tʰumjʌŋɦada
ㄴㅔㅇㅗㄷㅣㅁㅠㅁ	neodimjum
ㅂㅓㄱㅓ	pʌɡʌ
ㅁㅣㄴㅂㅕㅇ	minbjʌŋ
ㅅㅏㅇㅅㅏㅇ	sʰaŋsʰaŋ
ㅇㅜㅅㄱㅣㄷㅏ	ut̚kida
NG	eɲd͡ʑi
ㄴㅔㅍㅣㄷㅗ	nepʰido
ㅊㅚㅅㅏㅇㄱㅡㅂ	t͡ɕʰwesʰaŋɡɯp̚
ㅊㅓㄹㅈㅓㅎㅏㄷㅏ	t͡ɕʰʌʎt͡ɕʌɦada
ㅈㅏㅇㅁㅕㄴ	t͡ɕaŋmjʌn
ㅊㅜㄹㅅㅣㄴ	t͡ɕʰuɭɕin
ㅂㅏㄴㅅㅓㅇ	pansʌŋ
ㄱㅡㄴㅁㅜㅎㅏㄷㅏ	kɯnmuɦada
ㄷㅗㅇㅈㅓㅇ	toŋd͡ʑʌŋ
ㅅㅓㄹㄱㅛ	sʰʌɭɡjo
ㅈㅣㄷㅗㅈㅏ	t͡ɕidod͡ʑa
ㅅㅔㄱㅖ	sʰeɡje
ㅋㅡㄹㅔㄷㅣㅌㅡ	kxɯɾeditʰɯ
ㅅㅔㄲㅗ	sʰeko
ㅌㅏㄴㅎㅘㄴㅇㅕㄹㅊㅏ	tʰanβwaɲjʌʎt͡ɕʰa
ㅍㅖ	pʰje
ㅇㅣㅅㅏㅇㅇㅑㄹㅡㅅㅎㅏㄷㅏ	isʰaŋɲjaɾɯtʰada
ㅈㅣㅇㄱㅡㄹㅓㅂㄷㅏ	t͡ɕiŋɡɯɾʌp̚ta
ㅈㅓㅁㅅㅣㅁ	t͡ɕɘmɕʰim
ㅎㅔㅇㅓㅈㅣㄷㅏ	heʌd͡ʑida
ㅂㅜㅍㅜㅁ	pupʰum
ㅇㅠㅅㅓㅇ	jusʰʌŋ
ㅁㅗㄱㄱㅕㄱㅈㅏ	mok̚kjʌk̚t͡ɕa
ㄱㅘㄴㅎㅏㄷㅏ	kwanɦada
ㅅㅗㅇㅠ	sʰoju
ㅇㅕㄱㅅㅏ	jʌksa
ㅅㅡㄹㅍㅡㅁㅈㅡㅇ	sʰɯɭpʰɯmd͡ʑɯŋ
ㅊㅏㄷㅏㄴ	t͡ɕʰadan
ㅅㅓㄱㅇㅠ	sʰʌɡju
ㅈㅏㅂㄴㅕㄴ	t͡ɕamɲjʌn
ㄴㅗㄱㅇㅣㄷㅏ	noɡida
ㅈㅏㅁㅗ	t͡ɕamo
ㄴㅗㅂㅔㄹㄹㅠㅁ	nobeʎʎjum
ㅇㅣㄹㄱㅘㅇㅇㅛㄱ	iɭɡwaŋjok̚
ㅂㅜㅅㅜㄹㄱㅣ	pusʰuɭɡi
ㅆㅡㄹㅣㄷㅏ	sɯɾida
ㅂㅓㄱㅊㅏㄷㅏ	pʌk̚t͡ɕʰada
ㅇㅏㅁㅣㄷㅣㄴ	amidin
ㄲㅏㄲㄷㅏ	kak̚ta
ㅊㅓㅇㄷㅜㅇㅇㅗㄹㅣ	t͡ɕʰʌŋduŋoɾi
ㅎㅘㅇㅑㄱ	ɸwajak̚
ㅍㅜㄷㅏ	pʰuda
ㅍㅔㅇㄱㅟㄴ	pʰeŋɡɥin
ㅈㅣㄱㅅㅡㅇㄱㅣ	t͡ɕiksɯŋɡi
ㅇㅏㄴㄴㅕㅇㅎㅏㅅㅔㅇㅛ	anɲjʌŋɦasʰejo
ㅅㅏㄹㅏㅈㅣㄷㅏ	sʰaɾad͡ʑida
ㅅㅑㅂㅏㄹ	ɕʰabaɭ
ㄹㅗㅁㅔ	ɾome
ㅆㅡㄹㅓㅈㅣㄷㅏ	sɯɾʌd͡ʑida
ㅅㅓㅁㅣㅅ	sʰʌmit̚
ㅍㅣㄴㅏㄴㅊㅓ	pʰinaɲt͡ɕʰʌ
ㄱㅛㅊㅔ	kjot͡ɕʰe
ㅇㅣㅇㅣㄴㅊㅣㅇ	iiɲt͡ɕʰiŋ
ㄱㅣㅂㅜ	kibu
ㅇㅏㄻ	am
ㄱㅓㅈㅣㅅㅁㅏㄹㅎㅏㄷㅏ	kɘd͡ʑinmaɾɦada
ㅌㅡㄹㅗㅍㅣㄹㄹㅠㅁ	tʰɯɾopʰiʎʎjum
ㅂㅏㄷㄷㅏ	pat̚ta
ㅁㅏㄸㅏㅇㅎㅏㄷㅏ	mataŋɦada
ㅇㅖ	je
ㅈㅓㅇㄷㅗ	t͡ɕʌŋdo
ㅂㅕㄴㅈㅓㄹㅈㅏ	pjɘɲd͡ʑʌʎd͡ʑa
ㄴㅗㅋㅡㄴㅗㅋㅡ	nokxɯnokxɯ
ㅇㅠㅇㅝㄴㅈㅣ	juwʌɲd͡ʑi
ㅆㅣㅍㅏㄹ	ɕipʰaɭ
ㅁㅜㅅㅡㄴ	musʰɯn
ㅈㅓㄴㄹㅣㅍㅜㅁ	t͡ɕɘʎʎipʰum
ㅎㅏㅂㄱㅡㅁ	hap̚kɯm
ㅂㅜㄱㅁㅏㅋㅡ	puŋmakxɯ
ㅂㅜㄴㄹㅑㅇ	puʎʎjaŋ
ㄷㅡㅇㅈㅏㅇㅎㅏㄷㅏ	tɯŋd͡ʑaŋɦada
ㅈㅏㅁㅔㅇㅣㅋㅏ	t͡ɕameikʰa
ㅅㅜㅍㅣ	sʰupʰi
ㅋㅝ	kʰwʌ
ㄹㅗㄷㅠㅁ	ɾodjum
ㅅㅏㄷㅏㄱㄷㅏㄹㅣ	sʰadak̚taɾi
ㅇㅕㄴㅅㅓㄹ	jɘnsʰʌɭ
ㅁㅜㅇㅖ	muje
ㄱㅏㅈㅕㄱㅏㄷㅏ	kad͡ʑʌɡada
ㅇㅣㄴㅅㅣㄱㄹㅗㄴ	inɕʰiŋnon
ㄱㅏㅈㅣㄱㅏㅈㅣ	kad͡ʑiɡad͡ʑi
ㄱㅜㅇㅈㅓㄴ	kuŋd͡ʑʌn
ㄱㅏㄴㅅㅏ	kansʰa
ㄴㅏㄴㅁㅣㄴ	nanmin
ㅎㅜㄹ	ɸʷuɭ
ㅈㅓㄴㅂㅏㄴㅈㅓㄱ	t͡ɕʌnbaɲd͡ʑʌk̚
ㅁㅗㅁㅅㅗ	momsʰo
ㅇㅠㅇㅡㅁ	juɯm
ㄷㅜㄱㅡㄴㄷㅜㄱㅡㄴ	tuɡɯnduɡɯn
ㅇㅡㅁㅅㅗ	ɯmsʰo
ㅍㅡㄹㅗㅍㅔㄹㄹㅓ	pʰɯɾopʰeɭɭʌ
ㅇㅘㅇㅣㅅㅕㅊㅡ	waiɕʰʌt͡ɕʰɯ
ㅇㅡㄴㅇㅣㄴ	ɯnin
ㅌㅣㅇㅡㅌ	tʰiɯt̚
ㄹㅣㅂ	ɾip̚
ㅇㅣㅅㅡㄹㄹㅏㅁㅏㅂㅏㄷㅡ	isʰɯɭɭamabadɯ
ㅇㅏㄴㅈㅓㅇ	aɲd͡ʑʌŋ
ㄷㅏㄴㄱㅏㅁㅈㅏ	tanɡamd͡ʑa
ㅎㅚㄱㅛㄷㅗ	ɸweɡjodo
ㅍㅗㄹㄹㅏㄴㄷㅡㅇㅓ	pʰoɭɭandɯʌ
ㅇㅑㅇㅅㅓㅇ	jaŋsʰʌŋ
ㅅㅗㄴㅈㅜ	sʰoɲd͡ʑu
ㄱㅗㄺ	kok̚
ㅅㅔㄴㅌㅣㅁㅣㅌㅓ	sentʰimitʰʌ
ㅆㅓㄹㄷㅏ	sɘɭda
ㅌㅗㄲㅣ	tʰoki
ㅅㅔㅁㅌㅡㄹ	sʰemtʰɯɭ
ㅁㅐㄴㄴㅏㄹ	mɛnnaɭ
ㅂㅔㅇㅣㅋㅓㄴ	peikʰʌn
ㅂㅏㅇㅇㅜㄹ	paŋuɭ
ㅎㅜㄴㅈㅏㅇ	ɸʷuɲd͡ʑaŋ
ㅅㅜㅇㅓㅄㅇㅣ	sʰuʌpɕi
ㄱㅏㅇㅗㄹㅣ	kaoɾi
ㅂㅜㄱㄱㅡㄱ	puk̚kɯk̚
ㄲㅜㄹㅂㅏㅁ	kuɭbam
ㅁㅜㄹ	muɭ
ㄱㅜㅇㄷㅜㅇㅇㅣ	kuŋduŋi
ㅇㅛㄱㅎㅏㄷㅏ	jokʰada
ㄱㅜㄴㄷㅔ	kunde
ㄱㅟㅇㅕㅂㄷㅏ	kɥijʌp̚ta
ㄷㅡㄱㅌㅔㅁ	tɯk̚tʰem
ㄱㅡㅂㄹㅛ	kɯmɲjo
ㅉㅗㄷㅏ	t͡ɕoda
ㄴㅓㅂㅣㅇㅏㄴㅣ	nʌbiani
ㅇㅣㄴㅇㅛㅇ	iɲjoŋ
ㅈㅗㅇㄹㅠ	t͡ɕoŋɲju
ㄷㅚㅁㄷㅚㅁㅇㅣ	twemdwemi
ㄱㅓㅁㅅㅗㅎㅏㄷㅏ	kʌmsʰoɦada
ㅇㅣㅁㅗㄱㄱㅜㅂㅣ	imok̚kubi
ㅅㅓㅇㄱㅘ	sʰʌŋkwa
ㅂㅏㅇㅅㅏㅅㅓㄴ	paŋsʰasʰʌn
ㅈㅏㅇㅟ	t͡ɕaɥi
ㅎㅓㅇㅕㅇㅅㅣㅁ	hʌjʌŋɕʰim
ㅇㅏㄴㄷㅡㄹㅔㅇㅏ	andɯɾea
ㅎㅏㅂㅅㅓㅇ	hapsʌŋ
ㅎㅏㅅㅣㄷㅏ	haɕʰida
ㄷㅏㅅㅓㅅ	tasʰʌt̚
ㅌㅡㄱㅂㅕㄹㅎㅣ	tʰɯk̚pjʌɾʝi
ㅎㅏㄴㅇㅓ	hanʌ
ㄱㅘㄴㅇㅛㅇㄱㅜ	kwaɲjoŋɡu
ㅎㅗㅇㅎㅏㅂ	ɸʷoŋɦap̚
ㄲㅏㅂㅔㄹ	kabeɭ
ㅊㅐㅅㅣㄱㅈㅜㅇㅢㅈㅏ	t͡ɕʰɛɕʰik̚t͡ɕuɰid͡ʑa
ㅍㅟㅂ	pʰɥip̚
ㄱㅗㅇㅂㅜㅈㅏ	koŋbud͡ʑa
ㅅㅏㅎㅕㅇ	sʰaʝjʌŋ
ㅇㅏㄹㅍㅏㄴ	aɭpʰan
ㄱㅗㄱㅣㄱㅕㅂㅃㅏㅇ	koɡiɡjʌp̚paŋ
ㅁㅓㅍㅣㄴ	mʌpʰin
ㅂㅣㄱㅜㄹㅡㅁ	piɡuɾɯm
ㅇㅠㄹㅗㅂㅣㅌㅡ	juɾobitʰɯ
ㅈㅓㄴㄹㅏㄷㅗ	t͡ɕʌɭɭado
ㅇㅣㄲㅡㄹㄷㅏ	ikɯɭda
ㅈㅜㄷㅜ	t͡ɕudu
ㅍㅕㄱ	pʰjʌk̚
ㅁㅜㄹㅇㅓㄸㅔㄷㅏ	muɾʌteda
ㄷㅏㄹㄱㅑㄹ	taɭɡjaɭ
ㅍㅜㅈㅔㄴ	pʰud͡ʑen
ㅎㅗㄹㅜㄹㅏㄱㅣ	ɸʷoɾuɾaɡi
ㅅㅓㅇ	sʌŋ
ㄱㅏㅁ	kam
ㅂㅗㄴㅁㅜㄴ	ponmun
ㅅㅏㅌㅏㅇㅅㅜㅅㅜ	sʰatʰaŋsʰusʰu
ㅂㅗㄹㄹㅣㅇ	poʎʎiŋ
ㅇㅑㄱㅈㅜ	jak̚t͡ɕu
ㅈㅗㅈㅣㅇㅏ	t͡ɕod͡ʑia
ㅅㅗㅇㄱㅘㅅㅓㄴ	sʰoŋɡwasʰʌn
ㅋㅡㄴㄱㅏㅅㅣㄱㅗㄱㅣ	kxɯnɡaɕʰiɡoɡi
ㅂㅗㄱㅓㄴ	poɡʌn
ㅇㅕㄱㅏ	jʌɡa
ㅂㅜㅈㅗㄱㅎㅏㄷㅏ	pud͡ʑokʰada
ㅅㅜㄱㅗㅎㅏㄷㅏ	sʰuɡoɦada
ㄹㅡㄱ	ɾɯk̚
ㅁㅗㅇㅛㄱㅎㅏㄷㅏ	mojokʰada
ㅇㅣㄱㄹㅛㅇ	iŋɲjoŋ
ㅅㅡㅂㅎㅏㄷㅏ	sʰɯpʰada
ㄴㅓㄱㅡㄹㅓㅂㄷㅏ	nʌɡɯɾʌp̚ta
ㅅㅣㅈㅏㄱ	ɕʰid͡ʑak̚
ㅊㅏㅇㅣㄴㅏㅌㅏㅇㅜㄴ	t͡ɕʰainatʰaun
ㅂㅔㄹㄹㅣㅈㅡ	peʎʎid͡ʑɯ
ㅅㅜㅍㅛ	sʰupʰjo
ㅎㅔㅇㅣㄱㅡ	heiɡɯ
ㅇㅕㅁㅅㅔㅈㅜㅇㅢ	jɘmsʰed͡ʑuɰi
ㅈㅏㅇㅡㅁ	t͡ɕaɯm
ㄱㅏㄴㅈㅏㅇ	kaɲd͡ʑaŋ
ㅈㅣㄱㅡㅁ	t͡ɕiɡɯm
ㅇㅏㅍ	ap̚
ㅈㅓㅇㅅㅏㅇㅎㅚㄷㅏㅁ	t͡ɕʌŋsʰaŋβwedam
ㄱㅕㄹㅈㅓㅇ	kjʌʎt͡ɕʌŋ
ㅍㅏㄱㅗㄷㅏ	pʰaɡoda
ㄷㅜㅇㅓㅅㅓㄴㅓㅅ	tuʌsʰʌnʌt̚
ㄱㅏㅂㅂㅜㄴㅆㅏ	kap̚punsa
ㄱㅘㅈㅓㅇ	kwad͡ʑʌŋ
ㅅㅓㄴㅈㅓㄴ	sʰʌɲd͡ʑʌn
ㄱㅗㅇㅈㅏㅇ	koŋd͡ʑaŋ
ㅊㅓㄱ	t͡ɕʰʌk̚
ㅂㅏㄹ	paɭ
ㅅㅜㅈㅏㅇㄹㅛㅇ	sʰud͡ʑaŋɲjoŋ
ㅈㅓㅇㅅㅣㄴㅂㅜㄴㅇㅕㄹㅂㅕㅇ	t͡ɕʌŋɕʰinpuɲjʌɭbjʌŋ
ㅇㅏㅍㅅㅓㄷㅏ	apsʌda
ㅇㅜㄴㅇㅕㅇㅎㅏㄷㅏ	uɲjʌŋɦada
ㅁㅏㅅㅜㄹㅅㅏ	masʰuɭsa
ㅂㅜㄹㄱㅏㅍㅣㅎㅏㄷㅏ	puɭɡapʰiɦada
ㅁㅣㄴㅈㅜㅇ	miɲd͡ʑuŋ
ㅈㅓㅁㅍㅡ	t͡ɕʌmpʰɯ
ㅈㅏㅂㅈㅣ	t͡ɕap̚t͡ɕi
ㅎㅜㅈㅣ	ɸʷud͡ʑi
ㅂㅣㅅㅈㅏㄹㅜ	pit̚t͡ɕaɾu
ㄷㅗㄱㅌㅡㄱㅎㅏㄷㅏ	tok̚tʰɯkʰada
ㅅㅡㅌㅏㅂㅓㄱㅅㅡ	sʰɯtʰabʌksɯ
ㄷㅏㄴㄴㅕㅁㅎㅏㄷㅏ	tanɲjʌmɦada
ㄴㅠㄷㅔㄹㄹㅣ	ɲjudeʎʎi
ㅊㅓㅇㅅㅗㄴㅕㄴ	t͡ɕʰʌŋsʰoɲjʌn
ㅈㅏㅇㅇㅣㄴㅇㅓㄹㅡㄴ	t͡ɕaŋinʌɾɯn
ㄸㅣㅇㅏㅅ	tiat̚
ㅂㅣㄴㄱㅗㄴ	pinɡon
ㅎㅡㄴㅎㅣ	xɯnʝi
ㅇㅟㄱㅣ	ɥiɡi
ㅅㅣㄹㅊㅔ	ɕʰiʎt͡ɕʰe
ㄴㅡㅇㄹㅕㄱ	nɯŋɲjʌk̚
ㅅㅓㅌㅜㄹㅡㄷㅏ	sʰɘtʰuɾɯda
ㅇㅏㅁㅜㄱㅓㅅ	amuɡʌt̚
ㅎㅜㄹㄹㅠㅇㅎㅏㄷㅏ	ɸʷuʎʎjuŋɦada
ㅉㅣㅁㅈㅣㄹㅂㅏㅇ	t͡ɕimd͡ʑiɭbaŋ
ㅎㅗㅇ	ɸʷoŋ
ㄱㅏㅅㅣㄷㅏ	kaɕʰida
ㄸㅓㄹㄹㅣㄷㅏ	tʌʎʎida
ㄴㅏㅁㅇㅢㅈㅏ	namɰid͡ʑa
ㅅㅣㄹㅅㅡㅂ	ɕʰiɭsɯp̚
ㅈㅣㅂㅇㅗㄹㅣ	t͡ɕiboɾi
ㄷㅡㅅ	tɯt̚
ㄱㅡㅁㄱㅏㅇㅁㅗㅊㅣ	kɯmɡaŋmot͡ɕʰi
ㅁㅜㄹㅣ	muɾi
ㅈㅏㄱㄱㅏ	t͡ɕak̚ka
ㅂㅣㅈㄷㅏ	pit̚ta
ㅌㅡㄱㅈㅓㅇ	tʰɯk̚t͡ɕʌŋ
ㄱㅗㅇㅡㄹ	koɯɭ
ㅂㅏㅇㄱㅘㅇ	paŋɡwaŋ
ㄲㅏㅁㅏㄱㅟㅅㄱㅘ	kamaɡɥit̚kwa
ㄱㅕㄹㅎㅏㅂㅎㅏㄷㅏ	kjʌɾɦapʰada
ᆫㄷㅔ	nde
ㅆㅏㄹㅆㅏㄹㅎㅣ	saɭsaɾʝi
ㅌㅏ	tʰa
ㄴㅏㄴㅊㅗ	naɲt͡ɕʰo
ㅇㅕㄴㅎㅏㅂ	jʌnɦap̚
ㅅㅕㅌㅓ	ɕʰʌtʰʌ
ㅇㅓㅂㅈㅗㅇ	ʌp̚t͡ɕoŋ
ㅊㅓㄴㄷㅏㅇ	t͡ɕʰʌndaŋ
ㄷㅟㅅㅓㄲㄷㅏ	tɥisʰʌk̚ta
ㄹㅜㅂㅡㄹ	ɾubɯɭ
ㅈㅜㄹㄷㅏ	t͡ɕuɭda
ㄹㅓㅁ	ɾʌm
ㅂㅣㅂㅣㅁ	pibim
ㅂㅜㄹㄹㅏ	puɭɭa
ㅁㅜㅅㅏ	musʰa
ㅅㅔㄹㅠㅁ	sʰeɾjum
ㅇㅛㄹㅏㅁ	joɾam
ㄱㅗㅈㅣㅂㅎㅏㄷㅏ	kod͡ʑipʰada
ㅈㅏㅁㄱㅣㄷㅏ	t͡ɕamɡida
ㅅㅏㅅㅡㄹ	sʰasʰɯɭ
ㅎㅏㅇㅣㅎㅣㄹ	haiʝiɭ
ㅊㅜㄹㅅㅏㄴ	t͡ɕʰuɭsan
ㅇㅗㅁㅡㄹㄹㅔㅅ	omɯɭɭet̚
ㄹㅗㄹㄹㅓㅋㅗㅅㅡㅌㅓ	ɾoɭɭʌkʰosʰɯtʰʌ
ㅈㅔㅎㅏㄴㅎㅏㄷㅏ	t͡ɕeɦanɦada
ㅁㅗㅇㄷㅜㅇㅇㅣ	moŋduŋi
ㅌㅗㄹㅗㄱ	tʰoɾok̚
ㅅㅏㅇㅌㅜㅁㅔ	sʰaŋtʰume
ㅅㅣㄱㄷㅏㅇ	ɕʰik̚taŋ
ㅈㅡㅇ	t͡ɕɯŋ
ㅇㅓㄹㅇㅡㅁㄱㅘㅈㅏ	ʌɾɯmɡwad͡ʑa
ㅅㅜㅅㅓㅇ	sʰusʰʌŋ
ㅅㅓㄹㅏㅂ	sʰʌɾap̚
ㄷㅡㅇㄱㅓㄹ	tɯŋɡʌɭ
ㄴㅓㅌㅡ	nʌtʰɯ
ㄷㅜㄹㅣㅇㅏㄴ	tuɾian
ㅊㅓㄴㄹㅣㅁㅏ	t͡ɕʰʌʎʎima
ㅂㅕㄴㅎㅏㄷㅏ	pjɘnɦada
ㅈㅗㄱㅡㅁ	t͡ɕoɡɯm
ㅂㅜㄺㅇㅡㄴㅂㅜㄹㅣㅎㅢㄴㅈㅜㄱㅈㅣ	puɭɡɯnbuɾiʝiɲd͡ʑuk̚t͡ɕi
ㅇㅛㅇㅇㅓㄴ	joŋʌn
ㅇㅚㅂㅗㄱㅅㅏㄱㅡㄴ	weboksaɡɯn
ㅅㅏㄴㅇㅓㅂ	sʰanʌp̚
ㅅㅏㅃㅜㄴㅅㅏㅃㅜㄴ	sʰapunsʰapun
ㅌㅗㅇㅂㅏㄹ	tʰoŋbaɭ
ㅈㅓㅈㅏㅇ	t͡ɕʌd͡ʑaŋ
ㅎㅘㄹㅅㅣㅇㅟ	ɸwaɭɕiɥi
ㅇㅗㄷㅡㅇ	odɯŋ
ㅎㅏㄴㅇㅑㄱ	haɲjak̚
ㅂㅜㅂㅜㄴ	pubun
ㄴㅗㄹㄹㅏㄷㅏ	noɭɭada
ㅅㅏㅇㅣㅌㅡ	sʰaitʰɯ
ㄴㅓㄼㅎㅣㄷㅏ	nʌɭpʰida
ㅇㅓㄵㄷㅏ	ʌnta
ㅈㅔㅅㅏ	t͡ɕesʰa
ㅁㅣㄴㄱㅜㄱ	minɡuk̚
ㄷㅗㅇㅂㅏㅇ	toŋbaŋ
ㅌㅡㄹㅓㅇㅋㅡ	tʰɯɾʌŋkxɯ
ㅇㅣㄴㅎㅏㄷㅏ	inɦada
ㅇㅕㄱ	jʌk̚
ㄱㅜㄹㄷㅏ	kuɭda
ㅅㅠㅍㅓㅅㅡㅌㅏ	ɕʰupʰʌsʰɯtʰa
ㅇㅜㄴㄷㅗㅇㄹㅑㅇ	undoŋɲjaŋ
ㄱㅕㄹㄹㅗㄴ	kjʌɭɭon
ㅇㅣㄹㅈㅏ	iʎt͡ɕa
ㅇㅜㅂㅣㄷㅏ	ubida
ㄲㅏㅁㅏㄱㄴㅜㄴ	kamaŋnun
ㅂㅐㅅㅣㄴㅎㅏㄷㅏ	pɛɕʰinɦada
ㅇㅕㅇㅅㅏ	jʌŋsʰa
ㄱㅕㅇㄹㅕㄴ	kjʌŋɲjʌn
ㅅㅏㄹㅡㄹㅡ	sʰaɾɯɾɯ
ㅇㅗㅋㅔㅇㅣ	okʰei
ㅈㅓㅇㅂㅕㄴ	t͡ɕʌŋbjʌn
ㄱㅜㄹㅠ	kuɾju
ㅅㅡㅂㄱㅘㄴ	sʰɯp̚kwan
ㅌㅔㄹㅓㅂㅓㅁ	tʰeɾʌbʌm
ㄱㅓㄴㄱㅏㅇㅎㅣ	kɘnɡaŋʝi
ㅁㅏㅇㅡㄹ	maɯɭ
ㅇㅗㄷㅔㅇ	odeŋ
ㅌㅏㄹㅈㅗㅅㅓㄴ	tʰaʎd͡ʑosʰʌn
ㅇㅏㄱㅅㅓㅇ	aksʌŋ
ㄲㅗㅊㅂㅕㅇ	kot̚pjʌŋ
ㅅㅏㅇㅜㄴㅏ	sʰauna
ㅌㅖㄴ	tʰjen
ㅂㅜㄹㅆㅏㅇㄴㅗㅁ	puɭsaŋnom
ㅅㅗㄹ	sʰoɭ
ㅇㅕㅇㅣㄴ	jʌin
ㅇㅑㅅㅣㄱ	jaɕʰik̚
ㄱㅛㅎㅘㄹㅎㅏㄷㅏ	kjoβwaɾɦada
ㅊㅣㄴㅈㅓㅇ	t͡ɕʰiɲd͡ʑʌŋ
ㅈㅓㄱㄱㅡㄱㅈㅓㄱ	t͡ɕʌk̚kɯk̚t͡ɕʌk̚
ㅅㅔㅁㅍㅏㄴ	sʰempʰan
ㄷㅔㄹㅕㅇㅗㄷㅏ	teɾjʌoda
ㅇㅠㄱㅈㅣ	juk̚t͡ɕi
ㄹㅑㅇㅂㅏㄴ	ɾjaŋban
ㅇㅏㄹㄹㅣㅂㅏㅂㅏ	aʎʎibaba
ㅇㅗㄹㅏㅂㅓㄴㅣㅁ	oɾabʌnim
ㄱㅗㄹㅏㄴㅣ	koɾani
ㅇㅐㄱㅜㄱㅈㅏ	ɛɡuk̚t͡ɕa
ㅂㅗㄴㅈㅣㄹ	poɲd͡ʑiɭ
ㅌㅔㄹㅍㅔㄴ	tʰeɭpʰen
ㅇㅓㄱㄹㅠ	ʌŋɲju
ㅈㅣㄹㅌㅜ	t͡ɕiɭtʰu
ㅊㅔㅇㅠㄱㄱㅘㄴ	t͡ɕʰejuk̚kwan
ㅊㅏㄱㅎㅏㄷㅏ	t͡ɕʰakʰada
ㅈㅓㅇㅊㅣㅈㅓㄱ	t͡ɕʌŋt͡ɕʰid͡ʑʌk̚
ㄲㅡㄶㄷㅏ	kɯntʰa
ㅇㅔ	e
ㅊㅓㄱㅅㅜ	t͡ɕʰʌksu
ㅇㅣㄴㄷㅗ	indo
ㄱㅓㅁㅅㅜㄹ	kɘmsʰuɭ
ㅈㅗㄹㄷㅏ	t͡ɕoɭda
ㄸㅔ	te
ㅇㅣㅅㅡㄹㅏㅇㅔㄹ	isʰɯɾaeɭ
ㄷㅓ	tʌ
ㅅㅏㅁㅎㅏㄴ	sʰamɦan
ㅇㅗㅅ	ot̚
ㅇㅖㅅㅜㄹㄱㅏ	jesʰuɭɡa
ㅇㅣㄹㅂㅏㄴㅈㅓㄱ	iɭbaɲd͡ʑʌk̚
ㅁㅣㄴㅎㅘ	minβwa
ㅇㅚㄴㅉㅗㄱ	weɲt͡ɕok̚
ㅅㅏㅇㅇㅓㅂ	sʰaŋʌp̚
ㅅㅏㅇㄷㅏㅇㅎㅏㄷㅏ	sʰaŋdaŋɦada
ㅅㅡㅋㅔㅇㅣㅌㅡㅂㅗㄷㅡ	sʰɯkʰeitʰɯbodɯ
ㅂㅜㅈㅜㅁㅂㅜㄹㅏ	pud͡ʑumbuɾa
ㅇㅏㄹㄹㅕㅈㅣㄷㅏ	aʎʎjʌd͡ʑida
ㅊㅓㅇㅈㅣㄴㄱㅣ	t͡ɕʰʌŋd͡ʑinɡi
ㅂㅓㅁㅈㅚㅈㅏ	pɘmd͡ʑwed͡ʑa
ㄴㅗㄴㅇㅢ	nonɰi
ㅆㅣㅂ	ɕip̚
ㅂㅏㅇㅅㅗㅇ	paŋsʰoŋ
ㄴㅗㄹㅡㄴㅈㅏㅇㅟ	noɾɯɲd͡ʑaɥi
ㅈㅣㅂㅇㅓㄴㅓㅎㄷㅏ	t͡ɕibʌnʌtʰa
ㅁㅏㅇㅜㅈㅏ	maud͡ʑa
ㄷㅗㅇㅇㅣㄹㅎㅏㄷㅏ	toŋiɾɦada
ㅋㅗㄹㄹㅏㅂㅗ	kʰoɭɭabo
ㄹㅏㅇㅣㅁ	ɾaim
ㅂㅏㄴㅑ	paɲja
ㅈㅓㅂㅈㅗㅇㅎㅏㄷㅏ	t͡ɕʌp̚t͡ɕoŋɦada
ㅂㅜㄷㅣㅈㅊㅣㄷㅏ	pudit̚t͡ɕʰida
ㅇㅏㅂㅡㄹㅏㅎㅏㅁ	abɯɾaɦam
ㅇㅛㅇㄱㅏㅁㅎㅏㄷㅏ	joŋɡamɦada
ㅎㅘㅈㅏㅇㅅㅣㄹ	ɸwad͡ʑaŋɕʰiɭ
ㄷㅏㄴㅊㅜ	taɲt͡ɕʰu
ㅅㅣㄴㅅㅣㅇㅏ	ɕʰinɕʰia
ㄱㅓㄴㄴㅓㅍㅕㄴ	kɘnnʌpʰjʌn
ㄱㅙㅇㅇㅣ	kwɛŋi
ㅅㅏㅎㅑㅇㄱㅗㅇㅑㅇㅇㅣ	sʰaʝjaŋɡojaŋi
ㅅㅗㅇㅛㅇㄷㅗㄹㅇㅣ	sʰojoŋdoɾi
ㅈㅅ	t͡ɕwesʰoŋ
ㅁㅏㄴㅜㄹㅏ	manuɾa
ㅊㅗㅇㄱㅏㄱ	t͡ɕʰoŋɡak̚
ㅇㅢㅈㅔ	ɰid͡ʑe
ㅉㅏㅇㄲㅗㄹㄹㅏ	t͡ɕaŋkoɭɭa
ㅈㅏㅁㄲㅏㄴ	t͡ɕamkan
ㅌㅓㄹㅇㅓㄴㅗㅎㄷㅏ	tʰʌɾʌnotʰa
ㅇㅞㅂ	wep̚
ㅌㅗㅅㅡㅌㅓ	tʰosʰɯtʰʌ
ㅂㅏㄺㅈㅟ	pak̚t͡ɕɥi
ㄱㅖㅅㅗㄱㄷㅚㄷㅏ	kjesʰok̚tweda
ㅊㅓㅇㅎㅏㄷㅏ	t͡ɕʰʌŋɦada
ㅋㅏㄴㅏ	kʰana
ㅍㅜㅁㅈㅣㄹ	pʰumd͡ʑiɭ
ㅎㅡㄺ	xɯk̚
ㅅㅜㄱㄷㅏㅂ	sʰuk̚tap̚
ㄱㅏㅈㅣ	kad͡ʑi
ㅇㅣㄱㅗㅅ	iɡot̚
ㅊㅔㅈㅓㄱ	t͡ɕʰed͡ʑʌk̚
ㄱㅏㅁㄱㅣㄷㅏ	kamɡida
ㅇㅠㄷㅜ	judu
ㅋㅏㅂㅗㅂㅔㄹㅡㄷㅔ	kʰabobeɾɯde
ㅈㅓㅁㅈㅜ	t͡ɕʌmd͡ʑu
ㅅㅣㄴㄱㅣㄹㅜ	ɕʰinɡiɾu
ㅈㅚㅅㅜ	t͡ɕwesʰu
ㅈㅏㅁㄱㅡㄷㅏ	t͡ɕamɡɯda
ㄴㅡㅇㄱㅕㄱ	nɯŋɡjʌk̚
ㅁㅣㄴㅕ	miɲjʌ
ㅅㅡㅍㅓㄴㅈㅣ	sʰɯpʰʌɲd͡ʑi
ㅂㅓㅁㅇㅣㄴ	pɘmin
ㅁㅏㄹㅣ	maɾi
ㅎㅗㄴㄹㅏㄴ	ɸʷoɭɭan
ㅂㅏㅇㄱㅗㅇ	paŋɡoŋ
ㄴㅏㅍㅗㄹㄹㅣ	napʰoʎʎi
ㅅㅗㄱㅇㅗㅅ	sʰoɡot̚
ㅎㅘㅂㅜㄴ	ɸwabun
ㅅㅜㅎㅗ	sʰuβo
ㄷㅓㅍㅂㅏㅂ	tʌp̚pap̚
ㅇㅣㄴㅌㅓㅂㅠ	intʰʌbju
ㄱㅗㅁㅗㅂㅜ	komobu
ㄴㅓㄳ	nʌk̚
ㅈㅔㄱㅗㅇ	t͡ɕeɡoŋ
ㅅㅏㅊㅓㄴ	sʰat͡ɕʰʌn
ㅈㅓㄴㄱㅗㄹ	t͡ɕɘnɡoɭ
ㅇㅕㅈㅣㄴ	jʌd͡ʑin
ㄱㅗㅇㅅㅏㄴㄷㅏㅇ	koŋsʰandaŋ
ㄷㅗㅇㅁㅜㄹㅎㅏㄱ	toŋmuɾɦak̚
ㄱㅡㄹㅣㅁㅇㅕㅂㅅㅓ	kɯɾimjʌpsʌ
ㅌㅓㅇㅅㅡㅌㅔㄴ	tʰʌŋsʰɯtʰen
ㅇㅘㅇ	waŋ
ㅈㅓㄴㅊㅣㅅㅏ	t͡ɕʌɲt͡ɕʰisʰa
ㄲㅗㄹㅣㅊㅣㄹㅔㄷㅗㄹㅗㅇㄴㅛㅇ	koɾit͡ɕʰiɾedoɾoŋɲjoŋ
ㅅㅜㄹㅣㅎㅏㄷㅏ	sʰuɾiɦada
ㅇㅣㅂㅜㄴ	ibun
ㄱㅘㅇ	kwaŋ
ㄷㅡㄹㅡㄹㅓㅇㄷㅡㄹㅡㄹㅓㅇ	tɯɾɯɾʌŋdɯɾɯɾʌŋ
ㄷㅗㄷㅏㄹㅎㅏㄷㅏ	todaɾɦada
ㅅㅓㅅㅓㅎㅣ	sʰɘsʰʌʝi
ㄷㅗㄱㄱㅡㄱㅁㅜㄹ	tok̚kɯŋmuɭ
ㅇㅣㅇㅠ	iju
ㅇㅠㅊㅜㄹ	jut͡ɕʰuɭ
ㄷㅗㅇㅇㅏㄴ	toŋan
ㅅㅣㄱㄷㅏ	ɕʰik̚ta
ㄱㅓㅁㅣ	kʌmi
ㅅㅣㄴㄴㅗㄹㄹㅣㄴ	ɕʰinnoʎʎin
ㅈㅣㄴㅉㅏ	t͡ɕiɲt͡ɕa
ㅈㅏㄱㅣ	t͡ɕaɡi
ㅇㅗㄹㅣㄴㅏㅁㅜ	oɾinamu
ㅋㅜㄷㅔㅌㅏ	kʰudetʰa
ㅍㅜㅁㅅㅏㄳ	pʰumsak̚
ㄷㅓㄷㅡㅁㅇㅣㄷㅏㄹㅣ	tʌdɯmidaɾi
ㅇㅕㅅㅓㅅ	jʌsʰʌt̚
ㄱㅣㄱㅣ	kiɡi
ㅅㅓㅍㅛ	sʰʌpʰjo
ㄱㅚㄹㅚ	kweɾwe
ㄱㅏㄹㅏㄱㅈㅣ	kaɾak̚t͡ɕi
ㄱㅜㄴㄱㅘㄴ	kunɡwan
ㅇㅣㄴ	in
ㄴㅗㄹㅇㅣㄱㅣㄱㅜ	noɾiɡiɡu
ㄴㅏㅁㅈㅏㅇ	namd͡ʑaŋ
ㅇㅏㅂㅂㅏㄱ	ap̚pak̚
ㄱㅏㅁㅅㅗ	kamsʰo
ㅈㅏㄹㅛ	t͡ɕaɾjo
ㅅㅓㄹㅗ	sʰʌɾo
ㅇㅏㅎㅗㅂ	aβop̚
ㅇㅕㄱㅘㄴ	jʌɡwan
ㄱㅏㄴㄷㅏㄴㅎㅏㄷㅏ	kantanɦada
ㄷㅗㅇㅈㅣ	toŋd͡ʑi
ㅍㅕㅌ	pʰjʌt̚
ㄷㅏㄴㄱㅗㄱㅣ	tanɡoɡi
ㄱㅗㅂㄷㅏㄹㅏㅎㄷㅏ	kop̚taɾatʰa
ㄴㅕㅇ	ɲjʌŋ
ㄲㅗㄹㅣㅈㅣㄴㅡㄹㅓㅁㅣ	koɾid͡ʑinɯɾʌmi
ㅇㅢㅅㅣㄱㅎㅏㄷㅏ	ɰiɕʰikʰada
ㅋㅏㄹㅡㅂㅗㄹㄹㅣㄴ	kʰaɾɯboʎʎin
ㄴㅕㄱ	ɲjʌk̚
ㅅㅓㅅㅣㄱㅈㅣ	sʰʌɕʰik̚t͡ɕi
ㅇㅔㄹㅅㅏㄹㅂㅏㄷㅗㄹㅡ	eɭsʰaɭbadoɾɯ
ㄴㅗㄹㅡㅇㅞㅇㅣ	noɾɯwei
ㅇㅕㄴㅅㅗㄱㄱㅡㄱ	jʌnsʰok̚kɯk̚
ㅎㅝㄹㅆㅣㄴ	ɸwʌɭɕin
ㅅㅣㅈㅏㄱㄷㅚㄷㅏ	ɕʰid͡ʑak̚tweda
ㅈㅏㄴㅕ	t͡ɕaɲjʌ
ㅁㅔㅎㅣㄲㅗ	meʝiko
ㅁㅜㄹㅅㅣㄱㅖ	muɭɕiɡje
ㅁㅏㄹㅆㅡㅁ	maɭsɯm
ㄷㅡㄹㅏㅁㅏ	tɯɾama
ㄱㅣㅁㅗㄴㅗ	kimono
ㅍㅏㅈㅏㅁㅏ	pʰad͡ʑama
ㄲㅗㄹㅅㅏㄴㅏㅂㄷㅏ	koɭsʰanap̚ta
ㅇㅣㄴㅊㅣ	iɲt͡ɕʰi
ㅈㅏㅈㅓㅇ	t͡ɕad͡ʑʌŋ
ㄴㅏㅂㅈㅏㄹㅜ	nap̚t͡ɕaɾu
ㄲㅓㄱㅈㅓㅇㅇㅣ	kʌk̚t͡ɕʌŋi
ㅂㅏㄷㅏㅁㅏㄹ	padamaɭ
ㅅㅏㅎㅚㅎㅏㄱ	sʰaβweɦak̚
ㅍㅏㄴㄷㅏㄴ	pʰandan
ㅅㅏㄴㅅㅗ	sʰansʰo
ㅇㅓㅍㅏ	ɘpʰa
ㅇㅏㅈㅜㅁㅓㄴㅣ	ad͡ʑumʌni
ㅍㅔㅅ	pʰet̚
ㅁㅗㅅㅔㅎㅕㄹㄱㅘㄴ	mosʰeʝjʌɭɡwan
ㅎㅓㄹㅣㄸㅣ	hʌɾiti
ㄱㅓㄹㅡㄷㅏ	kʌɾɯda
ㅇㅣㄷㅗ	ido
ㅂㅏㅂㅈㅣㅂ	pap̚t͡ɕip̚
ㅂㅏㅇㅅㅓㄱㅈㅣㅂ	paŋsʰʌk̚t͡ɕip̚
ㄱㅕㄹㄱㅘㅈㅓㄱ	kjʌɭɡwad͡ʑʌk̚
ㅇㅛㅇㅇㅣㅎㅏㄷㅏ	joŋiɦada
ㅇㅣㅇㅑㄱㅣ	ijaɡi
ㅅㅣㅁㄹㅣㅎㅏㄱ	ɕʰimniɦak̚
ㅈㅜㅁㅏㄹ	t͡ɕumaɭ
ㅃㅓㄲㅜㄱㅣ	pʌkuɡi
ㅁㅜㅌㅏㄹ	mutʰaɭ
ㅂㅏㄹ	paɭ
ㄴㅏㄱㅈㅔ	nak̚t͡ɕe
ㄴㅜㄱㅜㄴㄱㅏ	nuɡunɡa
ㄱㅗㅇㅇㅕㄴ	koŋjʌn
ㅇㅕㅇㅇㅑㅇㅈㅔ	jʌŋjaŋd͡ʑe
ㅂㅜ	pu
ㅊㅗㄱㅅㅜ	t͡ɕʰoksu
ㅅㅔ	sʰe
ㅇㅏㄱㅎㅏㄴ	akʰan
ㄱㅏㅁㅣㅋㅏㅈㅔ	kamikʰad͡ʑe
ㅅㅡㅌㅣㄱ	sʰɯtʰik̚
ㅂㅗㄱㅗㅎㅏㄷㅏ	poɡoɦada
ㄱㅕㅇㅊㅏㄹㄱㅘㄴ	kjɘŋt͡ɕʰaɭɡwan
ㄲㅗㄹ	koɭ
ㅎㅚㅎㅏㅂ	ɸweɦap̚
ㄴㅏㄱㅎㅏㅅㅏㄴ	nakʰasʰan
ㅇㅓㄹㅚ	ʌɾwe
ㅇㅓㅇㅁㅏㅇ	ʌŋmaŋ
ㅈㅓㄴㅅㅜㄹ	t͡ɕɘnsʰuɭ
ㅋㅡㄹㅣㅁ	kxɯɾim
ㅉㅣㅎㄷㅏ	t͡ɕitʰa
ㅅㅓㄴㄱㅓㅎㅏㄷㅏ	sʰɘnɡʌɦada
ㅅㅏㄴㅅㅡㅋㅡㄹㅣㅌㅡㅇㅓ	sʰansʰɯkxɯɾitʰɯʌ
ㅂㅏㄴㄹㅣㅂㅈㅏ	paʎʎip̚t͡ɕa
ㅎㅚㅇㅢㅎㅏㄷㅏ	ɸweɰiɦada
ㅇㅠㄱㅂㅜㄴㅇㅢ	juk̚punɰi
ㅅㅜㅈㅜㄴ	sʰud͡ʑun
ㄱㅏㄴㅡㅇㅎㅏㄷㅏ	kanɯŋɦada
ㄱㅕㄹㅡㄹ	kjʌɾɯɭ
ㅅㅏㅈㅣㄴㅃㅏㄹ	sʰad͡ʑinpaɭ
ㅇㅣㅇㅇㅓ	iŋʌ
ㅂㅗㅇㅅㅏ	poŋsʰa
ㄷㅗㅇㄱㅓㅇㅣㄴ	toŋɡʌin
ㅊㅣㄴㅈㅓㄹㅎㅏㄷㅏ	t͡ɕʰiɲd͡ʑʌɾɦada
ㅅㅔㄴㅌㅡ	sʰentʰɯ
ㄷㅓㅂㅣㅇ	tʌbiŋ
ㄱㅓㄴㄴㅓㄷㅏ	kɘnnʌda
ㅇㅕㅇㅂㅗㄴ	jʌŋbon
ㅅㅏㄹㄱㅡㅁㅅㅏㄹㄱㅡㅁ	sʰaɭɡɯmsʰaɭɡɯm
ㅅㅓㄱㅏㅇ	sʰʌɡaŋ
ㅅㅜㅅㅗ	sʰusʰo
ㅅㅗ	sʰo
ㅍㅡㄹㅏㅇㅅㅠㅁ	pʰɯɾaŋɕʰum
ㅂㅜㄹㄱㅛ	puɭɡjo
ㅇㅕㄴㅂㅏㅇ	jʌnbaŋ
ㅂㅐㅅㅣㅁㅇㅝㄴ	pɛɕʰimwʌn
ㄷㅏㄹㄹㅓ	taɭɭʌ
ㅎㅘㅈㅣ	ɸwad͡ʑi
ㅊㅓㅇㄱㅏㄱ	t͡ɕʰʌŋɡak̚
ㄱㅏㄹㅇㅏㅇㅣㅂㄷㅏ	kaɾaip̚ta
ㅅㅓㄹㄴㅏㄹ	sʰɘɭɭaɭ
ㅇㅏㄴㄴㅕㅇㅎㅏㄷㅏ	anɲjʌŋɦada
ㅈㅏㅈㅣ	t͡ɕad͡ʑi
ㅇㅝㄴㅈㅗㄱ	wʌɲd͡ʑok̚
ㅇㅐㅁㅜㅎㅏㄷㅏ	ɛmuɦada
ㅊㅜㅁㅊㅜㄷㅏ	t͡ɕʰumt͡ɕʰuda
ㅇㅓㄲ	ʌk̚
ㅂㅏㅇㅣㅂㅡㄹ	paibɯɭ
ㅈㅜㅇㅂㅏㄴ	t͡ɕuŋban
ㅇㅝㄴㅈㅏㄹㅕㄱ	wʌɲd͡ʑaɾjʌk̚
ㄷㅜㄹㅕㅇㅝㅎㅏㄷㅏ	tuɾjʌwʌɦada
ㅌㅡㄱㅂㅕㄹ	tʰɯk̚pjʌɭ
ㅂㅏㅇㅇㅏㅅㄱㅏㄴ	paŋat̚kan
ㅎㅏㄴㄱㅏㅇㅟ	hanɡaɥi
ㄱㅖㅅㅏ	kjesʰa
ㅂㅏㅇㅍㅕㄴ	paŋpʰjʌn
ㅈㅜㄱㅛ	t͡ɕuɡjo
ㄸㅏㄹㅡㅁ	taɾɯm
ㅈㅣㅎㅏㄷㅡ	t͡ɕiɦadɯ
ㅇㅕㄹㅅㅣㅁㅎㅣ	jʌɭɕimʝi
ㅂㅏㄴㄷㅗㅇㅂㅜㄴㅈㅏ	pandoŋbuɲd͡ʑa
ㅊㅜㅇㅈㅓㄴㄱㅣ	t͡ɕʰuŋd͡ʑʌnɡi
ㅌㅡㄹㅓㅁㅍㅡ	tʰɯɾʌmpʰɯ
ㅈㅓㄴㅎㅏㄱ	t͡ɕɘnɦak̚
ㄹㅗㄷㅗㅇㅈㅏㄱㅜ	ɾodoŋd͡ʑaɡu
ㄱㅖㄱㅡㅂ	kjeɡɯp̚
ㅎㅡㄴㅈㅓㄱ	xɯɲd͡ʑʌk̚
ㅎㅚㄱㅕㄴ	ɸweɡjʌn
ㅍㅣㅅㅡㅌㅗㄹ	pʰisʰɯtʰoɭ
ㄷㅗㄹㅣ	toɾi
ㅂㅡㄹㄹㅜㅈㅣㄴ	pɯɭɭud͡ʑin
ㅅㅏㅇㅇㅘㄴㅅㅏㅁㄷㅜㄱㅡㄴ	sʰaŋwansʰamduɡɯn
ㅎㅏㄴㄱㅜㄱㅁㅏㄹ	hanɡuŋmaɭ
ㅉㅣㄷㅏ	t͡ɕida
ㅌㅗㅇㄱㅖ	tʰoŋɡje
ㅇㅠㅁㅗ	jumo
ㅇㅣㄹㅂㅏㄴ	iɭban
ㅈㅗㅇ	t͡ɕoŋ
ㅂㅏㄴㅈㅜㄱ	paɲd͡ʑuk̚
ㅇㅕㄱㅓㄴ	jɘɡʌn
ㄷㅐㄷㅜㅇㅓ	tɛduʌ
ㅇㅓㅉㅣ	ʌt͡ɕi
ㅊㅣㄹ	t͡ɕʰiɭ
ㅅㅗㄹ	sʰoɭ
ㅇㅗㄹㅠ	oɾju
ㄱㅜㄱㅈㅓㄱ	kuk̚t͡ɕʌk̚
ㅇㅜㅁㅜㄹ	umuɭ
ㄷㅐㄹㅣㅈㅓㅁ	tɛɾid͡ʑʌm
ㅍㅔㅎ	pʰet̚
ㅌㅏㅁㅎㅓㅁ	tʰamɦʌm
ㅈㅗㅅㅏㅎㅏㄷㅏ	t͡ɕosʰaɦada
ㄱㅏㄱㅁㅏㄱ	kaŋmak̚
ㅈㅣㅈㅣ	t͡ɕid͡ʑi
ㄱㅘㅇㅅㅓ	kwaŋsʰʌ
ㅌㅓㄴㅓㄹ	tʰʌnʌɭ
ㅈㅜㄹㄱㅣ	t͡ɕuɭɡi
ㅆㅜㄱ	suk̚
ㅈㅓㄴㅅㅏㅇㅈㅏㅇㄱㅗㄹㄱㅡㄱ	t͡ɕʌnsʰaŋd͡ʑaŋɡoɭɡɯk̚
ㅂㅣㅅㅈㅏㅇㅃㅕ	pit̚t͡ɕaŋpjʌ
ㅎㅘㄴㄱㅕㅇㅇㅗㅇㅕㅁ	ɸwanɡjʌŋojʌm
ㅈㅔㅈㅜㄸㅏㅅㅈㅟ	t͡ɕed͡ʑutat̚t͡ɕɥi
ㄱㅟㄱㅜㄱ	kɥiɡuk̚
ㅅㅏㅅㅏㅇ	sʰasʰaŋ
ㅂㅜㄴㄹㅣㅈㅜㅇㅢ	puʎʎid͡ʑuɰi
ㄴㅏㅊㅣ	nat͡ɕʰi
ㅌㅏㅇㅣ	tʰai
ㅊㅏㅁㅁㅏㅈㅏ	t͡ɕʰammad͡ʑa
ㅅㅡㄹㅓㅂㄷㅏ	sʰɯɾʌp̚ta
ㅇㅜㄹㄹㅏㄴㅂㅏㅌㅗㄹㅡ	uɭɭanbatʰoɾɯ
ㅎㅜㅈㅏㄱ	ɸʷud͡ʑak̚
ㅇㅓㄷㅡㅂㅔㄴㅊㅓ	ʌdɯbeɲt͡ɕʰʌ
ㅇㅏㄴㅈㅓㄴㅎㅏㄷㅏ	aɲd͡ʑʌnɦada
ㅋㅡㄴ	kxɯn
ㅁㅓㅇㅁㅓㅇ	mʌŋmʌŋ
ㅎㅘㄹㄷㅗㅇㅎㅏㄷㅏ	ɸwaɭtoŋɦada
ㅇㅣㄴㅁㅣㄴ	inmin
ㅊㅜㄹㅇㅝㄴㅈㅏ	t͡ɕʰuɾwʌɲd͡ʑa
ㅊㅏㅇㅅㅔㄱㅣ	t͡ɕʰaŋsʰeɡi
ㅇㅠㅁㅓ	jumʌ
ㅋㅡㄴㅈㅣㅂㅂㅏㄱㅈㅟ	kxɯɲd͡ʑip̚pak̚t͡ɕɥi
ㅂㅣㄴㅏㄴㅎㅏㄷㅏ	pinanɦada
ㅊㅜㄹㅣㄴㅣㅇ	t͡ɕʰuɾiniŋ
ㅇㅗㄴㄷㅗㄹ	ondoɭ
ㅈㅗㅁㅏㄴㄱㅏㄴ	t͡ɕomanɡan
ㄱㅗㄱㅡㅂ	koɡɯp̚
ㅎㅏㄹㄹㅗㅇㅟㄴ	haɭɭoɥin
ㅅㅓㅇㅊㅟ	sʰʌŋt͡ɕʰɥi
ㄱㅗㅇㄹㅗ	koŋno
ㅇㅏㅅㅓ	asʰʌ
ㅍㅗㄹㅗ	pʰoɾo
ㅁㅣㄹ	miɭ
ㄹㅣㅂㅣㄷㅗ	ɾibido
ㅂㅣㅅㅡㅅㅎㅏㄷㅏ	pisʰɯtʰada
ㄱㅡㅊㅣㄷㅏ	kɯt͡ɕʰida
ㄲㅓㄱㅈㅓㄱㅜ	kʌk̚t͡ɕʌɡu
ㅈㅏㅇㄱㅛ	t͡ɕaŋɡjo
ㅇㅡㄹㄱㅔ	ɯɭke
ㅁㅣㄴㅅㅜㄱㅣ	minsʰuɡi
ㄸㅓㄼㄷㅣㄸㅓㄼㄷㅏ	tɘɭtitʌɭta
ㄴㅏㄹㅜ	naɾu
ㄷㅐㅎㅏㄱㅅㅜㅎㅏㄱㄴㅡㅇㄹㅕㄱㅅㅣㅎㅓㅁ	tɛɦaksuɦaŋnɯŋɲjʌkɕiɦʌm
ㅌㅏㅇ	tʰaŋ
ㅎㅏㄱㅅㅜㄹ	haksuɭ
ㅈㅓㄱㅣ	t͡ɕʌɡi
ㅈㅣㅇㅕㄱ	t͡ɕijʌk̚
ㄴㅏㅁㅇㅛㅇ	namjoŋ
ㄷㅏㅂㅈㅓㅇㄴㅓ	tap̚t͡ɕʌŋnʌ
ㅇㅢㅇㅝㄴ	ɰiwʌn
ㄸㅔㅇㅏㅌㅡㄹㅡ	teatʰɯɾɯ
ㅂㅏㅇㅈㅣ	paŋd͡ʑi
ㅁㅗㄱㅅㅏ	moksa
ㅇㅖㅂㅣ	jebi
ㅂㅜㄴㅁㅕㅇㅎㅏㄷㅏ	punmjʌŋɦada
ㅁㅜㄴㅂㅏㅇ	munbaŋ
ㅅㅜㄱㅏㄴ	sʰuɡan
ㅅㅣㄴㅊㅔ	ɕʰiɲt͡ɕʰe
ㄸㅡㄷㄷㅏ	tɯt̚ta
ㅇㅗㄹㄹㅣㅂㅡ	oʎʎibɯ
ㅍㅗㄹㄹㅏㄴㄷㅡ	pʰoɭɭandɯ
ㅋㅔㅇㄱㅣㄷㅏ	kʰeŋɡida
ㅉㅏㅇㄸㅜㅇㅇㅓ	t͡ɕaŋtuŋʌ
ㅁㅣㄷㄷㅏ	mit̚ta
ㅁㅜㄴㅎㅘㅇㅝㄴ	munβwawʌn
ㄴㅕㅅㅓㅇㅈㅜㅇㅇㅡㅁ	ɲjʌsʰʌŋd͡ʑuŋɯm
ㄱㅏㄴㅈㅣ	kaɲd͡ʑi
ㄷㅏㄴㅂㅏㄹ	tanbaɭ
ㄱㅗㅇㅅㅡㅂ	koŋsʰɯp̚
ㅁㅐㅇㅡㅁㄱㅜㄹ	mɛɯmɡuɭ
ㅊㅏㅁㅇㅕ	t͡ɕʰamjʌ
ㄱㅡㄹㅣ	kɯɾi
ㅋㅓㅍㅡㄹ	kʰʌpʰɯɭ
ㄱㅘㅇㄴㅕㄴ	kwaŋɲjʌn
ㅍㅗㅌㅡ	pʰotʰɯ
ㅅㅗㄱㅇㅣㄷㅏ	sʰoɡida
ㅆㅏㄷㅏ	sada
ㅇㅕㄴㅎㅡㄴ	jʌnɣɯn
ㄷㅡㄹㅅㅜㅁ	tɯɭsʰum
ㅁㅗㅎㅕㅇ	moʝjʌŋ
ㅈㅏㄱㅈㅏㄱ	t͡ɕak̚t͡ɕak̚
ㅇㅐㅊㅣㅇ	ɛt͡ɕʰiŋ
ㅇㅖㅈㅓㅇ	jed͡ʑʌŋ
ㄴㅏㄹㄱㅗㄱㅣ	naɭɡoɡi
ㅊㅔㅅㅡ	t͡ɕʰesʰɯ
ㅁㅜㄹㅁㅏㅇㅊㅗ	muɭmaŋt͡ɕʰo
ㅈㅔㄷㅏㄴ	t͡ɕedan
ㅁㅗㄹㅔ	moɾe
ㄱㅏㄱㅏㅇㅜㅅㅡㅇㅓ	kaɡausʰɯʌ
ㄱㅏㅅㅜㅇㅇㅓ	kasʰuŋʌ
ㅁㅜㄹㄹㅓㄴㅏㄷㅏ	muɭɭʌnada
ㅇㅜㄹㅔ	uɾe
ㅋㅗㅁㅔㄴㅌㅡ	kʰomentʰɯ
ㄷㅐㅈㅓㄴ	tɛd͡ʑʌn
ㅌㅏㅌㅏㄹㅡㅇㅓ	tʰatʰaɾɯʌ
ㄸㅏㅅㅏㄹㅗㅂㄷㅏ	tasʰaɾop̚ta
ㅉㅣㅇㄱㅡㄹㅣㄷㅏ	t͡ɕiŋɡɯɾida
ㄹㅔㅋㅗㄷㅡ	ɾekʰodɯ
ㅁㅏㅇㅁㅕㅇ	maŋmjʌŋ
ㄱㅏㄱㅗㄱ	kaɡok̚
ㅈㅜㅇㅂㅜ	t͡ɕuŋbu
ㅂㅣㄴㅈㅏ	piɲd͡ʑa
ㅇㅘㅂㅘ	wabwa
ㅇㅏㅁㅜㄹㅣ	amuɾi
ㅈㅓㄹㅊㅏ	t͡ɕʌʎt͡ɕʰa
ㄴㅡㅈㅊㅜㄷㅏ	nɯt̚t͡ɕʰuda
ㅈㅏㅇㄱㅏ	t͡ɕaŋɡa
ㄱㅖ	kje
ㅇㅏㅆㅣ	aɕi
ㅈㅏㄴㅎㅗㄱ	t͡ɕanβok̚
ㅅㅣㄹ	ɕʰiɭ
ㄱㅓㅅㅔㄷㅏ	kʌsʰeda
ㄴㅗㄷㅗㅇ	nodoŋ
ㅋㅏㅌㅏㄹㅡ	kʰatʰaɾɯ
ㅁㅣㄱㅜㄱㅇㅣㄴ	miɡuɡin
ㅊㅟㅎㅏㄷㅏ	t͡ɕʰɥiɦada
ㅇㅏㅁㅜㄹㅓㅎㄷㅏ	amuɾʌtʰa
ㄴㅏㄺㄷㅏ	nak̚ta
ㅇㅏㄱㅡㄹㅏ	aɡɯɾa
ㅍㅣㄹㅣㄷㅏㅈㅣㄴ	pʰiɾidad͡ʑin
ㅂㅣㅇㅂㅣㅇ	piŋbiŋ
ㅇㅡㅁㅁㅜㄴ	ɯmmun
ㅊㅏㅈㅏㅇ	t͡ɕʰad͡ʑaŋ
ㅇㅗㄴㄱㅏㅈ	onɡat̚
ㅇㅑㅇㅅㅏㅇ	jaŋsʰaŋ
ㄷㅐㅊㅓㄴㅅㅏ	tɛt͡ɕʰʌnsʰa
ㅍㅡㅌㅔㄹㅣㄴ	pʰɯtʰeɾin
ㅇㅑㅎㅞ	jaβwe
ㅇㅕㅅㅓㅇㅅㅡㄹㅓㅂㄷㅏ	jʌsʰʌŋsʰɯɾʌp̚ta
ㅇㅡㅁㄹㅛ	ɯmɲjo
ㅍㅏㅅㅡㄴㅣㅂ	pʰasʰɯnip̚
ㅂㅜㄹㄱㅓㅈㅣㄷㅏ	puɭɡʌd͡ʑida
ㅅㅜㅁㅕㄴ	sʰumjʌn
ㄱㅣㅁㅏㄴㅎㅏㄷㅏ	kimanɦada
ㅂㅜㄹㅊㅣㅂㅕㅇ	puʎt͡ɕʰipjʌŋ
ㄴㄴ	nono
ㅌㅚㅇㅟ	tʰweɥi
ㅂㅗㅅㅈㅣㅁ	pot̚t͡ɕim
ㄱㅜㄹㅡㄷㅏ	kuɾɯda
ㅎㅏㅇㅣㅍㅡㄴ	haipʰɯn
ㅈㅜㅇㅢ	t͡ɕuɰi
ㄴㅗㄷㅗㅇㅂㅓㅂ	nodoŋpʌp̚
ㅂㅓㅅ	pɘt̚
ㅅㅣㄹㄹㅣㄷㅏ	ɕʰiʎʎida
ㅇㅡㅇㅈㅓㅂ	ɯŋd͡ʑʌp̚
ㄱㅣㄱㅖ	kiɡje
ㅇㅑㅈㅏㅇㅠ	jad͡ʑaju
ㄱㅡㄹㄹㅣㅅㅔㄹㅣㄴ	kɯʎʎisʰeɾin
ㅁㅗㄱㅁㅕㄴ	moŋmjʌn
ㅎㅏㅊㅓㄴ	hat͡ɕʰʌn
ㄱㅔㅇㅣㅅㅑ	keiɕʰa
ㅇㅗㅊ	ot̚
ㅇㅏㄴㅁㅏㄷㅏㅇ	anmadaŋ
ㅍㅑㄱ	pʰjak̚
ㅅㅏㅁㅜㄹ	sʰamuɭ
ㄱㅗㄹㅣㄹㄹㅏ	koɾiɭɭa
ㄱㅏㄹㅇㅡㅁㅎㅏㄷㅏ	kaɾɯmɦada
ㅃㅏㄹㅣ	paɾi
ㅇㅕㄹㅇㅕㄱㅎㅏㄱ	jʌʎʎjʌkʰak̚
ㅁㅏ	ma
ㅅㅣㅂㅇㅣ	ɕʰibi
ㅇㅏㅁㅜㄹㅡㄱㅏㅇ	amuɾɯɡaŋ
ㅇㅏㅇㅣㅅㅡㄹㄹㅏㄴㄷㅡ	aisʰɯɭɭandɯ
ㅇㅗㅂㅡㄴ	obɯn
ㅁㅜㄹㄹㅣㅎㅘㅎㅏㄱ	muʎʎiβwaɦak̚
ㅅㅏㅁㅅㅣㅂㅇㅠㄱㄱㅖ	sʰamɕʰibjuk̚kje
ㄹㅜㄱㅅㅔㅁㅂㅜㄹㅡㅋㅡ	ɾuksembuɾɯkxɯ
ㅈㅞㅊㅣㄷㅏ	t͡ɕwet͡ɕʰida
ㅂㅜㅇㅕ	pujʌ
ㅁㅣㅎㅏㄱ	miɦak̚
ㄲㅗㅊㅁㅏㄹ	konmaɭ
ㅂㅜㅈㅓㅅㄱㅏㄹㅏㄱ	pud͡ʑʌt̚kaɾak̚
ㅂㅐㅇㅇㅓ	pɛŋʌ
ㅎㅏㅇㅇㅢ	haŋɰi
ㄹㅣㅎㅣㅌㅔㄴㅅㅠㅌㅏㅇㅣㄴ	ɾiʝitʰenɕʰutʰain
ㅈㅜㅇㅇㅏㅇㅇㅏㅁㅔㄹㅣㅋㅏ	t͡ɕuŋaŋameɾikʰa
ㄷㅓㄹ	tɘɭ
ㅎㅘㅅㅏㄹ	ɸwasʰaɭ
ㅌㅡㄹㄷㅏ	tʰɯɭda
ㅂㅏㄴㄷㅣㅅㅂㅜㄹㅇㅣ	pandit̚puɾi
ㅈㅓㅇㄷㅏㅂㄷㅏ	t͡ɕʌŋdap̚ta
ㅎㅗㄹㅁㅠㅁ	ɸʷoɭmjum
ㅁㅗㄱㅈㅓㅈ	mok̚t͡ɕʌt̚
ㅌㅗㅇㅅㅗㄹㅈㅏ	tʰoŋsʰoʎd͡ʑa
ㅍㅛㅎㅕㄴㅎㅏㄷㅏ	pʰjoʝjʌnɦada
ㅈㅣㅂㅏㅇ	t͡ɕibaŋ
ㅂㅣㅊㅜㄷㅏ	pit͡ɕʰuda
ㅂㅜㅌㅓ	putʰʌ
ㄱㅓㅇㅑ	kɘja
ㅇㅚㅅㅜㄱㅁㅗ	wesʰuŋmo
ㅂㅣㅇㅇㅓ	piŋʌ
ㅇㅠㅈㅓㄴㅎㅏㄱ	jud͡ʑʌnɦak̚
ㅇㅏㅈㅣ	ad͡ʑi
ㄱㅕㄴㅂㅗㄴ	kjɘnbon
ㅁㅜㄹㄱㅗㄱㅣㅇㅏㄹ	muɭɡoɡiaɭ
ㅂㅜㄹㄹㅠㄴ	puʎʎjun
ㄱㅏㄹㅡㅊㅣㅁ	kaɾɯt͡ɕʰim
ㅍㅡㄹㄹㅏㅅㅡㅌㅣㄱ	pʰɯɭɭasʰɯtʰik̚
ㅍㅖㅎㅏ	pʰjeɦa
ㅋㅡㄹㅜㅇㅏㅅㅏㅇ	kxɯɾuasʰaŋ
ㅅㅣㅁㅜㄹ	ɕʰimuɭ
ㄱㅜㅈㅓㄹ	kud͡ʑʌɭ
ㄹㅣㅂㅅㅡㅌㅣㄱ	ɾipsɯtʰik̚
ㅅㅓㄴㅏㅁ	sʰʌnam
ㅍㅏㄴㅈㅏ	pʰaɲd͡ʑa
ㅊㅔㅎㅓㅁ	t͡ɕʰeɦʌm
ㅎㅚㅇㄷㅏㄴㅂㅗㄷㅗ	ɸweŋdanbodo
ㅌㅏㄹㄹㅏㄱ	tʰaɭɭak̚
ㄲㅣㄱ	kik̚
ㅁㅏㄹㅎㅏㄷㅏ	maɾɦada
ㅁㅜㄱㄴㅏㅂㅈㅏㄹㅜ	muŋnap̚t͡ɕaɾu
ㅈㅓㄴㅁㅜㄴ	t͡ɕʌnmun
ㄱㅔㅅㅣㅍㅏㄴ	keɕʰipʰan
ㅎㅜㄱㅖㅈㅏ	ɸʷuɡjed͡ʑa
ㄱㅗㅇㅈㅜㅇㅈㅓㄴㅎㅘ	koŋd͡ʑuŋd͡ʑʌnβwa
ㅅㅗㅂㅏㅇㅅㅜ	sʰobaŋsʰu
ㄱㅏㅇㅎㅘㄷㅗ	kaŋβwado
ㅅㅣㄴㄱㅣ	ɕʰinɡi
ㅅㅓㄱㅘ	sʰʌɡwa
ㄹㅣㅇ	ɾiŋ
ㅇㅛㄱㅓㄴ	jokʌn
ㅅㅣㅁㅅㅣㅁㅎㅏㄷㅏ	ɕʰimɕʰimɦada
ㅎㅏㄴㅗㅇㅣ	hanoi
ㅈㅣㄹㅡㅋㅗㄴㅠㅁ	t͡ɕiɾɯkʰoɲjum
ㅈㅗㄹㅇㅓㅂㅎㅏㄷㅏ	t͡ɕoɾʌpʰada
ㅂㅜㄹ	puɭ
ㅈㅘㅇㅜ	t͡ɕwau
ㅍㅣㅂㅂㅏㄱ	pʰip̚pak̚
ㅊㅜㅇㅅㅜ	t͡ɕʰuŋsʰu
ㅇㅡㅁㅎㅑㅇㅇㅑㅇㅈㅏ	ɯmʝjaŋjaŋd͡ʑa
ㄲㅜㅂㅏ	kuba
ㄱㅔㅇㅣㄱㅣ	keiɡi
ㅊㅗㄹㅗㅇㅊㅗㄹㅗㅇ	t͡ɕʰoɾoŋt͡ɕʰoɾoŋ
ㄱㅘㄴㄱㅖㅈㅏ	kwanɡjed͡ʑa
ㄷㅏㄴㅁㅜㄹㅇㅑㄱ	tanmuɾjak̚
ㄱㅗㄱㅗㅎㅏㄱ	koɡoɦak̚
ㅇㅑㄱㅈㅓㅁ	jak̚t͡ɕʌm
ㅂㅏㅇㅅㅗㅇㄱㅏㄴㅅㅓㅂ	paŋsʰoŋɡansʰʌp̚
ㅃㅐㄹㅅㅔㅁ	pɛɭsʰem
ㅇㅜㄹㅕ	uɾjʌ
ㅎㅏㅌㅚㅅㅏㅁㄷㅜㄱㅡㄴ	hatʰwesʰamduɡɯn
ㄱㅖㄱㅏㄴ	kjeɡan
ㅈㅔㄷㅗ	t͡ɕedo
ㅃㅏㄹㄹㅣ	paʎʎi
ㄱㅕㄹㅎㅗㄴㅅㅣㄱ	kjʌɾβonɕʰik̚
ㅂㅣㅂㅓㄴ	pibʌn
ㅊㅗㅋㅗㄹㄹㅔㅅ	t͡ɕʰokʰoɭɭet̚
ㅎㅔㅇㅣㄹㅜㅇㅈㅏㅇ	heiɾuŋd͡ʑaŋ
ㅈㅣㅂㄷㅡㄹ	t͡ɕip̚tɯɭ
ㅌㅜㅈㅏ	tʰud͡ʑa
ㅈㅏㅅㅏㄹㅎㅏㄷㅏ	t͡ɕasʰaɾɦada
ㄱㅓㅂㅜㄱㅇㅣ	kʌbuɡi
ㅁㅜㅎㅘㄱㅘ	muβwaɡwa
ㅇㅠㄱㅏㅁ	juɡam
ㄱㅕㅇㄱㅗ	kjɘŋɡo
ㅁㅗㅈㅓㄴ	mod͡ʑʌn
ㅎㅐㅇㅘㅇㅅㅓㅇ	hɛwaŋsʰʌŋ
ㅂㅕㅇㄷㅡㄹㄷㅏ	pjɘŋdɯɭda
ㅈㅔㅌㅏㄴ	t͡ɕetʰan
ㅇㅜㄴㄷㅗㅇㅂㅗㄱ	undoŋbok̚
ㅁㅓㅁㅜㄹㄷㅏ	mʌmuɭda
ㄱㅏㄴㅡㅁㅎㅏㄷㅏ	kanɯmɦada
ㅂㅜㄲㅡㄹㅓㅂㄷㅏ	pukɯɾʌp̚ta
ㅇㅕㄴㄹㅛ	jʌʎʎjo
ㄷㅗㅁㅔㅇㅣㄴ	tomein
ㅅㅓㅇㄱㅏㅁ	sʰɘŋɡam
ㄱㅗㅇㄱㅣㅂㅏㅇㅅㅓㄱ	koŋɡibaŋsʰʌk̚
ㅇㅏㅅㅟㅇㅜㅁ	aʃʰɥium
ㅅㅗㅎㅕㅇ	sʰoʝjʌŋ
ㄷㅗㄱㅡㅁ	toɡɯm
ㄹㅏㄷㅣㅇㅗ	ɾadio
ㄷㅚㅁㄷㅚㅁ	twemdwem
ㅅㅜㄱㅂㅏㄱ	sʰuk̚pak̚
ㅈㅣㅁㅏㄴ	t͡ɕiman
ㅈㅗㄱㅜㄱ	t͡ɕoɡuk̚
ㄹㅗㅁㅡㄴㅣㅇㅏ	ɾomɯnia
ㅅㅏㅈㅓㅇ	sʰad͡ʑʌŋ
ㅈㅜㅇㅇㅛㅅㅣㅎㅏㄷㅏ	t͡ɕuŋjoɕʰiɦada
ㅋㅏㅇㅣㄹㅗ	kʰaiɾo
ㅈㅣㄴㅏㅊㅣㄷㅏ	t͡ɕinat͡ɕʰida
ㅈㅣㅈㅓㅇㄷㅚㄷㅏ	t͡ɕid͡ʑʌŋdweda
ㅂㅣㅇㅅㅜ	piŋsʰu
ㄷㅡㄹㄱㅓㅅ	tɯɭɡʌt̚
ㄴㅗㅍㅇㅣㄷㅏ	nopʰida
ㅡ	ɯ
ㅇㅠㅈㅔㅍㅜㅁ	jud͡ʑepʰum
ㅈㅗㄱㅡㅁㅆㅣㄱ	t͡ɕoɡɯmɕik̚
ㅊㅗㄷㅡㅇㅎㅏㄱㄱㅛ	t͡ɕʰodɯŋɦak̚kjo
ㅇㅑㅇㅊㅗ	jaŋt͡ɕʰo
ㅇㅑㄱㅁㅜㄹ	jaŋmuɭ
ㅃㅐㅅㄷㅏ	pɛt̚ta
ㅇㅣㅇㅚ	iwe
ㅇㅕㄹㅇㅓㅄㄷㅏ	jɘɾʌp̚ta
ㅂㅜㄴㅁㅕㅇ	punmjʌŋ
ㅈㅓㅈㅌㅗㅇ	t͡ɕʌt̚tʰoŋ
ㅎㅚㅅㅏ	ɸwesʰa
ㄴㅗㅇㅣㄴ	noin
ㅅㅣㄴㅅㅓㄴㅎㅏㄷㅏ	ɕʰinsʰʌnɦada
ㅇㅓㄹㅏ	ʌɾa
ㄱㅣㅂㅏㄹ	kibaɭ
ㅇㅣㅂㅅㅜㄹㅇㅕㄴㅈㅣ	ipsuʎʎjʌɲd͡ʑi
ㅅㅣㄴㅇㅣㅁ	ɕʰinim
ㅅㅗㅁ	sʰom
ㅅㅣㅁㅂㅏㅇ	ɕʰimbaŋ
ㅅㅔㄹㅖ	sʰeɾje
ㅁㅜㄹㅇㅡㅁㅍㅛ	muɾɯmpʰjo
ㅅㅗㄹㄲㅏㅁㅏㄹ	sʰoɭkamaɭ
ㄱㅜㄴㅅㅗㄹㅣ	kunsʰoɾi
ㅂㅕㄴㅎㅘㄴ	pjɘnβwan
ㄴㅏㅂㅣ	nabi
ㄱㅘㅇㄱㅗ	kwaŋɡo
ㄷㅐㄱㅣㅎㅏㄷㅏ	tɛɡiɦada
ㄱㅖㄱㅗㄱ	kjeɡok̚
ㅇㅓㄹㅇㅓㅂㅜㅌㄷㅏ	ʌɾʌbut̚ta
ㅁㅔㄹㄹㅗㄴ	meɭɭon
ㅌㅔㄹㄹㅔㅂㅣㅈㅓㄴ	tʰeɭɭebid͡ʑʌn
ㅁㅣㅅㅜㄹ	misʰuɭ
ㅇㅣㅅㅓㅇ	isʰʌŋ
ㅋㅗㅌㅡ	kʰotʰɯ
ㅍㅗㅅㅡㅌㅓ	pʰosʰɯtʰʌ
ㅊㅜㅇㅊㅓㅇㄴㅏㅁㄷㅗ	t͡ɕʰuŋt͡ɕʰʌŋnamdo
ㅅㅣㅈㅏㅇ	ɕʰid͡ʑaŋ
ㅊㅏㅇㅛㅇㅇㅓ	t͡ɕʰajoŋʌ
ㅍㅣㅇㅡㅍ	pʰiɯp̚
ㅅㅓㅁㅕㅇ	sʰɘmjʌŋ
ㄲㅚㅂㅕㅇ	kwebjʌŋ
ㅇㅣㅂㄹㅕㄱㄱㅣ	imɲjʌk̚ki
ㅈㅡㅇㄱㅣㅅㅓㄴ	t͡ɕɯŋɡisʰʌn
ㅁㅗㅇㅑㅇ	mojaŋ
ㄷㅣㅈㅣㅌㅓㄹ	tid͡ʑitʰʌɭ
ㅇㅑㅌㅂㅗㄷㅏ	jat̚poda
ㅈㅣㅎㅏ	t͡ɕiɦa
ㄱㅣㅅㅌㅓㄹ	kit̚tʰʌɭ
ㅁㅜㄴㅎㅏㄱ	munɦak̚
ㄷㅏㄺㅂㅏㄹ	tak̚paɭ
ㄱㅏㅊㅏㅇ	kat͡ɕʰaŋ
ㅎㅏㄴㅏ	hana
ㄴㅣㄴㅈㅏ	niɲd͡ʑa
ㅇㅜㅅㅏㄴ	usʰan
ㄱㅓㄴㅇㅢ	kɘnɰi
ㅎㅟㅍㅏㄹㅏㅁ	hɥipʰaɾam
ㅍㅣㄹㄹㅡㅁ	pʰiɭɭɯm
ㅇㅓㄴㅈㅔㄴㅏ	ɘɲd͡ʑena
ㅈㅓㄴㅁㅏㅇ	t͡ɕɘnmaŋ
ㄱㅕㅇㅅㅏ	kjɘŋsʰa
ㅂㅔㄹㄹㅗㄹㅜㅅㅣ	peɭɭoɾuɕʰi
ㄷㅏㅈㅣㅁ	tad͡ʑim
ㄸㅏㄹㄸㅏㄹㅇㅣ	taɭtaɾi
ㅇㅑㅇㄱㅟㅂㅣ	jaŋɡɥibi
ㅇㅏㄱ	ak̚
ㅅㅣㄱㅏㅈㅓㄴㅊㅏ	ɕʰiɡad͡ʑʌɲt͡ɕʰa
ㅅㅏㅇㅅㅏㅇㄹㅕㄱ	sʰaŋsʰaŋɲjʌk̚
ㅅㅗㅅㅗㄱ	sʰosʰok̚
ㄲㅣㅇㅜㄷㅏ	kiuda
ㅅㅓㅇㄱㅜ	sʰʌŋɡu
ㅋㅗㅅㅗㅂㅗ	kʰosʰobo
ㅊㅏㄹㅖ	t͡ɕʰaɾje
ㅇㅏㄷㅣㅅㅡㅇㅏㅂㅏㅂㅏ	adisʰɯababa
ㅇㅕㅈㅏ	jʌd͡ʑa
ㅇㅑㅌㄷㅏ	jat̚ta
ㄷㅏㄺㅆㅏㅁ	taksam
ㅆㅓㄴㄱㅡㄹㄹㅏㅅㅡ	sʌnɡɯɭɭasʰɯ
ㅇㅣㄴㅅㅜ	insʰu
ㅅㅕㅂㅓㅅ	ɕʰʌbʌt̚
ㅁㅔㄴㅂㅜㅇ	menbuŋ
ㄴㅜㄴㄱㅣㄹ	nunkiɭ
ㄱㅛㅎㅘㅇ	kjoβwaŋ
ㅅㅓㅋㅓㅅㅡ	sʰʌkʰʌsʰɯ
ㅅㅡㅌㅠ	sʰɯtʰju
ㄷㅗㅇㄹㅛ	toŋɲjo
ㅅㅏㄱㅓㄴ	sʰakʌn
ㄱㅡㄴㅅㅏㅎㅏㄷㅏ	kɯnsʰaɦada
ㅁㅕㅊ	mjʌt̚
ㅅㅓㄹㅊㅣ	sʰʌʎt͡ɕʰi
ㅁㅗㅁㅂㅣㅊㄲㅏㄹ	mompit̚kaɭ
ㄱㅏㄱㅜ	kaɡu
ㅈㅣㄹㅁㅜㄴ	t͡ɕiɭmun
ㅊㅓㄴㅏㅁ	t͡ɕʰʌnam
ㅋㅔㅊㅓㅂ	kʰet͡ɕʰʌp̚
ㅂㅗㅈㅏㅇㅎㅏㄷㅏ	pod͡ʑaŋɦada
ㅅㅏㅇㅣㅍㅗㄴ	saipʰon
ㅂㅘ	pwa
ㄱㅕㅇㅈㅜ	kjɘŋd͡ʑu
ㅂㅗㅊㅡㅇㅘㄴㅏ	pot͡ɕʰɯwana
ㅍㅏㅊㅜㄹㅅㅗ	pʰat͡ɕʰuɭsʰo
ㅍㅗㄱㅈㅓㅇ	pʰok̚t͡ɕʌŋ
ㅅㅔㅌㅏㄱ	sʰetʰak̚
ㅁㅗㄱㅇㅛㄱ	moɡjok̚
ㅊㅗㅅㅡㅇㄷㅏㄹ	t͡ɕʰosʰɯŋtaɭ
ㅇㅗㄹㅡㅁ	oɾɯm
ㄴㅛㅅㅗ	ɲjosʰo
ㅁㅔㄱㅅㅣㅋㅗ	mekɕikʰo
ㄴㅏㅃㅏㅈㅣㄷㅏ	napad͡ʑida
ㄹㅏㅅㅓ	ɾasʰʌ
ㄱㅝㄴㄱㅗ	kwɘnɡo
ㅋㅏㄹㄹㅣㅍㅏ	kʰaʎʎipʰa
ㅍㅣㄹㅣㅁㅣㄷㅣㄴ	pʰiɾimidin
ㄱㅡㄹㅜㅌㅓㄱㅣ	kɯɾutʰʌɡi
ㅅㅗㅁㅕㄹㅎㅏㄷㅏ	sʰomjʌɾɦada
ㅁㅜㄹㄹㅗㄴㅇㅣㅂㄴㅣㄷㅏ	muɭɭonimnida
ㄹㅛㅇ	ɾjoŋ
ㅊㅡㅇ	t͡ɕʰɯŋ
ㄹㅕㅁ	ɾjʌm
ㅍㅛㅈㅓㄹ	pʰjod͡ʑʌɭ
ㅌㅏㄹㅇㅕㅇㅈㅏ	tʰaɾjʌŋd͡ʑa
ㅎㅏㄱㅏㅇ	haɡaŋ
ㅃㅐㄴㅗㅎㄷㅏ	pɛnotʰa
ㄱㅘㄴㄹㅕㄴㄷㅚㄷㅏ	kwaʎʎjʌndweda
ㅇㅣㄹㅈㅏㄹㅣ	iʎt͡ɕaɾi
ㄹㅔㅂㅏㄴㅗㄴ	ɾebanon
ㄱㅏㅁㄷㅗㄹㄱㅗㄱㅣ	kamdoɭɡoɡi
ㅃㅏㅇ	paŋ
ㄱㅗㅇㄷㅗㅇㅊㅔ	koŋdoŋt͡ɕʰe
ㅍㅕㅇㅅㅗ	pʰjʌŋsʰo
ㄸㅓㄱㅂㅗㄲㅇㅣ	tʌk̚poki
ㄱㅕㄱㄹㅕ	kjʌŋɲjʌ
ㅃㅣㅊㅣㅁㅂㅕㄹ	pit͡ɕʰimbjʌɭ
ㅇㅜㅋㅡㄹㅏㅇㅣㄴㅏㅇㅓ	ukxɯɾainaʌ
ㅂㅣㅍㅏ	pipʰa
ㄱㅏㄹㄷㅡㅇ	kaɭtɯŋ
ㄱㅡㅁㅏㄴㄷㅜㄷㅏ	kɯmanduda
ㅎㅏㅁㅂㅜㄹㅡㅋㅡ	hambuɾɯkxɯ
ㅌㅔㄴㅔㅅㅣㄴ	tʰeneɕʰin
ㅍㅣㅂ	pʰip̚
ㄱㅓㅁㅜㄴㄱㅗ	kʌmunɡo
ㅈㅓㅇㅇㅠ	t͡ɕʌŋju
ㅇㅓㄴㄹㅗㄴ	ʌɭɭon
ㅅㅜㄷㅏ	sʰuda
ㄱㅓㅁㅈㅣㄹㄱㅣㄷㅏ	kɘmd͡ʑiɭɡida
ㄷㅐㅇㅕㄱㅈㅚ	tɛjʌk̚t͡ɕwe
ㅁㅜㄱㅣ	muɡi
ㅂㅓㄹㄲㅜㄹ	pɘɭkuɭ
ㅅㅏㅇㅣㅋㅡㄹㄹㅣㅇ	sʰaikxɯʎʎiŋ
ㄱㅘㅁㅗㄱ	kwamok̚
ㅎㅏㅍㅡ	hapʰɯ
ㅁㅗㄱㅂㅏㄹ	mok̚paɭ
ㅁㅏㅇㄹㅕㅇ	maŋɲjʌŋ
ㅈㅏㄹㅡㄷㅏ	t͡ɕaɾɯda
ㄴㅕㅅㅓㅇㅈㅓㅇㅡㅁ	ɲjʌsʰʌŋd͡ʑʌɯm
ㅇㅗㅊㅣㄹㅔㄱㅣ	ot͡ɕʰiɾeɡi
ㅅㅏㅇㄷㅏㅇㅎㅣ	sʰaŋdaŋʝi
ㄱㅓㅈㅣㅅ	kɘd͡ʑit̚
ㅍㅔㅂㅌㅣㄷㅡ	pʰep̚tʰidɯ
ㄱㅏㅁㅇㅕㅁㅈㅡㅇ	kamjʌmt͡ɕɯŋ
ㅅㅜㅁㄷㅏ	sʰumta
ㅋㅡㄴㅁㅜㄹ	kxɯnmuɭ
ㅇㅕㅇㅇㅓ	jʌŋʌ
ㅇㅣㄱ	ik̚
ㄴㅗㅎㅇㅣㄷㅏ	noida
ㅈㅡㅇㄱㅏ	t͡ɕɯŋɡa
ㅇㅣㅅㅏㄴㅎㅘㅌㅏㄴㅅㅗ	isʰanβwatʰansʰo
ㅋㅡㄹㄹㅗㅂㅓ	kxɯɭɭobʌ
ㅈㅣㅂㅈㅜㅇ	t͡ɕip̚t͡ɕuŋ
ㅇㅕㄷㅇㅏㅎㅗㅂ	jʌdaβop̚
ㅂㅏㅈㅏㄹㅡ	pad͡ʑaɾɯ
ㅅㅣㅎㅓㅁ	ɕʰiɦʌm
ㅇㅓㅁㅜㄱ	ʌmuk̚
ㅁㅜㄱㄱㅏ	muk̚ka
ㅌㅗㅇㄴㅕㅁ	tʰoŋɲjʌm
ㅇㅗㄹㅣㄴㅓㄱㅜㄹㅣ	oɾinʌɡuɾi
ㄹㅛㄽ	ɾjoɭ
ㅆㅡㄹㄷㅏ	sɯɭda
ㅊㅐㅅㅗㅂㅏㅌ	t͡ɕʰɛsʰobat̚
ㅇㅠㄷㅗㄱ	judok̚
ㅊㅏㅁㄷㅏ	t͡ɕʰamta
ㅆㅏㅁㅈㅏㅇ	samd͡ʑaŋ
ㄷㅓㅂㄷㅏ	tɘp̚ta
ㄱㅡㄴㅂㅗㄴ	kɯnbon
ㅇㅕㄹㄷㅏ	jɘɭda
ㅇㅜㅁㅈㅣㄱㅇㅣㄷㅏ	umd͡ʑiɡida
ㅂㅏㄱㅅㅡ	paksɯ
ㄷㅏㅇㅑㅇㅎㅏㄷㅏ	tajaŋɦada
ㅁㅣㅅㅡㅌㅓㄹㅣ	misʰɯtʰʌɾi
ㅂㅣㄷㅡㅁ	pidɯm
ㅇㅕㄴㅅㅡㅂㄱㅗㄱ	jɘnsʰɯp̚kok̚
ㅅㅏㄹㄷㅏ	sʰaɭda
ㄱㅕㅁ	kjʌm
ㅁㅗㄱㅁㅏㄹㅡㄷㅏ	moŋmaɾɯda
ㅂㅣㄷㅣㅇㅗ	pidio
ㅈㅓㅂㅎㅏㄷㅏ	t͡ɕʌpʰada
ㄱㅕㅇㅂㅗㄱㅣ	kjɘŋboɡi
ㅎㅡㅂㅅㅜㅈㅣ	xɯpsud͡ʑi
ㅇㅡㅁㄱㅖ	ɯmɡje
ㅌㅓㄱㅅㅜㅇㅕㅁ	tʰʌksujʌm
ㄱㅡㄷㅏㅈㅣ	kɯdad͡ʑi
ㅁㅜㅅㅓㅇㅜㅁ	musʰʌum
ㅅㅓㅁㅁㅏㅇ	sʰʌmmaŋ
ㄱㅏㄱ	kak̚
ㅁㅗㅅㅔㄱㅘㄴ	mosʰeɡwan
ㅇㅏㄵㅇㅡㄴㅈㅏㄹㅣ	aɲd͡ʑɯɲd͡ʑaɾi
ㄹㅓㅅㅣㅇㅏㅁㅏㄹ	ɾʌɕʰiamaɭ
ㅈㅏㅇㅠㅈㅓㄱ	t͡ɕajud͡ʑʌk̚
ㅂㅏㄱㅊㅏ	pak̚t͡ɕʰa
ㅌㅗㅂㅏㄱㅗ	tʰobaɡo
ㅅㅡㅌㅔㅇㅣㅋㅡ	sʰɯtʰeikxɯ
ㅂㅡㄹㅜㄴㅏㅇㅣ	pɯɾunai
ㅈㅓㅂㅅㅜㅊㅓ	t͡ɕʌpsut͡ɕʰʌ
ㅈㅓㅇㅁㅏㄹㄹㅗ	t͡ɕɘŋmaɭɭo
ㅎㅘㅅㅏ	ɸwasʰa
ㅇㅓㅂ	ʌp̚
ㄱㅓㄷㅡㅂㅆㅣ	kʌdɯpɕi
ㅈㅣㅂㅈㅟ	t͡ɕip̚t͡ɕɥi
ㄴㅏㄹㅇㅏㄱㅏㄷㅏ	naɾaɡada
ㅇㅗㅅㅡㅌㅡㄹㅣㅇㅏ	osʰɯtʰɯɾia
ㅈㅣㄹㅠ	t͡ɕiɾju
ㅈㅏㅇㅓㅂㅈㅏㄷㅡㄱ	t͡ɕaʌp̚t͡ɕadɯk̚
ㄲㅏㅁㅉㅏㄱ	kamt͡ɕak̚
ㅍㅕㄴㅊㅏㄶㄷㅏ	pʰjʌɲt͡ɕʰantʰa
ㅅㅏㅎㅚ	sʰaβwe
ㅁㅗㅂㅏㄴ	moban
ㄷㅜㄹㅡㄷㅏ	tuɾɯda
ㅅㅏㅊㅣㅍㅜㅁ	sʰat͡ɕʰipʰum
ㅇㅝㄹㅂㅕㅇ	wʌɭbjʌŋ
ㅁㅏㅇㅣㅌㅡㄴㅓㄹㅠㅁ	maitʰɯnʌɾjum
ㅋㅡㄷㅏ	kxɯda
ㅂㅡㄹㄹㅗㄱㅡ	pɯɭɭoɡɯ
ㅎㅏㅇㅣㅇㅔㄴㅏ	haiena
ㅊㅏㄴㄱㅏ	t͡ɕʰanka
ㅎㅜㄴㄹㅕㄴ	ɸʷuʎʎjʌn
ㅇㅛㅂㅓㅂ	jobʌp̚
ㅂㅓㅁㅜㄹㅣㄷㅏ	pʌmuɾida
ㅊㅜㄱㅊㅓㄱ	t͡ɕʰuk̚t͡ɕʰʌk̚
ㅂㅓㅁㅇㅓ	pɘmʌ
ㅈㅗㄱㅛ	t͡ɕoɡjo
ㄹㅗㄱㅡ	ɾoɡɯ
ㄱㅏㄹㅈㅡㅇ	kaʎt͡ɕɯŋ
ㅇㅜㅊㅔㅌㅗㅇ	ut͡ɕʰetʰoŋ
ㄸㅓㄹㅊㅣㄷㅏ	tʌʎt͡ɕʰida
ㅊㅔㄹㄹㅗ	t͡ɕʰeɭɭo
ㅈㅜㅊㅔ	t͡ɕut͡ɕʰe
ㄹㅜㅍㅔ	ɾupʰe
ㅈㅔㅇㅏㄴ	t͡ɕean
ㅇㅣㅁㅅㅣ	imɕʰi
ㅈㅏㅇㅈㅓㅇ	t͡ɕaŋd͡ʑʌŋ
ㄷㅓㄴ	tʌn
ㄴㅏㅂㅊㅣ	nap̚t͡ɕʰi
ㅅㅗㅎㅘㅈㅓㄴ	sʰoβwad͡ʑʌn
ㄷㅗㄹㅣ	toɾi
ㅁㅜㄹㄱㅗㄱㅣ	muɭkoɡi
ㅇㅕㄱㄹㅑㅇ	jʌŋɲjaŋ
ㄱㅗㅇㅅㅏㄴㅈㅜㅇㅢㅈㅏ	koŋsʰaɲd͡ʑuɰid͡ʑa
ㅈㅜㄹㄱㅗㅇㅊㅣ	t͡ɕuɭɡoŋt͡ɕʰi
ㄷㅏㄷㄷㅏ	tat̚ta
ㅈㅓㄴㄱㅏㄹ	t͡ɕʌnɡaɭ
ㄱㅏㅁㅊㅜㄷㅏ	kamt͡ɕʰuda
ㅂㅏㅇㅇㅓ	paŋʌ
ㅅㅜㅊ	sʰut̚
ㅁㅕㅇㄱㅘㄴ	mjʌŋɡwan
ㅊㅗㄱㅗㅊㅜㅈㅏㅇ	t͡ɕʰoɡot͡ɕʰud͡ʑaŋ
ㅋㅡㄴㅈㅜㄹㄴㅏㅂㅈㅏㄹㅜ	kxɯɲd͡ʑuɭɭap̚t͡ɕaɾu
ㅍㅏㅌㅂㅣㅇㅅㅜ	pʰat̚piŋsʰu
ㄱㅗㄱㅈㅗ	kok̚t͡ɕo
ㅁㅜㄴㅎㅓㄴ	munɦʌn
ㅎㅘㄱㅂㅗ	ɸwak̚po
ㅇㅣㄹㅗㄴ	iɾon
ㅈㅣㅇㅗㄱㅊㅓㄹ	t͡ɕiok̚t͡ɕʰʌɭ
ㄱㅛㅁㅏㄴ	kjoman
ㅂㅓㅁㅇㅟ	pɘmɥi
ㅈㅣㄴㅔ	t͡ɕine
ㅌㅗㅇㅇㅣㄹ	tʰoŋiɭ
ㅁㅗㄱㄹㅏㄴ	moŋnan
ㅇㅓㄴㄹㅗㄴㅎㅏㄱ	ʌɭɭonɦak̚
ㅊㅓㅇㄱㅏㅅㅣㄱㅗㄱㅣ	t͡ɕʰʌŋɡaɕʰiɡoɡi
ㅍㅏㄹㅍㅏㄹㅎㅏㄷㅏ	pʰaɭpʰaɾɦada
ㅊㅔㅈㅗ	t͡ɕʰed͡ʑo
ㅌㅣㄹㅏㄴㅏ	tʰiɾana
ㅅㅣㅂㅇㅣㅇㅝㄹ	ɕʰibiwʌɭ
ㅌㅡㄹㄹㅣㅁㅇㅓㅄㅇㅣ	tʰɯʎʎimʌpɕi
ㅎㅏㅂㅜㄱ	habuk̚
ㄹㅛ	ɾjo
ㄱㅏㄹㅁㅏㅇㅎㅏㄷㅏ	kaɭmaŋɦada
ㅇㅗㄴㅈㅓㄴㅎㅏㄷㅏ	oɲd͡ʑʌnɦada
ㅈㅓㄴㅎㅘ	t͡ɕɘnβwa
ㄷㅏㄱㅏㄱㅏㄷㅏ	taɡaɡada
ㄹㅏㄷㅗㄴ	ɾadon
ㄷㅐㅈㅏㄱㅈㅏ	tɛd͡ʑak̚t͡ɕa
ㅂㅏㄹㅂㅏㄷㅏㄱ	paɭpadak̚
ㅌㅣㅅㅕㅊㅡ	tʰiɕʰʌt͡ɕʰɯ
ㅂㅏㅅㅏㄱㄱㅘㅈㅏ	pasʰak̚kwad͡ʑa
ㅋㅗㅍㅣ	kʰopʰi
ㅅㅜㅂㅏㄱ	sʰubak̚
ㅇㅣㄹㅈㅗㅇ	iʎt͡ɕoŋ
ㅇㅞㅂㅌㅜㄴ	wep̚tʰun
ㅁㅣㅅㅣㅇ	miɕʰiŋ
ㅈㅏㄱㅍㅜㅁ	t͡ɕak̚pʰum
ㅅㅣㄴㅎㅗㄷㅡㅇ	ɕʰinβodɯŋ
ㅇㅗㅁㅣㅈㅏ	omid͡ʑa
ㅇㅣㄹㅡㄷㅏ	iɾɯda
ㅇㅑㅇㅅㅣㅁ	jaŋɕʰim
ㅇㅣㄴㅎㅕㅇㄱㅡㄱ	inʝjʌŋɡɯk̚
ㅇㅗㅇㅡㅁ	oɯm
ㄱㅜㅂㅎㅣㄷㅏ	kupʰida
ㅈㅜㅇㅣㄹ	t͡ɕuiɭ
ㅍㅏㄹㄸㅜㄱ	pʰaɭtuk̚
ㄱㅏㄱㄷㅗ	kak̚to
ㅅㅡㅍㅔㄱㅌㅡㄹㅓㅁ	sʰɯpʰek̚tʰɯɾʌm
ㄱㅗㅇㅇㅓㄴㅎㅏㄷㅏ	koŋʌnɦada
ㅅㅓㅇㅈㅏㅇ	sʰʌŋd͡ʑaŋ
ㅈㅓㄴㅌㅗㅇㅈㅓㄱ	t͡ɕʌntʰoŋd͡ʑʌk̚
ㅈㅓㄴㅊㅔㅈㅓㄱ	t͡ɕʌɲt͡ɕʰed͡ʑʌk̚
ㄱㅡㄹㅆㅡㄴㅇㅣ	kɯɭsɯni
ㅈㅜㄹㅗ	t͡ɕuɾo
ㅇㅏㅁㅜㅌㅡㄴ	amutʰɯn
ㅈㅣㄹㅎㅘㄴ	t͡ɕiɾβwan
ㄱㅡㄱㄷㅏㄴㅈㅜㅇㅢ	kɯk̚taɲd͡ʑuɰi
ㅇㅣㄹㅂㅗㄴㅎㅏㄱ	iɭbonɦak̚
ㄱㅐㄱㅏㅎㅏㄷㅏ	kɛɡaɦada
ㅈㅓㅈㅣㅎㅏㄷㅏ	t͡ɕʌd͡ʑiɦada
ㅅㅡㅇㄱㅖ	sʰɯŋɡje
ㅇㅠㅈㅗㅊㅏ	jud͡ʑot͡ɕʰa
ㅅㅓㅇㄱㅗㅇ	sʰʌŋɡoŋ
ㅎㅜㅊㅜㅅㄱㅏㄹㅜ	ɸʷut͡ɕʰut̚kaɾu
ㅎㅔㄹㅈㅗㅅㅓㄴ	heʎd͡ʑosʰʌn
ㄷㅗㄷㄷㅏ	tot̚ta
ㅅㅣㄷㄷㅏ	ɕʰit̚ta
ㅌㅓㄹ	tʰʌɭ
ㅎㅏㅁㅎㅡㅇ	hamɣɯŋ
ㅇㅣㄹㅈㅜㅇㅣㄹ	iʎt͡ɕuiɭ
ㄱㅓㄴㄱㅏㅇ	kɘnɡaŋ
ㅈㅡㅇㅈㅓㅇ	t͡ɕɯŋd͡ʑʌŋ
ㅇㅛㅇㅂㅣㅇㅓㅊㅓㄴㄱㅏ	joŋbiʌt͡ɕʰʌnɡa
ㄷㅟㅅㅁㅏㄷㅏㅇ	tɥinmadaŋ
ㄷㅗㅂㄷㅏ	top̚ta
ㅎㅏㄹㅁㅓㄴㅣ	haɭmʌni
ㅅㅜㅌ	sʰut̚
ㅎㅓㅇㅛㅇ	hʌjoŋ
ㄴㅐㄷㅏ	nɛda
ㅁㅗㄹㅡㅍㅣㄴ	moɾɯpʰin
ㅂㅜㄷㅏㅍㅔㅅㅡㅌㅡ	pudapʰesʰɯtʰɯ
ㅁㅏㄴ	man
ㅎㅗㅇㅅㅗㅇㅇㅓ	ɸʷoŋsʰoŋʌ
ㅊㅣㅌㅏ	t͡ɕʰitʰa
ㅇㅓㅇㅋㅡㅁㅎㅏㄷㅏ	ʌŋkxɯmɦada
ㅈㅗㄹㅠㅎㅏㄱ	t͡ɕoɾjuɦak̚
ㄷㅔㄴㅁㅏㅋㅡ	tenmakxɯ
ㅋㅡㅂㅏㅅㅡ	kxɯbasʰɯ
ㅋㅗㅍㅔㄴㅎㅏㄱㅔㄴ	kʰopʰenɦaɡen
ㅍㅕㅇㅅㅏㅇ	pʰjʌŋsʰaŋ
ㅈㅜㅁㅓㄱ	t͡ɕumʌk̚
ㄱㅐㅈㅏㅅㅣㄱ	kɛd͡ʑaɕʰik̚
ㅁㅣㄱㅏㄱ	miɡak̚
ㅅㅜㅇㄱㅕㅇㅎㅏㄷㅏ	sʰuŋɡjʌŋɦada
ㅁㅏㅇㄱㅏㄴㅣㅈㅡ	maŋɡanid͡ʑɯ
ㅌㅡㄹㅗㄹ	tʰɯɾoɭ
ㅈㅏㄱㄴㅕㄴ	t͡ɕaŋɲjʌn
ㅅㅣㄹㄱㅗㄱㅣ	ɕʰiɭɡoɡi
ㅇㅟㅇㅝㄴ	ɥiwʌn
ㅇㅘㄴㅂㅕㄱ	wanbjʌk̚
ㅇㅣㅅㅏㅁ	isʰam
ㄷㅗㄱㅇㅓ	toɡʌ
ㅂㅗㅎㅓㅁ	poɦʌm
ㄸㅓㅇㅗㄹㅡㄷㅏ	tʌoɾɯda
ㅅㅣㅁㅂㅜㄹㅡㅁㅎㅏㄷㅏ	ɕʰimbuɾɯmɦada
ㄱㅓㅁㅇㅡㄴㅁㅓㄹㅣㅎㅢㄴㅈㅜㄱㅈㅣ	kʌmɯnmʌɾiʝiɲd͡ʑuk̚t͡ɕi
ㅆㅣㅅㅇㅡㄴㄷㅡㅅㅇㅣ	ɕisʰɯndɯɕʰi
ㅂㅜㄴㄱㅘㅇ	punɡwaŋ
ㅍㅕㄴㄱㅕㅇ	pʰjʌnɡjʌŋ
ㅁㅏㄱㅂㅏㅈㅣ	mak̚pad͡ʑi
ㅋㅔㅇㅣㅋㅡ	kʰeikxɯ
ㅇㅝㄴㅅㅜㅇㅇㅣ	wɘnsʰuŋi
ㅇㅕㄹㅡㅁ	jʌɾɯm
ㅇㅕㅇㅇㅑㅇㅌㅏㅇ	jʌŋjaŋtʰaŋ
ㅎㅘㅈㅏㅇㅍㅜㅁ	ɸwad͡ʑaŋpʰum
ㅉㅗㄱ	t͡ɕok̚
ㄲㅏㅊㅣㅂㅗㄱ	kat͡ɕʰibok̚
ㅅㅣㄱㅅㅓㅇ	ɕʰiksʌŋ
ㅈㅣㅎㅟㅈㅏ	t͡ɕiɦɥid͡ʑa
ㄴㅗㄹㅇㅣㅌㅓ	noɾitʰʌ
ㄷㅡㄹㅇㅓㅇㅗㄻㄱㅣㄷㅏ	tɯɾʌomɡida
ㄷㅏㄱㅊㅣㄷㅏ	tak̚t͡ɕʰida
ㄱㅗㄷㅡㅇㅎㅏㄱㄱㅛ	kodɯŋɦak̚kjo
ㅅㅏㄹㅇㅏㅇㅗㄷㅏ	sʰaɾaoda
ㅁㅏㄱㅟ	maɡɥi
ㄱㅜㄹㄸㅜㄱ	kuɭtuk̚
ㄱㅜㅇㅍㅣㅂ	kuŋpʰip̚
ㅅㅣㅂㅅㅏㅁ	ɕʰipsam
ㄸㅏㄱㄸㅏㄱㅎㅏㄷㅏ	tak̚takʰada
ㅇㅕㅇㄹㅣㅎㅏㄷㅏ	jɘŋniɦada
ㄷㅗㅇㄹㅕㄱ	toŋɲjʌk̚
ㄴㅓㄱ	nɘk̚
ㄹㅏㄱㅌㅏ	ɾak̚tʰa
ㄸㅗㅇ	toŋ
ㄹㅕㅇㅅㅏ	ɾjʌŋsʰa
ㅌㅡㄹㄹㅣㅁㅇㅓㅄㄷㅏ	tʰɯʎʎimʌp̚ta
ㄱㅜㄴㅂㅗㄱ	kunbok̚
ㄱㅗㅇㄱㅏㄹㅎㅏㄷㅏ	koŋɡaɾɦada
ㅎㅘ	ɸwa
ㄱㅡㄴㄹㅗㅈㅏ	kɯɭɭod͡ʑa
ㅎㅏㅂㅜ	habu
ㅅㅓㄴㅅㅣㄹ	sʰʌnɕʰiɭ
ㅊㅗㅌㅡㄱㄱㅡㅂ	t͡ɕʰotʰɯk̚kɯp̚
ㄱㅣㅇㅓㄱ	kiʌk̚
ㅇㅏㅈㅔㅌㅣㄷㅣㄴ	ad͡ʑetʰidin
ㅅㅗㅁㅏㄹㄹㅣㅇㅏ	somaʎʎia
ㅎㅗㄴㄷㅗㄴㅎㅏㄷㅏ	ɸʷondonɦada
ㅎㅚㅂㅗㄱㅎㅏㄷㅏ	ɸwebokʰada
ㄷㅏㅁㅏㄴ	taman
ㅇㅠㄱㅚ	juɡwe
ㅇㅓㅂㄷㅗㅇㅇㅣ	ʌp̚toŋi
ㄹㅏㅁㅕㄴ	ɾamjʌn
ㅌㅏㅈㅗ	tʰad͡ʑo
ㅎㅏㅇㅇㅝㄴ	haŋwʌn
ㅁㅏㄹㅕㄴ	maɾjʌn
ㅈㅣㄹㅏㄹㅎㅏㄷㅏ	t͡ɕiɾaɾɦada
ㅊㅣㅁㄹㅑㄱㅈㅏ	t͡ɕʰimɲjak̚t͡ɕa
ㅂㅏㄹㅌㅗㅂ	paɭtʰop̚
ㅅㅏㄷㅏㄹㅣ	sʰadaɾi
ㄱㅏㄱㅎㅏ	kakʰa
ㄹㅗㅅ	ɾot̚
ㅍㅏㅍㅏㅇㅑ	pʰapʰaja
ㅈㅗㄴㅈㅜㅇ	t͡ɕoɲd͡ʑuŋ
ㅎㅘㄴㅈㅓㄹㄱㅣ	ɸwaɲd͡ʑʌɭɡi
ㄱㅜㅊㅜㄱㅎㅏㅁ	kut͡ɕʰukʰam
ㅈㅣㄴㅏㄴㅂㅓㄴ	t͡ɕinanbʌn
ㅌㅜㅅㅜㄱ	tʰusʰuk̚
ㅂㅔㄹ	peɭ
ㅇㅛㅊㅓㅇㅎㅏㄷㅏ	jot͡ɕʰʌŋɦada
ㅇㅣㅂㄱㅜ	ip̚ku
ㅅㅣㄹㅣㅈㅡ	ɕʰiɾid͡ʑɯ
ㅇㅘㅇㅅㅜ	waŋsʰu
ㅁㅜㅇㅓㄴㄱㅏ	muʌnɡa
ㅂㅜㅂㅜ	pubu
ㄴㅗㄹㅡㅇㅞㅇㅣㅇㅓ	noɾɯweiʌ
ㅇㅗㅈㅜㅁ	od͡ʑum
ㅍㅡㄹㅗㄱㅡㄹㅏㅁ	pʰɯɾoɡɯɾam
ㅇㅕㅇㅜㅂㅣ	jʌubi
ㅈㅓㄴㅌㅗㅇ	t͡ɕʌntʰoŋ
ㅃㅏㅈㅕㄴㅏㅇㅗㄷㅏ	pad͡ʑʌnaoda
ㅂㅏㄴㅈㅣ	paɲd͡ʑi
ㄲㅏㄷㅏㄺ	kadak̚
ㄴㅏㄴ	nan
ㅅㅜㄹㅣ	sʰuɾi
ㄷㅜㄷㅡㄹㅓㅈㅣㄷㅏ	tudɯɾʌd͡ʑida
ㅆㅙㄱㅣ	swɛɡi
ㅁㅣㅎㅏㅂㅈㅜㅇㄱㅜㄱ	miɦap̚t͡ɕuŋɡuk̚
ㅈㅣㅎㅏㄴㅜㅂㅣ	t͡ɕiɦanubi
ㄸㅗㄱㄸㅗㄱㅎㅏㄷㅏ	tok̚tokʰada
ㅇㅣㄴㅈㅏ	iɲd͡ʑa
ㅍㅏㄹㅣ	pʰaɾi
ㅂㅔㄴㅌㅗ	pentʰo
ㅎㅏㅍㅜㅁㅎㅏㄷㅏ	hapʰumɦada
ㅍㅡㄹㄹㅓㄱㅡㅇㅣㄴ	pʰɯɭɭʌɡɯin
ㅊㅜㅊㅜㄹㅁㅜㄹ	t͡ɕʰut͡ɕʰuɭmuɭ
ㅂㅗㄱㅈㅔ	pok̚t͡ɕe
ㅂㅗㄱㅅㅏㅎㅏㄷㅏ	poksaɦada
ㄱㅓㅁㅇㅡㄴㄷㅏㅁㅂㅣ	kʌmɯndambi
ㄹㅐㅇㅈㅏㅇㄱㅗ	ɾɛŋd͡ʑaŋɡo
ㅈㅓㅁㅅㅜ	t͡ɕʌmsu
ㅎㅔㄹㅅㅡㅋㅡㄹㄹㅓㅂ	heɭsʰɯkxɯɭɭʌp̚
ㅂㅜㅌㅏㄴ	putʰan
ㅈㅓㄻㅇㅡㄴㅇㅣ	t͡ɕʌɭmɯni
ㅅㅏㄴㅅㅜㄹ	sʰansʰuɭ
ㅇㅢㅅㅏ	ɰisʰa
ㅂㅜㄹㅂㅓㅂ	puɭbʌp̚
ㅈㅏㅋㅏㄹㅡㅌㅏ	t͡ɕakʰaɾɯtʰa
ㄱㅓㅇㅟ	kʌɥi
ㄴㅗㅂㅗㅅㅣㅂㅣㄹㅡㅅㅡㅋㅡ	noboɕʰibiɾɯsʰɯkxɯ
ㅅㅣㅊㅓㅇㅈㅏ	ɕʰit͡ɕʰʌŋd͡ʑa
ㅍㅣㄹㅏㄴㅑ	pʰiɾaɲja
ㅅㅏㅇㄹㅗㄱㅅㅜ	sʰaŋnoksu
ㅅㅏㅁㅇㅝㄹ	sʰamwʌɭ
ㄷㅏㅊㅏ	tat͡ɕʰa
ㅈㅗㅇㅛㅇㅎㅣ	t͡ɕojoŋʝi
ㅈㅓㄱㅂㅏㄴㅎㅏㅈㅏㅇ	t͡ɕʌk̚panɦad͡ʑaŋ
ㅇㅣㄷㅏ	ida
ㄹㅏㄴㅌㅏㄴㅓㅁ	ɾantʰanʌm
ㄱㅗㄹㅡㄷㅏ	koɾɯda
ㅎㅏㄱㅂㅓㄴ	hak̚pʌn
ㅇㅗㄹㅡㄷㅏ	oɾɯda
ㅇㅛㅇㅂㅕㅇ	joŋbjʌŋ
ㅂㅏㄹㅁㅗㄱ	paɭmok̚
ㅅㅓㄴㅓㅅ	sʰʌnʌt̚
ㅉㅏㅇ	t͡ɕaŋ
ㅌㅏㄹ	tʰaɭ
ㅍㅜㅁㅈㅓㄹ	pʰumd͡ʑʌɭ
ㅅㅜㅁㄱㅣㄷㅏ	sʰumɡida
ㄱㅜㄴㄷㅏㄴ	kundan
ㅅㅏㅎㅑㅇㅈㅟ	sʰaʝjaŋd͡ʑɥi
ㄱㅏㅇㅑ	kaja
ㅇㅗㄱㄱㅗ	ok̚ko
ㅅㅓㄴㄱㅓㅌㅗㅇ	sʰʌnɡʌtʰoŋ
ㅇㅔㅌㅣㅋㅔㅅ	etʰikʰet̚
ㅍㅏㅇㅣㄹ	pʰaiɭ
ㅋㅏㄹㅏㅋㅏㄹ	kʰaɾakʰaɭ
ㅂㅓㄷㅡㄹㅂㅜㅇㅇㅓ	pʌdɯɭbuŋʌ
ㅇㅗㄹㅡㄴㅉㅗㄱ	oɾɯɲt͡ɕok̚
ㅅㅏㅊㅓㄹ	sʰat͡ɕʰʌɭ
ㅇㅚㅁㅕㄴㅎㅏㄷㅏ	wemjʌnɦada
ㄱㅏㄹㅏㄱㅈㅓㅁ	kaɾak̚t͡ɕʌm
ㅇㅣㅇㅑㄱㅣㅎㅏㄷㅏ	ijaɡiɦada
ㄸㅓㄷㅡㄹㄷㅏ	tɘdɯɭda
ㅁㅑ	mja
ㅈㅔㅂㅓㅂ	t͡ɕebʌp̚
ㅂㅕㄹㅂㅣㅊ	pjɘɭpit̚
ㅍㅣㅁㅏㅇ	pʰimaŋ
ㅁㅏㄹㄱㅏㅎㄷㅏ	maɭɡatʰa
ㄴㅜㄱㅜ	nuɡu
ㄲㅏㅇㅌㅗㅇ	kaŋtʰoŋ
ㄷㅓㅂㅜㄹㅇㅓ	tʌbuɾʌ
ㅇㅏㅂㅗㅋㅏㄷㅗ	abokʰado
ㅅㅏㅈㅣㄴ	sʰad͡ʑin
ㅂㅏㄴㅅㅏ	pansʰa
ㅁㅗㄱㅜㄱ	moɡuk̚
ㅅㅓㅇㅝㄴ	sʰʌwʌn
ㅎㅘㄹㅈㅏ	ɸwaʎt͡ɕa
ㅁㅏㅇㅜㅅㅡ	mausʰɯ
ㅍㅜㅅ	pʰut̚
ㅈㅔㅁㅕㅇ	t͡ɕemjʌŋ
ㅂㅕㄱ	pjʌk̚
ㄱㅏㅈㅏㅇ	kad͡ʑaŋ
ㅎㅏㅂㅅㅛㅊㅔ	hapɕot͡ɕʰe
ㅂㅗㅇㅅㅏㄱㅣ	poŋsʰaɡi
ㅇㅔㄹㄴㅣㄴㅛ	eʎʎiɲjo
ㄱㅓㄹㅉㅜㄱㅎㅏㄷㅏ	kʌʎt͡ɕukʰada
ㅎㅐㅂㅏㄹ	hɛbaɭ
ㅊㅣㅁㅅㅣㄹ	t͡ɕʰimɕʰiɭ
ㅇㅏㄴㄴㅕㅇㅎㅣ	anɲjʌŋʝi
ㅈㅟ	t͡ɕɥi
ㄷㅔㅇㅣㅌㅓㅂㅔㅇㅣㅅㅡ	teitʰʌbeisʰɯ
ㄱㅛㅌㅗ	kjotʰo
ㄱㅏㄲㅏㅇㅣㅎㅏㄷㅏ	kakaiɦada
ㅅㅓㅇㅎㅏ	sʰɘŋɦa
ㅋㅏㄹㅅㅠㅁ	kʰaɭɕʰum
ㄱㅡㄹㅜㅈㅣㅇㅑㅇㅓ	kɯɾud͡ʑijaʌ
ㅈㅓㅈㅁㅓㄱㅇㅣ	t͡ɕʌnmʌɡi
ㅈㅜㄱㅂㅜㅇㅣㄴ	t͡ɕuk̚puin
ㅍㅔㄹㄹㅏㅌㅣㅇㅗ	pʰeɭɭatʰio
ㅌㅡㄹㅣㅁㅎㅏㄷㅏ	tʰɯɾimɦada
ㅁㅔㅁㅗ	memo
ㅂㅔㅇㅣㄹㅜㅌㅡ	peiɾutʰɯ
ㄱㅜㄱㄱㅕㅇ	kuk̚kjʌŋ
ㅂㅣㄱㅛㅈㅓㄱ	piɡjod͡ʑʌk̚
ㅃㅣㅊㅣㅁ	pit͡ɕʰim
ㅆㅡㄷㅏ	sɯda
ㅇㅛㅅㅗ	josʰo
ㅅㅏㄹㅉㅏㄱ	sʰaʎt͡ɕak̚
ㅇㅗㅈㅣㅇㅇㅓ	od͡ʑiŋʌ
ㅇㅓㅁㅁㅏ	ʌmma
ㅌㅔㄹㄹㅔㅂㅣ	tʰeɭɭebi
ㅋㅡㅅㅔㄴㅗㄴ	kxɯsʰenon
ㅂㅏㅇ	paŋ
ㅊㅗㅇㅠ	t͡ɕʰoju
ㅅㅓㅅ	sʰʌt̚
ㅇㅕㅇㅇㅑㅇ	jʌŋjaŋ
ㅇㅑㅇㅅㅓㄹㅠ	jaŋsʰʌɾju
ㅈㅡㄱ	t͡ɕɯk̚
ㅈㅗㄱㅛ	t͡ɕoɡjo
ㅁㅗㄹㅌㅏㅇㅓ	moɭtʰaʌ
ㅈㅣㅈㅓㅁ	t͡ɕid͡ʑʌm
ㅁㅜㄹㄱㅏ	muɭka
ㅅㅏㅅㅣㅁㅣ	sʰaɕʰimi
ㅂㅜㄹㅓㅇㅜㅁ	puɾʌum
ㅇㅡㅇ	ɯŋ
ㅃㅜㄹㄴㅗㄴㅂㅕㅇㅇㅏㄹㅣ	puɭɭonbjʌŋaɾi
ㅃㅜㅁㄷㅏ	pumta
ㅁㅏㄶㅇㅡㄴ	manɯn
ㅁㅗㄴㅌㅔㅂㅣㄷㅔㅇㅗ	montʰebideo
ㅁㅣㄴㄱㅏㄴ	minɡan
ㅇㅣㄹㄷㅡㅇ	iɭtɯŋ
ㅇㅣㅇㅛㅇ	ijoŋ
ㄷㅏㅅㅣㄴㄹㅗㄴ	taɕʰinnon
ㄱㅣㄲㅓㅇㅣ	kikʌi
ㄱㅓㅁㅅㅏ	kɘmsʰa
ㅇㅕㅇㅁㅛ	jʌŋmjo
ㅍㅏㄹㅏㅁㅏㄹㅣㅂㅗ	pʰaɾamaɾibo
ㅂㅏㄹㄷㅏㄹ	paɭtaɭ
ㅇㅕㅈㅏㅇ	jʌd͡ʑaŋ
ㅅㅣㄴㅂㅜ	ɕʰinbu
ㅂㅜㄹㅇㅘㄴㅈㅓㄴㅎㅏㄷㅏ	puɾwaɲd͡ʑʌnɦada
ㅅㅣㅁㅈㅣ	ɕʰimd͡ʑi
ㄱㅏㅅㅡㄹㅔㅇㅣㄴㅈㅣ	kasʰɯɾeiɲd͡ʑi
ㅂㅏㅇㅣㅌㅡ	paitʰɯ
ㅁㅜㄴㅓㅈㅣㄷㅏ	munʌd͡ʑida
ㄴㅏㅁㄱㅡㄴ	namɡɯn
ㅂㅏㄹㅏㅁ	paɾam
ㄱㅏㅇㅓㅄㅇㅣ	kaʌpɕi
ㄴㅏㄹㅇㅏㅇㅗㄹㅡㄷㅏ	naɾaoɾɯda
ㅁㅗㅅㅡㅂ	mosʰɯp̚
ㄱㅓㅁㄷㅗㄱㅅㅜㄹㅣ	kʌmdoksuɾi
ㅇㅟㄴㄷㅗㅇㅜ	ɥindou
ㅈㅓㄴㅎㅏ	t͡ɕʌnɦa
ㄱㅏㅇㄹㅕㄱ	kaŋɲjʌk̚
ㄱㅡㄹㅓㅁ	kɯɾʌm
ㅌㅗㅇㄱㅏㄹㅣ	tʰoŋɡaɾi
ㅈㅓㅁㅈㅜㄹㅁㅏㅇㄷㅜㄱ	t͡ɕʌmd͡ʑuɭmaŋduk̚
ㅇㅣㄹㅉㅣㄱ	iʎt͡ɕik̚
ㄱㅏㄹㅣㄷㅏ	kaɾida
ㅌㅡㄷㅏ	tʰɯda
ㅊㅜㅈㅣㄴ	t͡ɕʰud͡ʑin
ㄷㅏㅇㅈㅏㅇ	taŋd͡ʑaŋ
ㅍㅗㅍㅡㄹㄹㅓ	pʰopʰɯɭɭʌ
ㄱㅛㅇㅝㄴ	kjowʌn
ㅎㅗㄹㅅㅗㄹㅣㅇㅓㅇㅜㄹㄹㅣㅁ	ɸʷoɭsoɾiʌuʎʎim
ㅊㅏㄱㅅㅓㄱㅎㅏㄷㅏ	t͡ɕʰaksʌkʰada
ㄴㅏㄹㅡㅁ	naɾɯm
ㅎㅏㄱㅅㅓㄹ	haksʌɭ
ㅇㅜㄹㅣ	uɾi
ㅇㅚㅎㅘ	weβwa
ㅂㅗㄹㅁㅗ	poɭmo
ㅎㅐㅇㅂㅗㄱ	hɛŋbok̚
ㄷㅡㅇㄴㅏㅁㅜ	tɯŋnamu
ㅅㅜㅊㅣ	sʰut͡ɕʰi
ㅋㅗㄹㅗㄴㅏㅂㅣㄹㅜㅅㅡ	kʰoɾonabiɾusʰɯ
ㅎㅏㄴㄹㅣㅁㅇㅝㄴ	haʎʎimwʌn
ㅂㅜㄴㅇㅑ	puɲja
ㅁㅑㄴㅁㅏ	mjanma
ㅇㅕㅂㅅㅓ	jʌpsʌ
ㅅㅟㄹㅣ	ʃʰɥiɾi
ㅇㅐㄱㅜㄱㅅㅣㅁ	ɛɡukɕim
ㅁㅣㅇㅠㄱㅣ	mijuɡi
ㅁㅣㅇㅝㅎㅏㄷㅏ	miwʌɦada
ㅋㅏㅁㅍㅏㄹㄹㅏ	kʰampʰaɭɭa
ㅅㅗㅊㅣ	sʰot͡ɕʰi
ㅂㅔㄴㅈㅗㄹ	peɲd͡ʑoɭ
ㅇㅗㄷㅡㅌㅜㅇㅘㄹㄹㅔㅅ	odɯtʰuwaɭɭet̚
ㅂㅏㄹㄱㅏㄹㅏㄱ	paɭkaɾak̚
ㅁㅏㅈㅇㅡㄴㅍㅕㄴ	mad͡ʑɯnpʰjʌn
ㅂㅓㄴ	pʌn
ㅅㅣㄱㅗㄹ	ɕʰiɡoɭ
ㅅㅗㅍㅗ	sʰopʰo
ㅊㅣㄴㅇㅣㄹㅍㅏ	t͡ɕʰiniɭpʰa
ㅂㅏㄹㄱㅏㄴㄷㅚㄷㅏ	paɭɡandweda
ㅂㅜㄹㄱㅏㄹㅣㅇㅏ	puɭɡaɾia
ㅇㅜㅁㅏ	uma
ㅎㅐㅊㅗ	hɛt͡ɕʰo
ㄱㅏㅅㅡㅍㅏㅊㅗ	kasʰɯpʰat͡ɕʰo
ㅁㅏㄹㅡㅅㅡ	maɾɯsʰɯ
ㄴㅗㄲㅡㄴ	nokɯn
ㅂㅜㅇㅓㅋ	puʌk̚
ㅅㅜㅅㅏㅎㅏㄱ	sʰusʰaɦak̚
ㅁㅗㄱㅈㅓㄱㅈㅣ	mok̚t͡ɕʌk̚t͡ɕi
ㅍㅜㅈㅜㅎㅏㄴ	pʰud͡ʑuɦan
ㅇㅓㄱㅇㅜㄹㅎㅏㄷㅏ	ʌɡuɾɦada
ㅈㅓㅅㄱㅏㄹㅏㄱ	t͡ɕʌt̚kaɾak̚
ㅇㅣㅁㅅㅣㄹㄴㅏㅂㅈㅏㄹㅜ	imɕʰiɭɭap̚t͡ɕaɾu
ㅋㅏㄹㅏㅂㅏㄴ	kʰaɾaban
ㄷㅡㄹㅇㅣㄷㅏ	tɯɾida
ㄲㅡㅌ	kɯt̚
ㅇㅕㄹㅓㅂㅜㄴ	jʌɾʌbun
ㄷㅡㅇㅅㅣㄴ	tɯŋɕʰin
ㅇㅓㄹㅂㅓㅁㅜㄹㅣㄷㅏ	ʌɭbʌmuɾida
ㅇㅣㅇㅑㄱㅣㅅㄱㅓㄹㅣ	ijaɡit̚kʌɾi
ㅅㅣㄴㄴㅕㅁ	ɕʰinɲjʌm
ㅈㅜㅊㅏ	t͡ɕut͡ɕʰa
ㅅㅓㄹㅈㅓㅇ	sʰʌʎt͡ɕʌŋ
ㅇㅚㄱㅛ	weɡjo
ㅅㅏㄴㅎㅗㅅㅔ	sʰanβosʰe
ㅈㅡㅇㅇㅣㄴ	t͡ɕɯŋin
ㅎㅚㅎㅘ	ɸweβwa
ㄴㅗㅁ	nom
ㄹㅣㅂㅈㅏ	ɾip̚t͡ɕa
ㅁㅣㅇㅡㅁ	miɯm
ㅎㅏㄴㅇㅕㄹㅡㅁ	hanɲjʌɾɯm
ㄴㅗㅇㅣㄴㅇㅢㅎㅏㄱ	noinɰiɦak̚
ㅁㅗㅈㅏ	mod͡ʑa
ㅅㅓㅋㅡㄹ	sʌkxɯɭ
ㅅㅣㄴㅈㅏ	ɕʰiɲd͡ʑa
ㅁㅓㄹㅁㅣ	mʌɭmi
ㄸㅡㄱㅓㅇㅝㅈㅣㄷㅏ	tɯɡʌwʌd͡ʑida
ㅍㅏㄹㄹㅔㅅㅡㅌㅏㅇㅣㄴ	pʰaɭɭesʰɯtʰain
ㅊㅓㄱㄹㅑㅇ	t͡ɕʰʌŋɲjaŋ
ㄴㅕㅇㅎㅏ	ɲjʌŋɦa
ㅂㅗㄷㅗ	podo
ㅂㅣㄴㅋㅏㄴ	pinkʰan
ㄱㅡㅁㅇㅣㄹ	kɯmiɭ
ㄴㅏㅁㅣㅂㅣㅇㅏ	namibia
ㅂㅏㅇㅣㄹㅓㅅㅡ	paiɾʌsʰɯ
ㄱㅕㅇㅂㅣㅇㅝㄴ	kjɘŋbiwʌn
ㅈㅗㅅㅏㅇ	t͡ɕosʰaŋ
ㅇㅣㅀㅇㅓㅂㅓㄹㅣㄷㅏ	iɾʌbʌɾida
ㅇㅓㅍㅈㅣㄹㅡㄷㅏ	ʌp̚t͡ɕiɾɯda
ㅌㅗㅇㄱㅖㅎㅏㄱ	tʰoŋɡjeɦak̚
ㅂㅏㅇㄱㅡㄹㄹㅏㄷㅔㅅㅣ	paŋɡɯɭɭadeɕʰi
ㅁㅓㄹㅣㄱㅡㄹ	mʌɾiɡɯɭ
ㅇㅛㅇㅇㅢㅈㅏ	joŋɰid͡ʑa
ㄱㅣㅈㅜㅇㄱㅣ	kid͡ʑuŋɡi
ㅈㅓㄴㅓㄹㄹㅣㅅㅡㅌㅡ	t͡ɕʌnʌʎʎisʰɯtʰɯ
ㅅㅗㄱㅅㅔ	sʰokse
ㅁㅕㅇㅇㅢ	mjʌŋɰi
ㄴㅏㄹㄹㅣㄷㅏ	naʎʎida
ㅇㅏㄴㅅㅡㅂ	ansʰɯp̚
ㅂㅕㄴㅂㅕㄴㅎㅏㄷㅏ	pjʌnbjʌnɦada
ㅇㅣㅂㅃㅏㅇㅣ	ip̚pai
ㅇㅓㅇㅕㅅㅎㅏㄷㅏ	ʌjʌtʰada
ㅇㅣㄱㅣㄷㅏ	iɡida
ㄷㅗㄱㅅㅣㄴ	tokɕin
ㅇㅏㄹㅋㅏㄹㄹㅣ	aɭkʰaʎʎi
ㅂㅜㅎㅏ	puɦa
ㅇㅓㅁㅅㅡㅂㅎㅏㄷㅏ	ʌmsʰɯpʰada
ㄱㅣㅇㅓㅂ	kiʌp̚
ㅇㅕㄴㄹㅏㄱ	jʌɭɭak̚
ㅂㅓㄹㄱㅓㅂㅓㅅㄷㅏ	pʌɭɡʌbʌt̚ta
ㄱㅏㅂㅍㅏㄴ	kap̚pʰan
ㅎㅚㄷㅏㅂ	ɸwedap̚
ㄱㅗㅇㄱㅕㄱ	koŋɡjʌk̚
ㄱㅏㄹㄹㅣㅅㅣㅇㅏ	kaʎʎiɕʰia
ㄱㅗㅌㅗㅇㅅㅡㄹㅓㅂㄷㅏ	kotʰoŋsʰɯɾʌp̚ta
ㅊㅣㄹㄹㅔ	t͡ɕʰiɭɭe
ㅌㅣㅂ	tʰip̚
ㄱㅕㅇㅈㅚ	kjʌŋd͡ʑwe
ㅌㅏㅇㅝㄹ	tʰawʌɭ
ㄱㅡㄱㅈㅏㄱㄱㅏ	kɯk̚t͡ɕak̚ka
ㅂㅣㅇㅎㅏ	piŋɦa
ㅋㅏㅇㅖㄴ	kʰajen
ㄱㅣㅇㅓㅂㄱㅏ	kiʌp̚ka
ㅁㅗㄱㄷㅏㄹㅣ	mok̚taɾi
ㅇㅏㅁㅅㅏㄹㅈㅏ	amsʰaʎt͡ɕa
ㅋㅗㄹㅎㅗㅅㅡ	kʰoɾβosʰɯ
ㅊㅜㄱㅜ	t͡ɕʰuɡu
ㄱㅏㄴㅊㅜㄹㅣㄷㅏ	kaɲt͡ɕʰuɾida
ㅅㅡㅁㅗ	sɯmo
ㅈㅔㅇㅣㄹ	t͡ɕeiɭ
ㅂㅜㅈㅓㅇㅈㅓㄱㅂㅜㄴ	pud͡ʑʌŋd͡ʑʌk̚pun
ㅅㅓㄹㅍㅡㅎㅣㄷㅡㄹㅣㄹㄱㅣ	sʰʌɭpʰɯʝidɯɾiɭɡi
ㄱㅏㄹㅏㅁ	kaɾam
ㄴㅏㅍㅡㅌㅏㄹㄹㅔㄴ	napʰɯtʰaɭɭen
ㄱㅗㅈㅣㅂㅂㅜㄹㅌㅗㅇ	kod͡ʑip̚puɭtʰoŋ
ㅇㅡㄹㄲㅏ	ɯɭka
ㄹㅣㅌㅜㅇㅏㄴㅣㅇㅏ	ɾitʰuania
ㅂㅏㄹㅡㄷㅏ	paɾɯda
ㄷㅗㄹㅁㅏㅈㅏ	toɭmad͡ʑa
ㄱㅣㄱㅘㄴㅊㅗㅇ	kiɡwaɲt͡ɕʰoŋ
ㅇㅏㄱㅣ	aɡi
ㅍㅏㅁㅇㅠ	pʰamju
ㅌㅗㄹㅗㄴ	tʰoɾon
ㄱㅗㄱㅜㄹㅕ	koɡuɾjʌ
ㅈㅔㅇㅠ	t͡ɕeju
ㅂㅜㅊㅣㄷㅏ	put͡ɕʰida
ㄴㅏㄹㅁㅏㄷㅏ	naɭmada
ㅈㅣㄹㅡㅁㄱㅣㄹ	t͡ɕiɾɯmɡiɭ
ㅁㅣㄴㅏㄹㅣ	minaɾi
ㅅㅡㅋㅏㅍㅡ	sʰɯkʰapʰɯ
ㅁㅣㅇㅛㅇㅅㅏ	mijoŋsʰa
ㄱㅜㄺㄷㅏㄹㅏㅎㄷㅏ	kuk̚taɾatʰa
ㅆㅏㅇㅂㅣㅇㅡㅂ	saŋbiɯp̚
ㅎㅘㅇㅡㅁ	ɸwaɯm
ㅁㅜㄹㅇㅔㄴㅔㄹㅡㄱㅣ	muɾeneɾɯɡi
ㅁㅐㅈㅓㅁ	mɛd͡ʑʌm
ㅇㅏㄹㄹㅣㄷㅏ	aʎʎida
ㄱㅗㅇㄱㅗㅇ	koŋɡoŋ
ㅅㅗㄴㅌㅗㅂ	sʰontʰop̚
ㅎㅜㄴㄷㅗㄱ	ɸʷundok̚
ㄸㅏㅈㅣㄷㅏ	tad͡ʑida
ㅎㅡㅇㅁㅣ	xɯŋmi
ㅁㅜㄴㅅㅓ	munsʰʌ
ㄴㅏㅂㅈㅣㄹㅣ	nap̚t͡ɕiɾi
ㅈㅜㅇㅅㅓㅇ	t͡ɕuŋsʰʌŋ
ㅇㅣㄴㅌㅔㄹㄹㅣㄱㅔㄴㅊㅣㅇㅏ	intʰeʎʎiɡeɲt͡ɕʰia
ㄱㅏㄹㄷㅏ	kaɭda
ㅇㅗㅅㅏㄲㅏ	osʰaka
ㅂㅜㄱㅂㅏㄴㄱㅜ	puk̚panɡu
ㅇㅣㅃㅡㄷㅏ	ipɯda
ㅅㅜㄷㅗㅅㅏ	sʰudosʰa
ㅇㅠㅁㅣㄴ	jumin
ㅇㅐㅆㅡㄷㅏ	ɛsɯda
ㅁㅣㅇㅏㄴㅎㅏㄷㅏ	mianɦada
ㅇㅗㄷㅏ	oda
ㅌㅡㄹㅔㅇㅣㄴㅓ	tʰɯɾeinʌ
ㄹㅜㅂㅣㄷㅠㅁ	ɾubidjum
ㅊㅣㅎㅏㄴ	t͡ɕʰiɦan
ㅅㅣㄴㅎㅏㄱ	ɕʰinɦak̚
ㄱㅏㄹㅣㅂㅣ	kaɾibi
ㄷㅗㄱㄹㅣㅂ	toŋnip̚
ㄱㅟㅅㅂㅜㄹ	kɥit̚puɭ
ㄱㅏㅇㅕㅄㄷㅏ	kajʌp̚ta
ㅁㅗㄹㅋㅏ	moɭkʰa
ㅈㅏㄱㅜㅇ	t͡ɕaɡuŋ
ㅁㅣㄴㄷㅡㄹㄹㅔ	mindɯɭɭe
ㄱㅡㅂㅜㄴ	kɯbun
ㄱㅏㄴㅅㅓㅂ	kansʰʌp̚
ㄴㅠㄱ	ɲjuk̚
ㄱㅐㅈㅣㄹㅏㄹ	kɛd͡ʑiɾaɭ
ㅂㅏㄼㄷㅏ	pap̚ta
ㄱㅏㅂㅕㅂㄷㅏ	kabjʌp̚ta
ㅇㅛㄱ	jok̚
ㄷㅡㅇㅅㅏㄴ	tɯŋsʰan
ㅇㅗㄴㄷㅗ	ondo
ㅎㅘㅇㅇㅗㄱ	ɸwaŋok̚
ㅅㅜㄴㄱㅕㄹ	sʰunɡjʌɭ
ㅍㅕㅇㅁㅕㄴ	pʰjʌŋmjʌn
ㄴㅏㅁㄴㅕ	namɲjʌ
ㅂㅗㄱㅡㅂ	poɡɯp̚
ㅍㅏㅇㅜㄴㄷㅔㅇㅣㅅㅕㄴ	pʰaundeiɕʰʌn
ㅂㅔㄴㅜㅅㅡ	penusʰɯ
ㅈㅏㅂㅎㅣㄷㅏ	t͡ɕapʰida
ㄱㅜㅂㅕㄹㄷㅚㄷㅏ	kubjʌɭdweda
ㅂㅜㄷㅗㅇㅅㅏㄴ	pudoŋsʰan
ㅉㅣㄹㄹㅣㄷㅏ	t͡ɕiʎʎida
ㅇㅣㄱㅣㅈㅓㄱ	iɡid͡ʑʌk̚
ㄹㅠㄱㅅㅣㅂ	ɾjukɕip̚
ㅁㅔㄴㄷㅔㄹㄹㅔㅂㅠㅁ	mendeɭɭebjum
ㄹㅔㅇㅣㅅㅡ	ɾeisʰɯ
ㄴㅗㅇㄴㅗ	noŋno
ㅇㅕㄴㅂㅕㄴ	jʌnbjʌn
ㅍㅕㅁ	pʰjʌm
ㅈㅏㅇㅁㅗ	t͡ɕaŋmo
ㅇㅠㅇㅔㄴ	juen
ㅁㅣㄴㅈㅜ	miɲd͡ʑu
ㅊㅣㄹㅎㅏㄷㅏ	t͡ɕʰiɾɦada
ㅅㅗㅇㅠㅎㅏㄷㅏ	sʰojuɦada
ㅁㅓㅅㅇㅣㅆㄷㅏ	mʌɕʰit̚ta
ㅇㅚㅌㅜ	wetʰu
ㅇㅣㅁㅕ	imjʌ
ㄷㅗㅇㅁㅕㅇㅅㅏ	toŋmjʌŋsʰa
ㅅㅗㄴㅕㄴ	sʰoɲjʌn
ㅂㅓㅂㅈㅓㅇ	pʌp̚t͡ɕʌŋ
ㅅㅓㄴㄱㅛ	sʰʌnɡjo
ㅂㅣㅆㅏㄷㅏ	pisada
ㄴㅏㅁㅇㅏㅍㅡㄹㅣㅋㅏㄱㅗㅇㅎㅘㄱㅜㄱ	namapʰɯɾikʰaɡoŋβwaɡuk̚
ㅍㅏㄹㄷㅏ	pʰaɭda
ㅃㅜㄹㅣㅎㅗㄱ	puɾiβok̚
ㅇㅏㄹㅡㅁㅔㄴㅣㅇㅏㅇㅓ	aɾɯmeniaʌ
ㅅㅏㄱㅘ	sʰaɡwa
ㅈㅗㄴㅁㅏㅅ	t͡ɕonmat̚
ㅁㅜㄴㅢ	muni
ㄴㅜㅅㅓㄹ	nusʰʌɭ
ㅂㅜㄹㅁㅏㄴㅈㅗㄱ	puɭmaɲd͡ʑok̚
ㄷㅡㄹㅓㅇㅎㅓㄹㅣ	tɯɾʌŋɦʌɾi
ㅁㅏㅅ	mat̚
ㅇㅕㅇㅇㅓㅂ	jʌŋʌp̚
ㅍㅕㅇㄱㅏㅎㅏㄷㅏ	pʰjɘŋkaɦada
ㅈㅣㄴㅅㅣㅁ	t͡ɕinɕʰim
ㅈㅗㄹㅇㅓㅂㅅㅣㄱ	t͡ɕoɾʌpɕik̚
ㅁㅕㅇㄱㅗㄱ	mjʌŋɡok̚
ㄱㅜㅂㅇㅣㄱㅜㅂㅇㅣ	kubiɡubi
ㅇㅏㄴㄷㅡㄹㅗㅇㅣㄷㅡ	andɯɾoidɯ
ㄷㅏㅇㅟㅅ	taɥit̚
ㅇㅣㄹㅇㅓㅅㅓㄷㅏ	iɾʌsʰʌda
ㅇㅕㄴㄱㅏ	jɘnɡa
ㅈㅜㅇㄱㅕㅇ	t͡ɕuŋɡjʌŋ
ㅅㅏㅇㅝㄴ	sʰawʌn
ㅊㅗㅎㅗ	t͡ɕʰoβo
ㅂㅜㄱㄱㅕㅇ	puk̚kjʌŋ
ㅈㅏㄹㅏㅇㅅㅡㄹㅓㅂㄷㅏ	t͡ɕaɾaŋsʰɯɾʌp̚ta
ㅂㅓㅈ	pʌt̚
ㅇㅣㄴㄱㅏㄴ	inɡan
ㅌㅓㄹㅂㅏㄹㅁㅏㄹㄸㅗㅇㄱㅏㄹㅣ	tʰʌɭbaɭmaɭtoŋɡaɾi
ㅅㅓㄴㅅㅜㄹㅈㅣㅂ	sʰʌnsʰuʎd͡ʑip̚
ㅈㅣㅅㅣㅂㅗㅇ	t͡ɕiɕʰiboŋ
ㄱㅣㄴㅕㅁㅇㅣㄹ	kiɲjʌmiɭ
ㄷㅗㅂㅏㄱ	tobak̚
ㅇㅜㄹㅇㅡㅁㅅㅗㄹㅣ	uɾɯmsoɾi
ㅇㅕㅇㅘㅇ	jʌwaŋ
ㅂㅗㅇㅗㄴㅂㅕㅇ	poonbjʌŋ
ㅇㅏㅈㅏ	ad͡ʑa
ㅎㅗㅎㅡㅂㅎㅏㄷㅏ	ɸʷoɣɯpʰada
ㅁㅜㅇㅣㄱㅎㅏㄷㅏ	muikʰada
ㅂㅓㅁㅏ	pʌma
ㅂㅣㄴㅏㄴ	pinan
ㅇㅕㅍㅇㅓㄹㄱㅜㄹ	jʌbʌɭɡuɭ
ㅈㅓㅇㅊㅣㅎㅏㄱ	t͡ɕʌŋt͡ɕʰiɦak̚
ㅍㅏㄴ	pʰan
ㅌㅏㄱㅊㅣ	tʰak̚t͡ɕʰi
ㄷㅡㅇㄹㅗㅇ	tɯŋnoŋ
ㄱㅟㅃㅜㄹㄴㅗㄴㅂㅕㅇㅇㅏㄹㅣ	kɥipuɭɭonbjʌŋaɾi
ㅎㅏㄷㅡㅇㅞㅇㅓ	hadɯweʌ
ㅊㅏㅊㅡㅁ	t͡ɕʰat͡ɕʰɯm
ㄱㅕㄹㅈㅓㅁ	kjʌʎt͡ɕʌm
ㅁㅗㄹㅗㄴㅣ	moɾoni
ㅍㅣㅎㅏㄷㅏ	pʰiɦada
ㅅㅣㄴㅇㅏㅇ	ɕʰinaŋ
ㄱㅏㄱㅗㅇㅍㅜㅁ	kaɡoŋpʰum
ㅊㅜㄹㄱㅡㄴ	t͡ɕʰuɭɡɯn
ㅅㅏㅈㅣㄱ	sʰad͡ʑik̚
ㄱㅖㅅㅜ	kjesʰu
ㄷㅏㄴㅅㅜ	tansʰu
ㄴㅏㅁㅓㅈㅣ	namʌd͡ʑi
ㅇㅜㅇㅏㅎㅏㄷㅏ	uaɦada
ㅊㅏㅇㅣ	t͡ɕʰai
ㅇㅏㅅㅡㅎㅏㅂㅏㅌㅡ	asʰɯɦabatʰɯ
ㅌㅡㄹㅗㅇㅍㅡㄹㅚㅇㅠ	tʰɯɾoŋpʰɯɾweju
ㅅㅗㅇㅝㄴ	sʰowʌn
ㄱㅡㅌㅗㄹㅗㄱ	kɯtʰoɾok̚
ㅎㅏㄴㄷㅜㄹ	handuɭ
ㅇㅖㅊㅟㄱㅣ	jet͡ɕʰɥiɡi
ㄱㅠㄹㅠㄹ	kjuɾjuɭ
ㄷㅏㅁㄷㅏ	tamta
ㄷㅣㅅㅡㅋㅔㅅ	tisʰɯkʰet̚
ㅂㅣㅇㅠ	piju
ㅂㅏㄱㅈㅟ	pak̚t͡ɕɥi
ㄹㅜㅅㅣㅍㅓ	ɾuɕʰipʰʌ
ㅊㅟㄹㅣㅎㅣ	t͡ɕʰɥiɾiʝi
ㅅㅜㄴㅊㅓㄴ	sʰuɲt͡ɕʰʌn
ㅁㅜㄹㄹㅣㅊㅣㄷㅏ	muʎʎit͡ɕʰida
ㅈㅓㅁㄱㅓㅁ	t͡ɕʌmɡʌm
ㅁㅜㄹㄷㅜㄲㅓㅂㅣ	muɭdukʌbi
ㅁㅐㅊㅜㄴㅂㅜ	mɛt͡ɕʰunbu
ㅋㅏㄷㅡㅁㅠㅁ	kʰadɯmjum
ㅎㅗㅇㅇㅕㄱ	ɸʷoŋjʌk̚
ㅂㅔㄷㅏ	peda
ㅅㅓㅁㅕㅇㅎㅏㄷㅏ	sʰɘmjʌŋɦada
ㄱㅖㅊㅡㅇ	kjet͡ɕʰɯŋ
ㅇㅕㅇㅎㅑㅇ	jɘŋʝjaŋ
ㅂㅗㄱㅗ	poɡo
ㅊㅔㅈㅜㅇ	t͡ɕʰed͡ʑuŋ
ㄸㅏㄱ	tak̚
ㅂㅔㄷㅏㄹ	pedaɭ
ㅅㅣㅂㅍㅏㄹ	ɕʰip̚pʰaɭ
ㅈㅓㄱㄷㅏㅇㅎㅣ	t͡ɕʌk̚taŋʝi
ㅂㅜㄹㅊㅓㄹㅈㅜㅇㅑ	puʎt͡ɕʰʌʎd͡ʑuja
ㅁㅣㄴㅏㅁ	minam
ㅅㅜㄱㅇㅓ	sʰuɡʌ
ㅁㅔㄷㅏㄹ	medaɭ
ㅅㅣㄹㅕㄱ	ɕʰiɾjʌk̚
ㄴㅏㄴㄹㅗ	naɭɭo
ㅂㅣㄸㅜㄹㄷㅏ	pituɭda
ㅅㅗㄱㅎㅏㄷㅏ	sʰokʰada
ㅅㅡㅊㅣㄷㅏ	sʰɯt͡ɕʰida
ㅈㅏㄱㅅㅓㅇ	t͡ɕaksʌŋ
ㅈㅣㅊㅣㄷㅏ	t͡ɕit͡ɕʰida
ㄱㅏㅅㅡ	kasʰɯ
ㄱㅘㅁㅜㄹ	kwamuɭ
ㄱㅖㄹㅏㄴ	kjeɾan
ㅈㅓㅇㄷㅏㅂ	t͡ɕɘŋdap̚
ㄹㅕㄴㅂㅏㅇ	ɾjʌnbaŋ
ㅎㅜㄱㅏㄱ	ɸʷuɡak̚
ㅈㅏㅇ	t͡ɕaŋ
ㄷㅗㅇㅍㅗ	toŋpʰo
ㅇㅣㅅㅡㅇ	isʰɯŋ
ㅁㅣㄴㅁㅜㄹㄱㅏㅁㅏㅇㅜㅈㅣ	minmuɭɡamaud͡ʑi
ㅈㅚㅇㅣㄴ	t͡ɕwein
ㄱㅜㅅㅣㄱ	kuɕʰik̚
ㄷㅡㅇㅂㅏㄷㅇㅣ	tɯŋbadi
ㄱㅡㅁㅎㅏㄷㅏ	kɯmɦada
ㅍㅏㄱㅚㄷㅚㄷㅏ	pʰaɡwedweda
ㅈㅜㅂㅏㅇ	t͡ɕubaŋ
ㅅㅜㅅㅣㄱㅇㅓ	sʰuɕʰiɡʌ
ㅇㅏㅁㅏㅊㅜㅇㅓ	amat͡ɕʰuʌ
ㅊㅜㄱㅅㅏ	t͡ɕʰuksa
ㅅㅡㅇㅇㅛㅇㅊㅏ	sʰɯŋjoŋt͡ɕʰa
ㅈㅜㅇㄷㅗ	t͡ɕuŋdo
ㅎㅘㄹㅇㅛㅇㅎㅏㄷㅏ	ɸwaɾjoŋɦada
ㄷㅏㅇㅣㅇㅓㅌㅡ	taiʌtʰɯ
ㅌㅏㅈㅏㄱㅣ	tʰad͡ʑaɡi
ㅈㅣㄱㅕㅂㄷㅏ	t͡ɕiɡjʌp̚ta
ㅌㅜㄴㄷㅡㄹㅏ	tʰundɯɾa
ㅌㅏㅇㅣㅇㅘㄴ	tʰaiwan
ㅎㅜㄷㅜ	ɸʷudu
ㅇㅕㅇㅜㄹ	jʌuɭ
ㄷㅏㅂ	tap̚
ㅂㅜㅈㅓㅇ	pud͡ʑʌŋ
ㄱㅗㅈㅏㅇ	kod͡ʑaŋ
ㅇㅕㄱㅣ	jʌɡi
ㄴㅡㄲㅣㅁㅍㅛ	nɯkimpʰjo
ㅇㅢㅇㅣㄴㅎㅘ	ɰiinβwa
ㅂㅏㄺㅇㅡㄹㄴㅕㅋ	paɭɡɯʎʎjʌk̚
ㅎㅘㄴㅁㅕㄹ	ɸwanmjʌɭ
ㅂㅏㄹㅈㅓㅇ	paʎt͡ɕʌŋ
ㅁㅗㅇㄸㅏㅈㅠ	moŋtad͡ʑu
ㅂㅏㅅㅡㅅㅡㅋㅏㅍㅡ	pasʰɯsʰɯkʰapʰɯ
ㄷㅏㄹㄹㅣㄷㅏ	taʎʎida
ㄱㅜㄱㅡㄹ	kuɡɯɭ
ㅋㅡㄹㅔㅇㅛㅇ	kxɯɾejoŋ
ㅁㅜㅇㅛㅇ	mujoŋ
ㅁㅜㄹㄹㅓㅅㅓㄷㅏ	muɭɭʌsʰʌda
ㅎㅏㅂㄱㅣㄷㅗ	hap̚kido
ㅂㅜㄹㄷㅏ	puɭda
ㅌㅗㄹㅗㄴㅌㅗ	tʰoɾontʰo
ㅇㅛㅁㅏㅇ	jomaŋ
ㅂㅜㅈㅓㄴㄹㅕㅇ	pud͡ʑʌʎʎjʌŋ
ㄱㅡㄹㅕㅈㅣㄷㅏ	kɯɾjʌd͡ʑida
ㅇㅏㅁㅌㅏㄺ	amtʰak̚
ㅇㅑㄱ	jak̚
ㄱㅡㄴㅂㅗㄴㅈㅓㄱ	kɯnboɲd͡ʑʌk̚
ㄱㅕㅂㄷㅏ	kjɘp̚ta
ㅈㅏㄹㅁㅗㅅ	t͡ɕaɭmot̚
ㅍㅣㄹㅇㅛ	pʰiɾjo
ㅇㅕㄴㄱㅜㅅㅣㄹ	jʌnɡuɕʰiɭ
ㅇㅠㅎㅗㄱ	juβok̚
ㄴㅡㅇㄹㅠㄹ	nɯŋɲjuɭ
ㅅㅓㄴㅂㅏㄴ	sʰʌnban
ㄴㅏㄱ	nak̚
ㅎㅜㅂㅏㄴ	ɸʷuban
ㄱㅕㅇㅊㅏㄹㄱㅕㄴ	kjɘŋt͡ɕʰaɭɡjʌn
ㅂㅣ	pi
ㄱㅡㄴㄹㅗ	kɯɭɭo
ㅁㅜㅇㅛㅇ	mujoŋ
ㅁㅗㅌㅗ	motʰo
ㅂㅏㄴㅉㅏㄱ	paɲt͡ɕak̚
ㄹㅣㅅㅔㅂㅅㅕㄴ	ɾisepɕʌn
ㅂㅗㅇㅈㅣ	poŋd͡ʑi
ㅍㅣㄱㅗㄴㅎㅏㄷㅏ	pʰiɡonɦada
ㅎㅏㄱㅣㄴ	haɡin
ㄱㅗㄹㅁㅜ	koɭmu
ㄷㅐㅎㅏㅂㅅㅣㄹ	tɛɦapɕiɭ
ㅁㅔㅅㅂㅏㄱㅈㅟ	met̚pak̚t͡ɕɥi
ㅂㅜ	pu
ㅇㅘㄱㅉㅣㄴ	wak̚t͡ɕin
ㅇㅏㄹㅕㄴ	aɾjʌn
ㅎㅜㄷㅡ	ɸʷudɯ
ㅊㅜㄱㅇㅣㄹ	t͡ɕʰuɡiɭ
ㅇㅔㅅㅡㅊㅔㅌㅡ	esʰɯt͡ɕʰetʰɯ
ㅍㅕㄴㅇㅏㅁ	pʰjʌnam
ㅂㅕㄹㅍㅛ	pjɘɭpʰjo
ㄱㅡㄹㅔㅇㅣㅍㅡㅍㅡㄹㅜㅌㅡ	kɯɾeipʰɯpʰɯɾutʰɯ
ㅅㅓㅈㅣㄴ	sʰʌd͡ʑin
ㄱㅏㄹㅁㅜㄴㅁㅏㅇㄷㅜㄱ	kaɭmunmaŋduk̚
ㅊㅣㅇㅏ	t͡ɕʰia
ㅈㅏㄴㅌㅔㄴ	t͡ɕantʰen
ㅂㅏㄴㅈㅜㄹ	paɲd͡ʑuɭ
ㅋㅔㅍㅣㄹㅡ	kʰepʰiɾɯ
ㅂㅓㅅㄱㅣㄷㅏ	pʌt̚kida
ㄱㅛㅅㅜ	kjosʰu
ㅁㅓㅅ	mʌt̚
ㄱㅗㅇㅎㅘㄱㅜㄱ	koŋβwaɡuk̚
ㅇㅜㅇㅜㄹ	uuɭ
ㅈㅣㅂㅎㅚ	t͡ɕipʰwe
ㄱㅏㄴㄱㅗㄱㅎㅏㄷㅏ	kanɡokʰada
ㅅㅏㅇㄱㅕㄴㄹㅖ	sʰaŋɡjʌʎʎje
ㄴㅏㅇㅣㅇㅗㅂㅠㅁ	naiobjum
ㅅㅗㄴㅈㅓㄴㅎㅘ	sʰoɲd͡ʑʌnβwa
ㄱㅠㅇㅠㄹ	kjujuɭ
ㄹㅜㄱ	ɾuk̚
ㅅㅏㄹㅣ	sʰaɾi
ㅈㅣㅇㅕㄱㅅㅏㅎㅚ	t͡ɕijʌksaβwe
ㄷㅏㄹㅏㄱㅂㅏㅇ	taɾak̚paŋ
ㅍㅡㄹㅏㅇ	pʰɯɾaŋ
ㅂㅜㄹㅊㅣㄷㅏ	puʎt͡ɕʰida
ㄹㅏㅂㅂㅣ	ɾap̚pi
ㄱㅗㅈㅏㄱ	kod͡ʑak̚
ㄷㅗㅅㅣ	toɕʰi
ㅇㅠㅇㅢㅇㅓ	juɰiʌ
ㅅㅣㅍㄷㅏ	ɕʰip̚ta
ㅈㅣㅈㅣㄴㅎㅏㄱ	t͡ɕid͡ʑinɦak̚
ㅂㅣㅍㅕㅇ	pipʰjʌŋ
ㄴㅐㅂㅜ	nɛbu
ㅂㅜㄹㅡㅂㄸㅡㄷㅏ	puɾɯp̚tɯda
ㅂㅜㄹㅈㅏㅇㄴㅏㄴ	puʎd͡ʑaŋnan
ㅍㅗㄹㅡㅌㅜㄱㅏㄹㅇㅓ	pʰoɾɯtʰuɡaɾʌ
ㅊㅣㅁㅕㅇㅈㅓㄱ	t͡ɕʰimjʌŋd͡ʑʌk̚
ㅃㅏㅇㅣㅃㅏㅇㅣ	paipai
ㅍㅟㄶ	pʰɥin
ㅇㅑㅇㅈㅡ	jaŋd͡ʑɯ
ㄱㅣㄴㅣㅍㅣㄱㅡ	kinipʰiɡɯ
ㅇㅣㅂㄹㅕㄱ	imɲjʌk̚
ㅁㅜㄹㅡㅍ	muɾɯp̚
ㅅㅡㅌㅏㅇㅣㄹ	sʰɯtʰaiɭ
ㅈㅗㅅㅓㄴㄱㅡㄹ	t͡ɕosʰʌnɡɯɭ
ㅅㅑㅌㅏ	ɕʰatʰa
ㅈㅓㄴㅅㅏ	t͡ɕɘnsʰa
ㄱㅣㄹㅗㄱㅎㅏㄷㅏ	kiɾokʰada
ㅋㅚㄹㄹㅡㄴ	kʰweɭɭɯn
ㄱㅓㄹㅊㅣㄷㅏ	kɘʎt͡ɕʰida
ㄴㅏㅌㄴㅏㅌㅇㅣ	nannat͡ɕʰi
ㅇㅑㄱㅏㄴ	jaɡan
ㅂㅡㄹㅣㅍㅣㅇ	pɯɾipʰiŋ
ㅆㅏㅇㅣㄴㅍㅔㄴ	sainpʰen
ㄱㅏㅁㅂㅏㅇ	kambaŋ
ㅎㅘㅍㅖㅎㅏㄱ	ɸwapʰjeɦak̚
ㅇㅝㄴ	wʌn
ㅍㅗㄱㅕㅇ	pʰoɡjʌŋ
ㄷㅐㅌㅗㅇㄹㅕㅇ	tɛtʰoŋɲjʌŋ
ㅇㅓㄷ	ʌt̚
ㅈㅏㅇㄱㅜㄴㅅㅓㄱ	t͡ɕaŋɡunsʰʌk̚
ㅇㅗㅅㅗㄹㅣ	osʰoɾi
ㄱㅏㄱㅅㅓㄴㅁㅣ	kaksʌnmi
ㅂㅜㅅㅜㄷㅏ	pusʰuda
ㅍㅗㄹㅡㅍㅣㄴ	pʰoɾɯpʰin
ㅊㅜㄱㅈㅔㅇㅣㄹ	t͡ɕʰuk̚t͡ɕeiɭ
ㅎㅏㅂㄱㅕㄱ	hap̚kjʌk̚
ㅂㅔㅌㅔㄹㅏㅇ	petʰeɾaŋ
ㅌㅟㄱㅣㅁ	tʰɥiɡim
ㅅㅓㅉㅗㄱ	sʰʌt͡ɕok̚
ㅅㅜㄴㄷㅜㅂㅜ	sʰundubu
ㄴㅗㅇㅝㅅㅡㅌㅣ	nowʌsʰɯtʰi
ㄱㅣㅇㅜㄹㄷㅏ	kiuɭda
ㅇㅣㅂㅎㅑㅇㅅㅜㄴㅅㅗㄱ	ipʰjaŋsʰunsʰok̚
ㅇㅡㅁㄹㅕㄱ	ɯmɲjʌk̚
ㅇㅏㄹㅚㄷㅏ	aɾweda
ㅂㅗㄷㅡㅋㅏ	podɯkʰa
ㅎㅐㅎㅕㅂ	hɛʝjʌp̚
ㅇㅣㄹㅓㅎㅏㄷㅏ	iɾʌɦada
ㅈㅗㅎㅏㅂ	t͡ɕoɦap̚
ㅂㅏㅇㄱㅜ	paŋɡu
ㅅㅜㅇㄱㅗ	sʰuŋɡo
ㄱㅣㅎㅏㄴ	kiɦan
ㅂㅣㄷㅏㄴㅌㅓㄹㄷㅡㄹㅈㅟ	pidantʰʌɭdɯʎd͡ʑɥi
ㄱㅡㅂㅅㅡㅂ	kɯpsɯp̚
ㄴㅓㄹㄹㅣ	nʌʎʎi
ㄷㅜㅁㅏㄴㄱㅏㅅㅣㄱㅗㄱㅣ	tumanɡaɕʰiɡoɡi
ㅈㅣㄹㅚ	t͡ɕiɾwe
ㄷㅡㄱㄴㅏㅁ	tɯŋnam
ㄱㅏㅂㅓㄹ	kabʌɭ
ㅅㅏㅇㅕㄱㅇㅝㄴ	sʰajʌɡwʌn
ㄱㅜㄱㅌㅗ	kuk̚tʰo
ㅈㅗㅈㅣㄱ	t͡ɕod͡ʑik̚
ㅇㅕㄴㅅㅏㅇ	jʌnsʰaŋ
ㅇㅣㅆㅇㅓ	isʌ
ㅁㅏㅍㅏㄷㅜㅂㅜ	mapʰadubu
ㄱㅏㅂㅗㄹㅗㄴㅔ	kaboɾone
ㄲㅗㅁㅊㅣ	komt͡ɕʰi
ㄱㅣㅍㅇㅣ	kipʰi
ㅁㅜㅅㅜ	musʰu
ㄲㅏㅈㅏ	kad͡ʑa
ㅈㅓㅇㅇㅝㄹ	t͡ɕʌŋwʌɭ
ㅎㅜㄴㅏㄴ	ɸʷunan
ㄷㅜㅅㅏㅇ	tusʰaŋ
ㅂㅕㅇㅅㅣㄴ	pjʌŋɕʰin
ㄲㅡㄴㅈㅓㄱㄲㅡㄴㅈㅓㄱㅎㅏㄷㅏ	kɯɲd͡ʑʌk̚kɯɲd͡ʑʌkʰada
ㄱㅏㅇㅅㅜ	kaŋsʰu
ㄱㅜㄻㄷㅏ	kumta
ㅈㅜㅇㅅㅗㄱㅣㅇㅓㅂ	t͡ɕuŋsʰoɡiʌp̚
ㄱㅓㄹㅈㅏㄱ	kʌʎt͡ɕak̚
ㅂㅜㄱㅂㅏㅇㅌㅗㄲㅣ	puk̚paŋtʰoki
ㅈㅓㅇㄹㅣ	t͡ɕʌŋni
ㅅㅠㅍㅓ	ɕʰupʰʌ
ㅎㅓㅎㅗㄴ	hʌβon
ㅇㅕㄷㅏㄴ	jɘdan
ㅈㅜㅇㄱㅗㄱㅣ	t͡ɕuŋɡoɡi
ㄱㅣㅊㅣㅁ	kit͡ɕʰim
ㄱㅏㅈㅕㅇㅗㄷㅏ	kad͡ʑʌoda
ㅊㅏㄴㅈㅏㅇ	t͡ɕʰaɲd͡ʑaŋ
ㅈㅓㅇㅇㅗ	t͡ɕɘŋo
ㅇㅏㅁㅗㄴㄷㅡ	amondɯ
ㅈㅗㅇㅍㅏ	t͡ɕoŋpʰa
ㅇㅠㅈㅓㄴㅈㅏ	jud͡ʑʌɲd͡ʑa
ㅇㅓㅎㅟ	ɘɦɥi
ㅂㅣㄷㅔㅇㅗㅍㅣㄹㄹㅣㅁ	pideopʰiʎʎim
ㄴㅡㄴㅑ	nɯɲja
ㅇㅏㅁㅔㄴ	amen
ㅅㅓㄱㅇㅢ	sʰʌɡɰi
ㅇㅣㄹㅏㅋㅡㅇㅓ	iɾakxɯʌ
ㅁㅕㅇㅇㅣㄹ	mjʌŋiɭ
ㄱㅔㅆ	ket̚
ㅂㅡㄹㅠㅆㅔㄹ	pɯɾjuseɭ
ㄱㅕㄹㅅㅣㅁ	kjʌɭɕim
ㅍㅜㄹㅁㅏㅇㄷㅜㄱ	pʰuɭmaŋduk̚
ㅇㅏㅁㅏ	ama
ㄱㅗㅂㅅㅏ	kopsa
ㅁㅏㅈㅂㅜㄷㅣㅈㅊㅣㄷㅏ	mat̚pudit̚t͡ɕʰida
ㅇㅣㅁㅈㅏ	imd͡ʑa
ㄱㅕㅁㅅㅗㄴ	kjʌmsʰon
ㅂㅏㅈㅣㄹㅏㄱ	pad͡ʑiɾak̚
ㅇㅙㄱㅏㄹㅣ	wɛɡaɾi
ㅇㅣㅈㅣㄹ	id͡ʑiɭ
ㅎㅓㅅㄱㅏㄴ	hʌt̚kan
ㅋㅓㅁㅠㄴㅣㅋㅔㅇㅣㅅㅕㄴ	kʰʌmjunikʰeiɕʰʌn
ㅁㅗㄱㅊㅏ	mok̚t͡ɕʰa
ㅅㅓㄱㄹㅏㅂ	sʰʌŋnap̚
ㄱㅜㅅㅓㄱ	kusʰʌk̚
ㅇㅣㅁㅔㅇㅣㄹ	imeiɭ
ㅇㅑㄱㅅㅣㄱ	jakɕik̚
ㅇㅗㄴㅅㅜ	onsʰu
ㅋㅏㅂㅏㅈㅗㄹ	kʰabad͡ʑoɭ
ㅅㅣㄹㅎㅕㄴㅎㅏㄷㅏ	ɕʰiɾʝjʌnɦada
ㄱㅓㄷㅡㅂ	kʌdɯp̚
ㅆㅏㅇㅜㄷㅏ	sauda
ㅁㅕㄴㅅㅏ	mjʌnsʰa
ㅂㅏㄹㅏㅁㅈㅣㄱㅎㅏㄷㅏ	paɾamd͡ʑikʰada
ㅁㅗㄱㅇㅛㄱㅅㅣㄹ	moɡjokɕiɭ
ㅇㅕㅇㅅㅓㅇ	jʌŋsʰʌŋ
ㅌㅡㄱ	tʰɯk̚
ㅇㅏㅈㅡㅂㅏㅇㅣ	ad͡ʑɯbai
ㅇㅜㄴㄷㅗㅇ	undoŋ
ㅇㅣㅅㅏㅇㅎㅏㄷㅏ	isʰaŋɦada
ㅎㅘㅇㅎㅜ	ɸwaŋβu
ㅍㅏㄹㄹㅏㅇㅜ	pʰaɭɭau
ㄱㅕㅇㄱㅖ	kjʌŋɡje
ㅇㅒㄱㅣㅎㅏㄷㅏ	jɛɡiɦada
ㄸㅔㄷㅏ	teda
ㄱㅓㄹㄹㅣㅁㅆㅣ	kʌʎʎimɕi
ㅂㅏㅇㅎㅑㅇㅈㅗㄱ	paŋʝjaŋd͡ʑok̚
ㅊㅜㅅㅜ	t͡ɕʰusʰu
ㅈㅔㅇㅚㅎㅏㄷㅏ	t͡ɕeweɦada
ㄱㅜㅅㅓㅇㅇㅝㄴ	kusʰʌŋwʌn
ㅋㅏㅈㅏㅎㅡㅇㅓ	kʰad͡ʑaɣɯʌ
ㅂㅏㅁㅏㅋㅗ	pamakʰo
ㅈㅔㅇㅜㅅㅡ	t͡ɕeusʰɯ
ㅈㅗㅊㅏ	t͡ɕot͡ɕʰa
ㅊㅜㅇ	t͡ɕʰuŋ
ㅂㅔㄹㄱㅣㅇㅔ	peɭɡie
ㅂㅣㅁㅏㅇㄹㅗㄱ	pimaŋnok̚
ㅇㅜㅇㅢ	uɰi
ㅇㅣㄴㅅㅣㄱㅍㅛ	inɕʰik̚pʰjo
ㅅㅣㅅㅣㄷㅓㄱㄱㅓㄹㅣㄷㅏ	ɕʰiɕʰidʌk̚kʌɾida
ㅇㅣㄴㅅㅏㅎㅏㄷㅏ	insʰaɦada
ㅇㅜㅁㅈㅣㄱㅇㅣㅁ	umd͡ʑiɡim
ㅇㅣㄹㅊㅟㅇㅝㄹㅈㅏㅇ	iʎt͡ɕʰɥiwʌʎd͡ʑaŋ
ㅈㅏㅂ	t͡ɕap̚
ㅁㅓㄹㅣㅅㄱㅕㄹ	mʌɾit̚kjʌɭ
ㄴㅜㄴㅇㅔㅅㄱㅏㅅㅣ	nunet̚kaɕʰi
ㅌㅏㄴㅅㅗ	tʰansʰo
ㄱㅛㅂㅗㄱ	kjobok̚
ㅉㅏㄱㅈㅣㅅㄷㅏ	t͡ɕak̚t͡ɕit̚ta
ㅇㅚㅅㅗㄴㄴㅕ	wesʰonɲjʌ
ㅁㅗㄱㅊㅓㅇ	mok̚t͡ɕʰʌŋ
ㅈㅜㅅㅗ	t͡ɕusʰo
ㅍㅗㄹㅣㅈㅣ	pʰoɾid͡ʑi
ㄱㅓㅁㅓㄹㅣ	kɘmʌɾi
ㄱㅣㄴㄲㅗㄹㅣㄲㅗㅁㅏㅈㅟ	kinkoɾikomad͡ʑɥi
ㄷㅜㅇㅓ	tuʌ
ㅇㅓㅉㅓㅁㅕㄴ	ʌt͡ɕʌmjʌn
ㄲㅜㅁ	kum
ㅇㅗㄹㄱㅕㅇㅜㄹ	oɭkjʌuɭ
ㅅㅜㄹㅔ	sʰuɾe
ㅁㅣㅈㅜㅇㅏㄹ	mid͡ʑuaɭ
ㅇㅡㅁㅂㅏㄴ	ɯmban
ㅍㅣㅈㅣ	pʰid͡ʑi
ㅌㅗㅊㅏㄱ	tʰot͡ɕʰak̚
ㅇㅏㄴㅣㅁㅔ	anime
ㅍㅡㄹㅗ	pʰɯɾo
ㄱㅜㅅ	kut̚
ㅃㅕㅁ	pjʌm
ㄱㅏㄴㄷㅏㄴㅎㅣ	kandanʝi
ㅂㅏㄹㄱㅣ	paɭɡi
ㅁㅣㅇㅑㄴㅁㅏ	mijanma
ㅇㅕㄴㅈㅜ	jɘɲd͡ʑu
ㅇㅜㄹㅌㅏㄹㅣ	uɭtʰaɾi
ㅁㅗㅇㅛㄱ	mojok̚
ㄷㅐㄱㅠㅁㅗ	tɛɡjumo
ㅂㅜㅈㅓㄴㅈㅏㅈㅓㄴ	pud͡ʑʌɲd͡ʑad͡ʑʌn
ㅇㅓㄹㅣㄴㅇㅏㅇㅣ	ʌɾinai
ㅂㅜㄹㄱㅏㄴㅡㅇㅎㅏㄷㅏ	puɭɡanɯŋɦada
ㅎㅝㄴ	ɸwʌn
ㅅㅏㅁㅜㄹㅏㅇㅣ	sʰamuɾai
ㅇㅠㅇㅓㄴ	juʌn
ㅂㅜㄴㄹㅠ	puʎʎju
ㅇㅕㄴㄱㅗ	jɘnɡo
ㅎㅜㄾㄷㅏ	ɸʷuɭta
ㄷㅏㄷㅡㄹ	tadɯɭ
ㅍㅗㅍㅣ	pʰopʰi
ㄱㅏㅁㅜㅇㅣㅇㅑㄱㅣ	kamuijaɡi
ㅊㅓㄴㄷㅜㅇ	t͡ɕʰʌnduŋ
ㄱㅗㅇㅇㅓㅂㅎㅘ	koŋʌpʰwa
ㅁㅏㄴㅈㅣㄷㅏ	maɲd͡ʑida
ㅇㅟㅎㅕㅂㅎㅏㄷㅏ	ɥiʝjʌpʰada
ㅂㅜㄺㅇㅡㄴㅃㅑㅁㄱㅏㅁㅏㅇㅜㅈㅣ	puɭɡɯnpjamɡamaud͡ʑi
ㅇㅗㅍㅔㄹㅏ	opʰeɾa
ㅈㅓㅁㅍㅡㅎㅏㄷㅏ	t͡ɕʌmpʰɯɦada
ㄱㅕㅇㅇㅕㅇ	kjʌŋjʌŋ
ㅍㅗㅋㅔㅅ	pʰokʰet̚
ㄱㅘㄴㅊㅏㄹㅎㅏㄷㅏ	kwaɲt͡ɕʰaɾɦada
ㄴㅐ	nɛ
ㅎㅡㄴㅎㅏㄷㅏ	xɯnɦada
ㅇㅡㅁㅇㅕㄱ	ɯmjʌk̚
ㅂㅗㄷㅏㄷㅗ	podado
ㅇㅣㄴㄷㅗㄹ	indoɭ
ㅅㅛㅂㅣㄴㅣㅈㅡㅁ	ɕʰobinid͡ʑɯm
ㄱㅓㄴㅁㅏㅇㅈㅡㅇ	kɘnmaŋt͡ɕɯŋ
ㄱㅡㄹㅓㄷㅏ	kɯɾʌda
ㄴㅏㅁㅅㅓㅇ	namsʰʌŋ
ㅇㅏㄴㅅㅓㅇㅁㅏㅈㅊㅜㅁ	ansʰʌŋmat̚t͡ɕʰum
ㅇㅖㅅㅁㅏㄹ	jenmaɭ
ㅁㅗㅅ	mot̚
ㅈㅏㅁㅕㅇㄱㅡㅁ	t͡ɕamjʌŋɡɯm
ㄱㅐㅂㅕㄹㅈㅏ	kɛbjʌʎt͡ɕa
ㅎㅡㄱㅇㅕㄱㅅㅏ	xɯɡjʌksa
ㅈㅏㅂㄷㅏㅁㅎㅏㄷㅏ	t͡ɕap̚tamɦada
ㄱㅏㅍㄷㅏ	kap̚ta
ㅇㅜㅊㅔㄱㅜㄱ	ut͡ɕʰeɡuk̚
ㄷㅜㅁㅗㄱ	tumok̚
ㅅㅓㅇㅅㅏㅇ	sʰɘŋsʰaŋ
ㅇㅓㅁㅈㅣ	ʌmd͡ʑi
ㄱㅖㅇㅕㄹ	kjejʌɭ
ㅂㅕㄹㅣㄷㅏ	pjʌɾida
ㅈㅔㄱㅗㅇㅎㅏㄷㅏ	t͡ɕeɡoŋɦada
ㅈㅓㅇㅎㅏㄷㅏ	t͡ɕɘŋɦada
ㅊㅟㅎㅑㅇ	t͡ɕʰɥiʝjaŋ
ㅇㅏㅈㅜ	ad͡ʑu
ㄱㅣㅊㅏㅇㅕㄱ	kit͡ɕʰajʌk̚
ㅇㅕㅁㅂㅗㄱ	jɘmbok̚
ㅁㅣㄲㅜㄹㅣ	mikuɾi
ㅅㅓㅇㅅㅣㅁ	sʰʌŋɕʰim
ㅈㅏㅇㅠ	t͡ɕaju
ㅁㅗㄹㅡㅍㅗㄹㄹㅣㄴ	moɾɯpʰoʎʎin
ㅅㅗㅍㅜㅇ	sʰopʰuŋ
ㄴㅏㅈㅇㅏㅈㅣㄷㅏ	nad͡ʑad͡ʑida
ㅂㅐㅂㅜ	pɛbu
ㄹㅏㅇㅗㅇㅓ	ɾaoʌ
ㅇㅘㅇㅈㅏ	waŋd͡ʑa
ㅂㅓㅁㅇㅣㅅㅣㄴㄹㅗㄴ	pʌmiɕʰiɭɭon
ㅛ	jo
ㄴㅗㅇㅅㅏㄴㅁㅜㄹ	noŋsʰanmuɭ
ㅊㅔㅇㅟ	t͡ɕʰeɥi
ㅇㅓㄴ	ʌn
ㅂㅜㄲㅡㄹㅓㅇㅝㅎㅏㄷㅏ	pukɯɾʌwʌɦada
ㅎㅏㄹㅜ	haɾu
ㄱㅘㄴㅅㅔ	kwansʰe
ㅇㅏㅇㅣㄴㅅㅠㅌㅏㅇㅣㄴㅠㅁ	ainɕʰutʰaiɲjum
ㅍㅔㄹㅡㅅㅣㅇㅏ	pʰeɾɯɕʰia
ㅇㅜㅅㅓㄴ	usʰʌn
ㅈㅓㅇㄱㅘㄴㅅㅏ	t͡ɕɘŋɡwansʰa
ㅇㅏㄴㅏㅌㅔㅁㅏ	anatʰema
ㄱㅗㅇㅛㅎㅏㄷㅏ	kojoɦada
ㅁㅕㄴㅇㅕㄱ	mjɘɲjʌk̚
ㄱㅘㄴㅅㅣㅁ	kwanɕʰim
ㄱㅓㅁㅏㄴ	kɘman
ㄷㅏㅁㄷㅏㅇ	tamdaŋ
ㅂㅏㅇㅋㅗㄱ	paŋkʰok̚
ㅇㅖㅅㅏㄴ	jesʰan
ㄱㅗㅂㅏㅇㅑㅅㅣㅂㅏㄱㅈㅟ	kobajaɕʰibak̚t͡ɕɥi
ㅇㅢㅅㅏㅇ	ɰisʰaŋ
ㅅㅏㄴㅌㅗㄷㅗㅁㅣㅇㄱㅗ	sʰantʰodomiŋɡo
ㅂㅣㄹㅗㅅㄷㅚㄷㅏ	piɾot̚tweda
ㄴㅏㅁㅊㅣㄴ	namt͡ɕʰin
ㅁㅓㄹㅇㅓㅈㅣㄷㅏ	mɘɾʌd͡ʑida
ㅇㅣㄴㅌㅓㄴㅔㅅ	intʰʌnet̚
ㅇㅝㄹㄱㅕㅇ	wʌɭɡjʌŋ
ㄷㅡㅇㅂㅜㄹ	tɯŋpuɭ
ㄱㅕㅇㅁㅕㄹㅈㅓㄱ	kjʌŋmjʌʎt͡ɕʌk̚
ㅇㅘㄴㅈㅓㄴ	waɲd͡ʑʌn
ㅏ	a
ㄱㅏㅁㅌㅏㄴ	kamtʰan
ㅅㅓㄴㅅㅏㅇ	sʰʌnsʰaŋ
ㄷㅏㄹㄹㅕㄱ	taʎʎjʌk̚
ㅇㅏㅂㄹㅗㄱㅈㅏㄱㅡㅅㅏㄴㅣ	amnok̚t͡ɕaɡɯsʰani
ㅇㅣㄹㅜㅇㅓㅈㅣㄷㅏ	iɾuʌd͡ʑida
ㅍㅡㄹㅣㅈㅡㅁ	pʰɯɾid͡ʑɯm
ㅇㅣㅅㅡㄹㅂㅣ	isʰɯɭbi
ㅇㅏㅇㅜ	au
ㄱㅐㅁㅣ	kɛmi
ㅎㅜㄴㅚ	ɸʷunwe
ㅂㅓㅍㅏㄹㄹㅗ	pʌpʰaɭɭo
ㄲㅜㅅㄲㅜㅅㅎㅏㄷㅏ	kut̚kutʰada
ㅊㅓㅇ	t͡ɕʰʌŋ
ㅁㅣㄴㅈㅗㄱ	miɲd͡ʑok̚
ㅂㅏㄷㅏㅈㅔㅂㅣ	padad͡ʑebi
ㄱㅜㄴㅈㅜ	kuɲd͡ʑu
ㅎㅗㅌㅇㅣㅂㅜㄹ	ɸʷonnibuɭ
ㄴㅑㅇ	ɲjaŋ
ㄱㅣㄹㅈㅏㅂㅇㅣ	kiʎd͡ʑabi
ㅈㅣㄴㅏㄴㄷㅏㄹ	t͡ɕinandaɭ
ㅇㅏㄲㅏㅂㄷㅏ	akap̚ta
ㅇㅓㅎㅏㄱ	ɘɦak̚
ㄷㅗㄹㅗㅇㄴㅛㅇ	toɾoŋɲjoŋ
ㅇㅡㄴㄱㅡㄴㅎㅣ	ɯnɡɯnʝi
ㄱㅘㄴㅈㅏㅇ	kwaɲd͡ʑaŋ
ㅅㅔㅈㅔㄹㄱㅟ	sʰed͡ʑeɭɡɥi
ㅌㅜㅇ	tʰuŋ
ㄱㅐㄱㅗㄱㅣ	kɛɡoɡi
ㅂㅏㄴㅁㅏㄹ	panmaɭ
ㅂㅣㅇㅔㄴㅌㅣㅇㅏㄴ	pientʰian
ㅂㅡㄹㅗㅊㅣ	pɯɾot͡ɕʰi
ㅊㅓㅇㅈㅣㄴ	t͡ɕʰʌŋd͡ʑin
ㄱㅏㄴㅅㅣㄱ	kanɕʰik̚
ㅁㅗㅇㄱㅗ	moŋɡo
ㄱㅗㅌㅗㅇ	kotʰoŋ
ㅁㅓㄹㅣㅁㅜㄹㅂㅣㄴㅜ	mʌɾimuɭbinu
ㅂㅏㅇㅇㅏㄴ	paŋan
ㅈㅜㅇㅇㅛ	t͡ɕuŋjo
ㅇㅏㅍㅣㅇㅏ	apʰia
ㄷㅐㅁㅗ	tɛmo
ㅌㅣㅇㅗㅍㅔㄴ	tʰiopʰen
ㅇㅓㅁㅅㅡㅂ	ʌmsʰɯp̚
ㅍㅏㅅㅡㅌㅔㄹ	pʰasʰɯtʰeɭ
ㅈㅓㄴㅎㅘㄴㅎㅏㄷㅏ	t͡ɕɘnβwanɦada
ㅇㅞㅌㄴㅏㅁ	wennam
ㅇㅕㅅㅏㅊㅣㄴ	jʌsʰat͡ɕʰin
ㅁㅣㅌㅓ	mitʰʌ
ㄱㅜㅇㄱㅡㅁㅎㅏㄷㅏ	kuŋɡɯmɦada
ㄱㅏㄴㅁㅜㄹ	kanmuɭ
ㅈㅣㄴㅂㅜㅎㅏㄷㅏ	t͡ɕinbuɦada
ㅇㅣㄺㄷㅏ	ik̚ta
ㄴㅏㄹㅏ	naɾa
ㄱㅕㅇㅈㅔㄱㅘㅎㅏㄱ	kjʌŋd͡ʑeɡwaɦak̚
ㄴㅏㄹㅉㅏ	naʎt͡ɕa
ㅊㅗㅅㅏㅇ	t͡ɕʰosʰaŋ
ㄷㅏㄹㅅㅓㅇ	taɭsʌŋ
ㄹㅛㄹㅣ	ɾjoɾi
ㅋㅏㅌㅡㅁㅏㄴㄷㅜ	kʰatʰɯmandu
ㄷㅗㅇㄱㅡㄹㄷㅏ	toŋɡɯɭda
ㅂㅣㄱㅛㄱㅡㅂ	piɡjoɡɯp̚
ㅅㅗㄱㅗㄱㅣ	sʰoɡoɡi
ㅈㅓㄱㅈㅓㄹㅎㅏㄷㅏ	t͡ɕʌk̚t͡ɕʌɾɦada
ㄱㅟㄸㅜㄹㄱㅟ	kɥituɭɡɥi
ㅋㅜㄴㅑㅇ	kʰuɲjaŋ
ㄱㅓㄴㄷㅓㄱㅣ	kʌndʌɡi
ㅁㅣㄹㅡㄱ	miɾɯk̚
ㅂㅜㅎㅗ	puβo
ㅇㅑㅌㅈㅏㅂㄷㅏ	jat̚t͡ɕap̚ta
ㅅㅡㅅㅣ	sʰɯɕʰi
ㄱㅖㄶ	kjen
ㅎㅡㅁㄱㅕㄹ	xɯmɡjʌɭ
ㅈㅣㄴㄱㅗㅇ	t͡ɕinɡoŋ
ㄱㅣㄸㅗㅇㅊㅏㄷㅏ	kitoŋt͡ɕʰada
ㅍㅗㅁㅜㄹㅅㅓㄴ	pʰomuɭsʌn
ㅉㅏㄹㅣ	t͡ɕaɾi
ㄹㅣㅁㅣㄱㅅㅡ	ɾimiksɯ
ㅅㅣㅈㅏㅇㅎㅏㄷㅏ	ɕʰid͡ʑaŋɦada
ㅍㅕㅇㅇㅗㄴ	pʰjʌŋon
ㅇㅓㅅ	ʌt̚
ㄷㅏㄴㅈㅣ	taɲd͡ʑi
ㅇㅑㅎㅏㄴ	jaɦan
ㄷㅏㅅㅡ	tasʰɯ
ㄴㅡㄲㅕㅈㅣㄷㅏ	nɯkjʌd͡ʑida
ㅇㅏㄴㅌㅔㄴㅏ	antʰena
ㅇㅖㅅㅏㅇㅎㅏㄷㅏ	jesʰaŋɦada
ㅎㅐㅅㅏㅁ	hɛsʰam
ㅍㅗㄷㅗㅈㅜ	pʰodod͡ʑu
ㄱㅘㄴㅈㅓㄹㅇㅕㅁ	kwaɲd͡ʑʌɾjʌm
ㅈㅓㄱㅗㄹㅣ	t͡ɕʌɡoɾi
ㅅㅣㅈㅓㅁ	ɕʰid͡ʑʌm
ㅇㅣㅁㅣ	imi
ㄷㅗㄴㄲㅏㅅㅡ	tonkasʰɯ
ㅁㅏㄴㄷㅡㄹㅇㅓㅈㅣㄷㅏ	mandɯɾʌd͡ʑida
ㅇㅝㄹ	wʌɭ
ㅎㅓㅅㅜ	hʌsʰu
ㅅㅗㄴㅌㅗㅂㄲㅏㄲㅇㅣ	sʰontʰop̚kaki
ㅇㅝㄴㅁㅏㅇ	wʌnmaŋ
ㄱㅗㅇㅉㅏ	koŋt͡ɕa
ㅅㅓㅈㅓㅁ	sʰʌd͡ʑʌm
ㅁㅜㄹㅡㅅ	muɾɯt̚
ㅈㅏㄱㅂㅕㄹ	t͡ɕak̚pjʌɭ
ㅂㅏㄺㄷㅏ	pak̚ta
ㅅㅏㅇㅣㄴ	sʰain
ㄱㅏㅁㄹㅏㅁ	kamnam
ㅇㅏㅍㅅㅓ	apsʌ
ㅅㅔㅁㅣㄴㅏ	sʰemina
ㅁㅗㄹㅜ	moɾu
ㄱㅏㄴㄱㅠㄴ	kanɡjun
ㅁㅣㄴㅁㅏㅇ	minmaŋ
ㅁㅗㄱㅏㄷㅣㅅㅠ	moɡadiɕʰu
ㅈㅓㄴㅎㅘㄱㅣ	t͡ɕɘnβwaɡi
ㅅㅜㅅㅜㄲㅔㄲㅣ	sʰusʰukeki
ㅇㅏㅅㅡㅍㅏㄹㅏㄱㅓㅅㅡ	asʰɯpʰaɾaɡʌsʰɯ
ㅅㅣㅇㅔㄹㅏㄹㅣㅇㅗㄴ	ɕieɾaɾion
ㄱㅓㄱㅈㅓㅇㄷㅚㄷㅏ	kʌk̚t͡ɕʌŋdweda
ㄱㅘㅇㅈㅜ	kwaŋd͡ʑu
ㅅㅣㅂㅇㅣㅈㅣㅈㅏㅇ	ɕʰibid͡ʑid͡ʑaŋ
ㅇㅏㅋㅡㄹㅣㄷㅣㄴ	akxɯɾidin
ㅇㅣㄴㄱㅕㄱ	inkjʌk̚
ㅂㅜㅈㅏㅅㅈㅣㅂ	pud͡ʑat̚t͡ɕip̚
ㅂㅏㅂㅂㅓㄹㅇㅣ	pap̚pʌɾi
ㅅㅗㄹㅈㅣㄱㅎㅏㄷㅏ	sʰoʎd͡ʑikʰada
ㅅㅗㄱㅅㅓㅇㅇㅡㅁㅅㅣㄱ	sʰoksʌŋɯmɕʰik̚
ㄴㅏㅅㅓㄴ	nasʰʌn
ㄱㅘㄴㅎㅏㄹ	kwanɦaɭ
ㅅㅓㄹㅍㅗㄴㅣㄹㄱㅣ	sʰʌɭpʰoniɭɡi
ㅊㅞㅈㅏㅇㅇㅏㅁ	t͡ɕʰwed͡ʑaŋam
ㅈㅜㅈㅓㅇㄲㅜㄴ	t͡ɕud͡ʑʌŋkun
ㅇㅓㅇ	ʌŋ
ㄱㅕㄴㄷㅣㄷㅏ	kjʌndida
ㅇㅏㄹㅏㅎㅏㄴ	aɾaɦan
ㅇㅗㅁㅜㄹ	omuɭ
ㅂㅜㄹㄷㅏㄺ	puɭdak̚
ㅈㅓㅁㄹㅕㅇ	t͡ɕʌmɲjʌŋ
ㄷㅡㅇㅍㅣ	tɯŋpʰi
ㅌㅏㄹㅇㅢㅅㅣㄹ	tʰaɾɰiɕʰiɭ
ㄴㅕㅋ	ɲjʌk̚
ㅅㅗㄱㄷㅏ	sʰok̚ta
ㅇㅗㄴ	on
ㄲㅓㄱㅈㅣ	kʌk̚t͡ɕi
ㅍㅏㅅㅏㄴㅎㅏㄷㅏ	pʰasʰanɦada
ㅅㅏㅂㅇㅣㅂㄱㅗㄱ	sʰabip̚kok̚
ㄷㅗ	to
ㅁㅐㅇㅣㄹ	mɛiɭ
ㅂㅜㅌㄷㅏ	put̚ta
ㅁㅗㅌㅔㄹ	motʰeɭ
ㄷㅏㅇㅈㅣㄹ	taŋd͡ʑiɭ
ㄱㅡㄹㅓㄴ	kɯɾʌn
ㅎㅓㄴㅏㄴ	hʌnan
ㄱㅗㄹㅣㅂㅈㅣ	koɾip̚t͡ɕi
ㄴㅗㅌㅡㅂㅜㄱ	notʰɯbuk̚
ㅇㅣㅁㅏ	ima
ㅅㅏㅇㅊㅜ	sʰaŋt͡ɕʰu
ㅈㅓㅈㄷㅏ	t͡ɕʌt̚ta
ㄱㅓㅁㅊㅏㄹㅊㅓㅇ	kɘmt͡ɕʰaʎt͡ɕʰʌŋ
ㅇㅢㅁㅣㄹㅗㄴ	ɰimiɾon
ㄹㅕㄹㄷㅗ	ɾjʌɭto
ㅁㅕㄱ	mjʌk̚
ㅈㅓㅇㅌㅗㅇ	t͡ɕʌŋtʰoŋ
ㄴㅜㄴㅏ	nuna
ㅈㅗㄹㅡㄷㅏ	t͡ɕoɾɯda
ㄷㅐㅎㅘㅂㅏㅇ	tɛβwabaŋ
ㄹㅔㅈㅡㅂㅣㅇㅓㄴ	ɾed͡ʑɯbiʌn
ㄱㅛㄷㅗㅅㅗ	kjodosʰo
ㅇㅜㄹㅣㄷㅡㄹ	uɾidɯɭ
ㅋㅏㄹㄹㅣㄴㅣㄴㄱㅡㄹㅏㄷㅡ	kʰaʎʎininɡɯɾadɯ
ㅇㅘㄴㅈㅓㄴㅎㅏㄷㅏ	waɲd͡ʑʌnɦada
ㅊㅏㄷㅏ	t͡ɕʰada
ㅈㅗㄹㅣㅂㅎㅏㄷㅏ	t͡ɕoɾipʰada
ㅂㅗㄱㄱㅓㄴㅅㅓㅇ	pok̚kʌnsʰʌŋ
ㅇㅏㅍㅕㄴ	apʰjʌn
ㄱㅜㄹㄹㅣㄷㅏ	kuʎʎida
ㅊㅚㄱㅗ	t͡ɕʰweɡo
ㅈㅣㅂㅗㄱㅈㅣㄱㄱㅘㄴ	t͡ɕibok̚t͡ɕik̚kwan
ㅂㅏㅇㅍㅡㄹ	paŋpʰɯɭ
ㅇㅣㅅㅗㅅㅣㅇㅏㄴㅣㄷㅡ	isʰoɕʰianidɯ
ㅇㅏㄹㅋㅔㄴ	aɭkʰen
ㄱㅗㅂㅏㄹ	kobaɭ
ㅅㅟㄷㅏ	ʃʰɥida
ㄴㅓㅁㅇㅓㅅㅓㄷㅏ	nʌmʌsʰʌda
ㅈㅗㅂㅏㄴ	t͡ɕoban
ㄷㅜㅇㄱㅏㄴㅇㅓ	tuŋɡanʌ
ㅇㅣㄹㅂㅗㄴㅈㅜ	iɭboɲd͡ʑu
ㅌㅗㄹㅗㄴㅎㅏㄷㅏ	tʰoɾonɦada
ㅅㅜㅎㅘㄱ	sʰuβwak̚
ㄷㅐㅌㅚ	tɛtʰwe
ㅎㅗㅂㅏㄱㅅㅏㄴ	ɸʷobaksan
ㅂㅜㄴㅁㅛ	punmjo
ㅅㅔㅅㅜㅎㅏㄷㅏ	sʰesʰuɦada
ㅆㅡㄹㅔㄱㅣㅌㅗㅇ	sɯɾeɡitʰoŋ
ㅅㅣㅇㅟ	ɕʰiɥi
ㅈㅗㅈㅗㅇㅅㅏ	t͡ɕod͡ʑoŋsʰa
ㅇㅏㅁㅣㄴ	amin
ㄷㅏㄹㅡㅇㅔㅅㅡㅅㅏㄹㄹㅏㅁ	taɾɯesʰɯsʰaɭɭam
ㄷㅡㄹㅏㅇㅣㄱㅣ	tɯɾaiɡi
ㅁㅏㅇㅡㅁㅆㅣ	maɯmɕi
ㄱㅓㄹㄹㅣㄷㅏ	kʌʎʎida
ㄷㅣㄱㅡㄷ	tiɡɯt̚
ㅈㅜㅈㅏㅇㅎㅏㄷㅏ	t͡ɕud͡ʑaŋɦada
ㅈㅣㅇㅜㄷㅏ	t͡ɕiuda
ㄴㅗㅇㅎㅜㅎㅏㄷㅏ	noŋβuɦada
ㅍㅏㅊㅣㄴㅋㅗ	pʰat͡ɕʰinkʰo
ㅂㅏㄹㅇㅕㄹ	paɾjʌɭ
ㅁㅣㅂㅜㄴㅁㅗㄳ	mibunmok̚
ㄷㅙㅈㅣㄱㅗㄱㅣ	twɛd͡ʑiɡoɡi
ㄷㅏㄴㅁㅜㅈㅣ	tanmud͡ʑi
ㅅㅓㄹㅊㅣㄹㅠ	sʰʌʎt͡ɕʰiɾju
ㅁㅏㄴㅍㅗ	manpʰo
ㅊㅚㅅㅓㄴ	t͡ɕʰwesʰʌn
ㅂㅏㄹㅂㅏㄹㅣ	paɭbaɾi
ㅊㅏㅇㄱㅗ	t͡ɕʰaŋko
ㄷㅗㅇㅜㅁㅣ	toumi
ㅈㅏㅂㅈㅗㅇㄱㅕㄴ	t͡ɕap̚t͡ɕoŋɡjʌn
ㄷㅏㅇㄴㅏㄱㅟ	taŋnaɡɥi
ㅎㅓㅅㅋㅗㄱㅗㄹㄷㅏ	hʌt̚kʰoɡoɭda
ㅂㅜㄲㅡㄹㅣㄷㅏ	pukɯɾida
ㄱㅣㅇㅓㄱㄴㅏㄷㅏ	kiʌŋnada
ㅊㅚㅈㅗㅇ	t͡ɕʰwed͡ʑoŋ
ㅈㅗㅇㅇㅏㄹㅣㅃㅕ	t͡ɕoŋaɾipjʌ
ㅇㅡㅁㄱㅕㅇ	ɯmɡjʌŋ
ㅈㅏㅇㄴㅏㄴㄲㅜㄹㅓㄱㅣ	t͡ɕaŋnankuɾʌɡi
ㅆㅜㄱㄱㅏㅅ	suk̚kat̚
ㄷㅡㅇㅈㅏ	tɯŋd͡ʑa
ㅈㅓㅅ	t͡ɕʌt̚
ㅇㅕㄹㅇㅏㅎㅗㅂ	jʌɾaβop̚
ㅈㅏㅇㅠㅈㅜㅇㅢ	t͡ɕajud͡ʑuɰi
ㅋㅡㄹㅔㅇㅣㄴ	kxɯɾein
ㄱㅘㄴㅂㅏㅇㅎㅏㄱ	kwanbaŋɦak̚
ㅇㅓㄴㄸㅡㅅ	ʌntɯt̚
ㄹㅣㄷㅜ	ɾidu
ㅇㅢㅈㅏ	ɰid͡ʑa
ㅇㅚㅁㅕㄴ	wemjʌn
ㅂㅜㄱㅟ	puɡɥi
ㅍㅣㄹㅅㅜㄴ	pʰiɭsʰun
ㅅㅓㅇㄱㅔ	sʰɘŋɡe
ㄱㅓㄷㄱㅣ	kɘt̚ki
ㄴㅠ	ɲju
ㄷㅓㅅ	tʌt̚
ㄹㅣㄷㅓ	ɾidʌ
ㅂㅗㄱㅇㅕㅂㄱㅣ	poɡjʌp̚ki
ㅇㅔㄹㄴㅣㄴㅗ	eʎʎino
ㅇㅓㄹㅇㅡㅁㅂㅗㅅㅜㅇㅇㅣ	ʌɾɯmbosʰuŋi
ㄷㅗㅊㅔ	tot͡ɕʰe
ㅇㅠㄴㅣㅍㅗㅁ	junipʰom
ㄱㅏㄹㅕㄴㅎㅣ	kaɾjʌnʝi
ㅅㅗㄹㅣㅊㅣㄷㅏ	sʰoɾit͡ɕʰida
ㄹㅣㅇㅓㅋㅏ	ɾiʌkʰa
ㅃㅗㅃㅗㅎㅏㄷㅏ	popoɦada
ㅇㅗㅅㅡㅌㅡㄹㅔㅇㅣㄹㄹㅣㅇㅏ	osʰɯtʰɯɾeiʎʎia
ㅈㅡㅇㅇㅓㄴ	t͡ɕɯŋʌn
ㅊㅗㅇㅁㅕㅇㅎㅏㄷㅏ	t͡ɕʰoŋmjʌŋɦada
ㅅㅣㅈㅣㅂ	ɕʰid͡ʑip̚
ㄱㅏㄹㄹㅠㅁ	kaʎʎjum
ㅇㅠㄹㅣㅅㅈㅗㄱㅏㄱ	juɾit̚t͡ɕoɡak̚
ㅎㅏㅇㅁㅜㄴ	haŋmun
ㅂㅜㄴㄴㅗ	punno
ㅁㅡㄹ	mɯɭ
ㅁㅣㅇㅕㄱㄱㅜㄱ	mijʌk̚kuk̚
ㅂㅣㄹㄷㅣㅇ	piɭdiŋ
ㄷㅗㅅㅓㄱㅘㄴ	tosʰʌɡwan
ㅇㅏㄴㄴㅏㅁ	annam
ㅅㅏㅅㅗㅎㅏㄷㅏ	sʰasʰoɦada
ㄱㅏ	ka
ㅍㅠㄹㅣㄴ	pʰjuɾin
ㄸㅏㅇㅋㅗㅇ	taŋkʰoŋ
ㄸㅓㄼㄷㅏ	tɘɭta
ㅍㅣㅇㅔㄹㅗ	pʰieɾo
ㅊㅣㄴㅇㅜ	t͡ɕʰinu
ㅎㅡㄱㄹㅗ	xɯŋno
ㅈㅓㄴㄹㅏㅂㅜㄱㄷㅗ	t͡ɕʌɭɭabuk̚to
ㅌㅜㅅㅏㅈㅣ	tʰusʰad͡ʑi
ㅋㅗㅁㅁㅏ	kʰomma
ㅂㅜㄹㅁㅏㄴ	puɭman
ㄱㅏㅁㅜㄹㄱㅏㅁㅜㄹ	kamuɭɡamuɭ
ㅅㅣㄱㅍㅜㅁㅂㅗㅈㅗㄴㄹㅛ	ɕʰik̚pʰumbod͡ʑoʎʎjo
ㅁㅗㄳㅁㅗㄳㅇㅣ	moŋmokɕi
ㅇㅔㄹㄹㅣㅂㅔㅇㅣㅌㅓ	eʎʎibeitʰʌ
ㅇㅏㅈㅓㅆㅣ	ad͡ʑʌɕi
ㅇㅏㄹㅣ	aɾi
ㄱㅕㄷㅡㄹㅏㅇㅇㅣ	kjʌdɯɾaŋi
ㅇㅏㄴㅏㄱ	anak̚
ㅁㅣ	mi
ㅇㅓㅆ	ʌt̚
ㅈㅔㄷㅗㅇㄱㅣ	t͡ɕedoŋɡi
ㅇㅡㅁㅅㅣㄱ	ɯmɕʰik̚
ㄱㅐㅈㅏㅇㄱㅜㄱ	kɛd͡ʑaŋkuk̚
ㅍㅗㄱㄱㅕㄱㄱㅣ	pʰok̚kjʌk̚ki
ㅅㅓㄴㄱㅓ	sʰɘnɡʌ
ㅈㅣㅇㅟ	t͡ɕiɥi
ㄱㅑㅇㅜㅅ	kjaut̚
ㅅㅏㅁㅇㅣㄴㅊㅣㅇ	sʰamiɲt͡ɕʰiŋ
ㄷㅟㅇㄱㅜㄹㄷㅏ	tɥiŋɡuɭda
ㅇㅕㄹㄷㅏㅅㅓㅅ	jʌɭtasʰʌt̚
ㅇㅓㄹㄹㅜㄱㄷㅗㅇㅅㅏㄹㅣ	ʌɭɭuk̚toŋsʰaɾi
ㄷㅚㄱㅔ	tweɡe
ㄱㅕㅇㅅㅓㅇ	kjʌŋsʰʌŋ
ㄷㅡㄹㅍㅏㄴ	tɯɭpʰan
ㄱㅡㄹㅣㅂㄷㅏ	kɯɾip̚ta
ㅂㅣㄴㅜ	pinu
ㄷㅐㅂㅏㄱ	tɛbak̚
ㅇㅓㄴㄹㅗㄴㄱㅏ	ʌɭɭonɡa
ㄱㅡㄹㅣㅅㅡ	kɯɾisʰɯ
ㅉㅣㄱㅅㅗㄹㅣ	t͡ɕiksoɾi
ㅎㅓㄱㅏ	hʌɡa
ㅅㅏㅇㅎㅕㅇ	sʰaŋʝjʌŋ
ㄱㅏㅇㅡㄹ	kaɯɭ
ㅍㅏㅅㅏㄴ	pʰasʰan
ㅉㅏㄱㅈㅣㅅㄱㅣ	t͡ɕak̚t͡ɕit̚ki
ㄱㅛㄱㅓ	kjoɡʌ
ㅇㅗㅇㅣ	oi
ㅅㅓㅇㅇㅢ	sʰʌŋɰi
ㅇㅏㅇㅜㄹㄹㅓ	auɭɭʌ
ㅁㅏㄴㅈㅗㄱ	maɲd͡ʑok̚
ㄴㅏㄹㅡㄷㅏ	naɾɯda
ㄱㅛㅈㅏㅇ	kjod͡ʑaŋ
ㄴㅏㅌㅏㄴㅏㄷㅏ	natʰanada
ㅈㅗㅅㅓㅇ	t͡ɕosʰʌŋ
ㄴㅓㄱㅜㄹㅣ	nʌɡuɾi
ㄹㅣㅌㅜㅇㅏㄴㅣㅇㅏㅇㅓ	ɾitʰuaniaʌ
ㅜ	u
ㅇㅗㅅㅈㅏㅇ	ot̚t͡ɕaŋ
ㅈㅔㅁㅜㄹ	t͡ɕemuɭ
ㅅㅗㅎㅘㄴ	sʰoβwan
ㅂㅔㄴㅣㄴ	penin
ㅇㅏㅇㅣㅋㅗㄴ	aikʰon
ㅇㅓㄴㄹㅗㄴㅎㅏㄱㅈㅏ	ʌɭɭonɦak̚t͡ɕa
ㅁㅕㄴㅎㅏㄷㅏ	mjɘnɦada
ㅈㅣㅂㅜㄹ	t͡ɕibuɭ
ㅈㅏㄱㅏㅅㅏㄹㅣ	t͡ɕaɡasʰaɾi
ㄲㅏㄲㅟ	kakɥi
ㅁㅗㅁㅌㅗㅇ	momtʰoŋ
ㅎㅗㅅㅏㅂㅣㅇㅗㄹㅣ	ɸʷosʰabioɾi
ㅇㅚㄱㅜㄱ	weɡuk̚
ㅅㅗㅎㅘ	sʰoβwa
ㅇㅠㄴㄱㅘㄱ	junɡwak̚
ㅈㅏㅈㅜ	t͡ɕad͡ʑu
ㅅㅡㅂㄴㅣㄷㅏ	sɯmnida
ㅈㅏㄹㅏㅇ	t͡ɕaɾaŋ
ㅅㅏㄴㅑㅇ	sʰaɲjaŋ
ㄱㅓㅈㅓㄹ	kʌd͡ʑʌɭ
ㄸㅗㄱㄱㅏㅌㄷㅏ	tok̚kat̚ta
ㅊㅢ	t͡ɕʰi
ㅅㅓㅇㅂㅜㄴ	sʰʌŋbun
ㅌㅏㄹㅈㅜㅂㅕㅇ	tʰaʎt͡ɕubjʌŋ
ㅅㅏㅇㄱㅘㄴ	sʰaŋɡwan
ㄱㅣㅊㅗㅎㅏㄷㅏ	kit͡ɕʰoɦada
ㅇㅗㅅㅏㅋㅏ	osʰakʰa
ㅇㅑㄼㄷㅏ	jaɭta
ㅁㅗㄱㅣ	moɡi
ㅅㅓㄹㅂㅣ	sʰʌɭbi
ㅂㅜㅈㅏㅇ	pud͡ʑaŋ
ㄱㅏㅇㅈㅓㅇ	kaŋd͡ʑʌŋ
ㅁㅣㄹㅣㄱㅕㄴ	miɾiɡjʌn
ㅇㅣㄹㅓㅎㄱㅔ	iɾʌkʰe
ㅇㅣㅂㅔㄴㅌㅡ	ibentʰɯ
ㅂㅏㄱㅎㅏ	pakʰa
ㄱㅓㄴㄴㅓㄱㅏㄷㅏ	kɘnnʌɡada
ㅇㅣㅂㅈㅏㅇ	ip̚t͡ɕaŋ
ㄱㅏㅂㅊㅜㅇ	kap̚t͡ɕʰuŋ
ㅇㅕㅇㅎㅘ	jʌŋβwa
ㅇㅏㄹㄹㅣㄹㄱㅣ	aʎʎiɭɡi
ㅇㅓㄷㄷㅏ	ʌt̚ta
ㅈㅣㅅㅣㄱ	t͡ɕiɕʰik̚
ㅈㅣㄱㅎㅏㄹㅅㅣ	t͡ɕikʰaɭɕʰi
ㅎㅏㅂㅈㅏㄱ	hap̚t͡ɕak̚
ㅅㅓㄱㅌㅏㄴ	sʰʌk̚tʰan
ㅂㅗㅎㅗ	poβo
ㅇㅗㅍㅔㄹㅔㅌㅏ	opʰeɾetʰa
ㅇㅏㅇㅣㄷㅣㅇㅓ	aidiʌ
ㅅㅏㄳ	sʰak̚
ㅇㅑㄱㅜ	jaɡu
ㅁㅏㅈㅣㅁㅏㄱ	mad͡ʑimak̚
ㅇㅏㅁ	am
ㅅㅔㅇㅝㄹ	sʰewʌɭ
ㄱㅏㄺ	kak̚
ㄱㅗㅇㅈㅓㅇㅎㅏㄷㅏ	koŋd͡ʑʌŋɦada
ㅅㅜㄴㅇㅑㅇㅎㅏㅁ	sʰuɲjaŋɦam
ㄴㅏㅊㅏㄹ	nat͡ɕʰaɭ
ㅈㅏㄱㅈㅓㄴ	t͡ɕak̚t͡ɕʌn
ㅇㅠㄱㅛ	juɡjo
ㄴㅗㅇㅏ	noa
ㅎㅚㄱㅖ	ɸweɡje
ㅋㅡㄴㅊㅓㅁㅅㅓ	kxɯɲt͡ɕʰʌmsʰʌ
ㅅㅏㄴㅏㅂㄷㅏ	sʰanap̚ta
ㅈㅜㅇㅎㅘㅇㅣㄴㅁㅣㄴㄱㅗㅇㅎㅘㄱㅜㄱ	t͡ɕuŋβwainminɡoŋβwaɡuk̚
ㄷㅗㅇㅘㅈㅜㄷㅏ	towad͡ʑuda
ㅅㅔㅅㅏㅇ	sʰesʰaŋ
ㅅㅏㅁㄱㅜㄱ	sʰamɡuk̚
ㅂㅜㄹㅆㅏㅇ	puɭsaŋ
ㅂㅏㄹㅉㅏㄱ	paʎt͡ɕak̚
ㄴㅜㄴ	nun
ㅅㅡㅇㅎㅏ	sʰɯŋɦa
ㅇㅜㄹㅡㄷㅜㅇㅓ	uɾɯduʌ
ㅅㅣㅁㅣㄴㄱㅝㄴ	ɕʰiminkwʌn
ㅇㅣㄹㄷㅏㄴ	iɭtan
ㅈㅚㅅㅗㅇㅎㅏㄷㅏ	t͡ɕwesʰoŋɦada
ㄱㅘㅇ	kwaŋ
ㅁㅜㅉㅣㄹㅡㄷㅏ	mut͡ɕiɾɯda
ㅇㅣㅁㄱㅡㅁ	imɡɯm
ㅅㅗㄱㄷㅗ	sʰok̚to
ㄴㅡㄺㅇㅡㄴㅇㅣ	nɯɭɡɯni
ㅍㅗㄹㅡㅌㅗㄴㅗㅂㅗ	pʰoɾɯtʰonobo
ㄱㅗㅊㅜㅈㅏㅈㅣ	kot͡ɕʰud͡ʑad͡ʑi
ㅈㅗㅋㅏㄸㅏㄹ	t͡ɕokʰataɭ
ㅇㅟㅎㅓㅁㅎㅏㄷㅏ	ɥiɦʌmɦada
ㅇㅓㄹㅇㅡㅁ	ʌɾɯm
ㅎㅔㄹㄱㅣ	heɭɡi
ㅅㅣㄹㄹㅣㄴㄷㅓ	ɕʰiʎʎindʌ
ㄱㅘㄱㅡㅁ	kwaɡɯm
ㄴㅐㄱㅏㄱ	nɛɡak̚
ㄱㅗㅇㅠㅇㅓ	kojuʌ
ㄴㅏㅁㅇㅏㅍㅡㄹㅣㅋㅏ	namapʰɯɾikʰa
ㅌㅔㄴㅣㅅㅡ	tʰenisʰɯ
ㅇㅣㄹㅕㄱㅅㅓ	iɾjʌksʌ
ㅎㅓㄹㅏㄱㅎㅏㄷㅏ	hʌɾakʰada
ㅅㅜㄹㅣㅇㅏ	sʰuɾia
ㅇㅚㄷㅗㅇㄸㅏㄹ	wedoŋtaɭ
ㅇㅗㄱㅡㅁ	oɡɯm
ㄱㅘㅇㅁㅜㄹ	kwaŋmuɭ
ㄱㅏㅇㅑㄱㅡㅁ	kajaɡɯm
ㅅㅏㅌㅏㄴ	sʰatʰan
ㅈㅔㄹㄹㅣ	t͡ɕeʎʎi
ㄷㅏㄹㄱㅜㅈㅣ	taɭɡud͡ʑi
ㅅㅏㄴㅁㅜㄴ	sʰanmun
ㄷㅡㄹㅏㅇㅣㅂㅡ	tɯɾaibɯ
ㅌㅡㄱㅇㅠ	tʰɯɡju
ㅂㅜㅅ	put̚
ㅁㅜㄹㅅㅜㄹㅣ	muɭsuɾi
ㅅㅏㅁㅗㅇㅏ	sʰamoa
ㅊㅣㅂ	t͡ɕʰip̚
ㄱㅣㅈㅏ	kid͡ʑa
ㄴㅑ	ɲja
ㅅㅗㄷㅗㄱㅈㅔ	sʰodok̚t͡ɕe
ㅎㅡㅇㅎㅏㄷㅏ	xɯŋɦada
ㅂㅏㅇㅂㅓㅂ	paŋbʌp̚
ㅇㅏㄱㅁㅗㅇ	aŋmoŋ
ㅋㅏㅂㅜㄹ	kʰabuɭ
ㅅㅜㅇㅕㅇㅎㅏㄷㅏ	sʰujʌŋɦada
ㅊㅏㅂㅕㄹ	t͡ɕʰabjʌɭ
ㅈㅣㄲㅓㄹㅇㅣㄷㅏ	t͡ɕikʌɾida
ㅂㅜㄴㅈㅓㅁ	puɲd͡ʑʌm
ㅇㅣㅂㅅㅜㄹ	ipsuɭ
ㅈㅜㅇㄹㅑㅇ	t͡ɕuŋɲjaŋ
ㅊㅣㄷㅏㄷㄷㅏ	t͡ɕʰidat̚ta
ㅁㅜㅊㅣㄷㅏ	mut͡ɕʰida
ㅂㅏㄴㅂㅏㅈㅣ	panbad͡ʑi
ㅁㅏㅊㅓㄴㄹㅜ	mat͡ɕʰʌɭɭu
ㅎㅓㄱㅜ	hʌɡu
ㅎㅏㄴㅂㅏㄴㄷㅗ	hanbando
ㄱㅡㄹㅆㅡㄱㅣ	kɯɭsɯɡi
ㅊㅜㅇㅊㅓㅇㅂㅜㄱㄷㅗ	t͡ɕʰuŋt͡ɕʰʌŋbuk̚to
ㅂㅏㄲㅏㅌ	pakat̚
ㅇㅠㅊㄴㅗㄹㅇㅣ	junnoɾi
ㅂㅔㅇㄱㅗㄹㅇㅓ	peŋɡoɾʌ
ㅎㅗㅅㅓㄴ	ɸʷosʰʌn
ㅇㅠㅎㅕㅇ	juʝjʌŋ
ㅁㅕㅇㅈㅜ	mjʌŋd͡ʑu
ㅉㅗㅂㅏㄱ	t͡ɕobak̚
ㄱㅘㄴㅁㅜㄴ	kwanmun
ㅁㅗㅂㅅㅣ	mopɕi
ㅈㅓㄴㄷㅡㅇ	t͡ɕɘndɯŋ
ㅇㅣㅅㅏ	isʰa
ㅎㅏㄱㅁㅕㅇ	haŋmjʌŋ
ㄱㅡㄹㅓㄴㄷㅔ	kɯɾʌnde
ㅍㅟㄹ	pʰɥiɭ
ㄴㅔㄱㅓㄹㅣ	neɡʌɾi
ㅁㅜㄹㄱㅜㅂㅇㅣ	muɭɡubi
ㅎㅡㅋ	xɯk̚
ㅇㅣㅆㅇㅡㅅㅣㄷㅏ	isɯɕʰida
ㄱㅕㄹㅅㅓㄱ	kjʌɭsʌk̚
ㅂㅏㅇㄱㅏㅁㅕㄴ	paŋɡamjʌn
ㅇㅠㄹㅗㅍㅠㅁ	juɾopʰjum
ㅂㅜㅍㅜㄹㄷㅏ	pupʰuɭda
ㄱㅓㄱㅈㅓㅇ	kʌk̚t͡ɕʌŋ
ㅅㅜㅁㅕㅇ	sʰumjʌŋ
ㅌㅜㄹㄹㅠㅁ	tʰuʎʎjum
ㅅㅗㅁㅡㄹㄹㅣㅇㅔ	sʰomɯʎʎie
ㅈㅏㄷㅗㅇㄱㅖㄷㅏㄴ	t͡ɕadoŋɡjedan
ㄱㅕㅇㄱㅣ	kjʌŋɡi
ㄴㅠㅅㅡ	ɲjusʰɯ
ㅅㅣㄴ	ɕʰin
ㅈㅣㄱㅁㅜㄹ	t͡ɕiŋmuɭ
ㅅㅓㅇㄹㅣㅂㄷㅚㄷㅏ	sʰʌŋnip̚tweda
ㅎㅏㄹㅇㅣㄴ	haɾin
ㄹㅏㄴ	ɾan
ㅅㅜㅅㅗㅍㅗㄱㅌㅏㄴ	sʰusʰopʰok̚tʰan
ㄴㅏㅇㅜㄹㅜ	nauɾu
ㅇㅡㄴㅎㅖ	ɯnʝje
ㅊㅜㅇㄱㅗㅎㅏㄷㅏ	t͡ɕʰuŋɡoɦada
ㅊㅜㄴ	t͡ɕʰun
ㅋㅏㄹㄹㅏ	kʰaɭɭa
ㅎㅘㅈㅏㅇ	ɸwad͡ʑaŋ
ㅊㅡ	t͡ɕʰɯ
ㅃㅗㄹㅡㄸㅜㄱㅏㄹ	poɾɯtuɡaɭ
ㅊㅓㄹㅍㅖ	t͡ɕʰʌɭpʰje
ㄱㅗㅇㅅㅏ	koŋsʰa
ㅎㅘㅇㅅㅗ	ɸwaŋsʰo
ㅅㅡㄹㄹㅗㅂㅔㄴㅅㅡㄲㅗ	sʰɯɭɭobensʰɯko
ㅊㅓㄴㅎㅘㅇ	t͡ɕʰʌnβwaŋ
ㅈㅣㄴㄷㅏㄴ	t͡ɕindan
ㅇㅕㄴㅃㅜㄹㅣ	jʌnpuɾi
ㅂㅗㅂㅗㄱ	pobok̚
ㄱㅟㅈㅜ	kɥid͡ʑu
ㅂㅜㄹㅣㄷㅏ	puɾida
ㅈㅡㄹㄱㅓㅇㅜㅁ	t͡ɕɯɭɡʌum
ㅊㅜㅇㅂㅜㄴㅎㅏㄷㅏ	t͡ɕʰuŋbunɦada
ㄱㅚㄹㅗㅂㄷㅏ	kweɾop̚ta
ㅁㅜㄴㅁㅕㅇ	munmjʌŋ
ㅎㅘㅇㅕㅁㅂㅕㅇ	ɸwajʌmbjʌŋ
ㄱㅏㅌㅇㅣ	kat͡ɕʰi
ㅍㅜㅅㅂㅗㄹ	pʰut̚poɭ
ㅈㅏㄴㄸㅡㄱ	t͡ɕantɯk̚
ㅂㅜㄹㄱㅗㄱㅣ	puɭɡoɡi
ㅂㅐㅅㅣㅁ	pɛɕʰim
ㅂㅣㄹㅗㅅㅎㅏㄷㅏ	piɾotʰada
ㅈㅏㅋㅏㄹ	t͡ɕakʰaɭ
ㅈㅏㄱㅕㄱㅈㅣㅅㅣㅁ	t͡ɕaɡjʌk̚t͡ɕiɕʰim
ㅇㅏㄴㅂㅏㅇ	anbaŋ
ㄱㅐㅇㅣㄴ	kɛin
ㅇㅑㅇㅈㅏㅇㅕㄱㅎㅏㄱ	jaŋd͡ʑajʌkʰak̚
ㅇㅏㅇㅏㄱ	aak̚
ㅂㅏㄴㅅㅏㄱㅕㅇ	pansʰaɡjʌŋ
ㅈㅔㅇㅢㅎㅏㄷㅏ	t͡ɕeɰiɦada
ㅇㅏㄹㄷㅔㅎㅣㄷㅡ	aɭdeʝidɯ
ㅂㅜㄹㅓㅁ	puɾʌm
ㅇㅝㄴㅍㅣㅅㅡ	wʌnpʰisʰɯ
ㅋㅡㄹㅔㅍㅏㅅㅡ	kxɯɾepʰasʰɯ
ㄷㅏㅇㄱㅣㄷㅏ	taŋɡida
ㅅㅓㄷㅜㄹㅡㄷㅏ	sʰʌduɾɯda
ㄱㅜㄷㅜ	kudu
ㅅㅛㄹㅜㅁ	ɕʰoɾum
ㅅㅣㄹㅅㅣㅎㅏㄷㅏ	ɕʰiɭɕʰiɦada
ㅈㅔㄱㅣㅊㅏㄱㅣ	t͡ɕeɡit͡ɕʰaɡi
ㅇㅏㄶㄷㅏ	antʰa
ㅎㅡㅁㅃㅓㄱ	xɯmpʌk̚
ㄹㅜ	ɾu
ㅈㅓㅇㅊㅣㅍㅏㄴ	t͡ɕʌŋt͡ɕʰipʰan
ㅇㅡㅇㅇㅛㅇ	ɯŋjoŋ
ㅅㅡㅁㅣㄷㅏ	sʰɯmida
ㅌㅡㄹㅣㄴㅣㄷㅏㄷㅡ	tʰɯɾinidadɯ
ㅎㅡㅇㅁㅣㅈㅣㄴㅈㅣㄴㅎㅏㄷㅏ	xɯŋmid͡ʑiɲd͡ʑinɦada
ㄱㅗㅅㅏㄱㅣ	kosʰaɡi
ㅁㅣㅊㅓ	mit͡ɕʰʌ
ㅍㅣㄹㅇㅓㅂ	pʰiɾʌp̚
ㅈㅣㅈㅣㄹ	t͡ɕid͡ʑiɭ
ㅍㅛㅈㅓㅇ	pʰjod͡ʑʌŋ
ㅇㅕㅌㄷㅏ	jʌt̚ta
ㅁㅏㄷㅏㅇ	madaŋ
ㄱㅗㅈㅣㄹㅂㅕㅇ	kod͡ʑiɭpjʌŋ
ㅈㅣㅍㅖ	t͡ɕipʰje
ㄱㅏㅊㅏㅇㅇㅗㄹㅣ	kat͡ɕʰaŋoɾi
ㄱㅟㄱㅗㄹㅣ	kɥiɡoɾi
ㅂㅏㄹㅍㅛㅎㅏㄷㅏ	paɭpʰjoɦada
ㅂㅐㄴㅏㅇ	pɛnaŋ
ㅁㅕㅇㄹㅕㅇㅎㅏㄷㅏ	mjɘŋɲjʌŋɦada
ㅇㅕㄴㅁㅗㅅ	jʌnmot̚
ㄸㅏㄹㅏㄱㅏㄷㅏ	taɾaɡada
ㄱㅏㄴㅁㅗ	kanmo
ㅈㅣㅇㄱㅖ	t͡ɕiŋɡje
ㅅㅜㅅㅜㅁㅣㄲㅜㄹㅣ	sʰusʰumikuɾi
ㄱㅏㅇㅓㅄㄷㅏ	kaʌp̚ta
ㅇㅜㅅㅜㄹㅣ	usʰuɾi
ㅁㅜㄹㄹㅕㅂㅏㄷㄷㅏ	muʎʎjʌbat̚ta
ㅆㅡㄹㄷㅔ	sɯɭte
ㅈㅗㅇㅓㄴㅎㅏㄷㅏ	t͡ɕoʌnɦada
ㅊㅏㄹㅎㅡㄺ	t͡ɕʰaɾɣɯk̚
ㄱㅗㅇㅇㅝㄴ	koŋwʌn
ㅍㅜㄹㅇㅓㅈㅣㄷㅏ	pʰuɾʌd͡ʑida
ㅎㅡㄿ	xɯp̚
ㅎㅗㄹㅇㅏㅂㅣ	ɸʷoɾabi
ㅇㅣㅌㅏㄹㄹㅣㅇㅏ	itʰaʎʎia
ㄱㅏㄴㅏㄴ	kanan
ㄱㅐㅅㅓㅇ	kɛsʰʌŋ
ㅂㅣㅍㅕㅇㄱㅏ	pipʰjʌŋɡa
ㄴㅜㄹㅣ	nuɾi
ㄱㅗㄴㅏㄴ	konan
ㄹㅏㅌㅣㄴ	ɾatʰin
ㅆㅏㄱ	sak̚
ㅍㅏㄴㅁㅜㄴㅈㅓㅁ	pʰanmuɲd͡ʑʌm
ㅊㅏㅁㄷㅚㄷㅏ	t͡ɕʰamtweda
ㄷㅗㅇㅂㅏㄴㅈㅏ	toŋbaɲd͡ʑa
ㄱㅏㅇㄷㅗㄷㅏㄹㅣ	kaŋdodaɾi
ㅈㅜㅇㅢㅎㅏㄷㅏ	t͡ɕuɰiɦada
ㅁㅗㄱㅁㅏㄹㅡㅁ	moŋmaɾɯm
ㄱㅏㅅㅗㄹㅗㅂㄷㅏ	kasʰoɾop̚ta
ㅈㅓㅂㄷㅏ	t͡ɕʌp̚ta
ㄷㅏㄴㄱㅗㄹ	tanɡoɭ
ㅂㅓㄷㅡㄹㄱㅏㅈㅣ	pʌdɯɭɡad͡ʑi
ㅂㅗㅈㅏㄹㄱㅓㅅㅇㅓㅄㄷㅏ	pod͡ʑaɭkʌsʰʌp̚ta
ㅌㅚㅈㅣㄴ	tʰwed͡ʑin
ㄷㅏㄴㅂㅏㄹ	tanbaɭ
ㅇㅜㅇㅠ	uju
ㄴㅜㅅㅓㄹㅎㅏㄷㅏ	nusʰʌɾɦada
ㅁㅏㅍㅜㅌㅗ	mapʰutʰo
ㄷㅐㅅㅏㄱㅘㄴ	tɛsʰaɡwan
ㅎㅏㅁㅁㅜㄱㅈㅡㅇ	hammuk̚t͡ɕɯŋ
ㅅㅣㄱㅁㅜㄹㅎㅏㄱ	ɕʰiŋmuɾɦak̚
ㄱㅓㄴㅅㅓㄹ	kɘnsʰʌɭ
ㅁㅣㅁ	mim
ㄴㅏㅍㅡㅌㅣㄹㅣㄷㅣㄴ	napʰɯtʰiɾidin
ㅁㅔㅋㅏ	mekʰa
ㅈㅜㅇㄷㅗㄱ	t͡ɕuŋdok̚
ㅂㅜㄹㄱㅏㅈㅣㄹㅗㄴ	puɭɡad͡ʑiɾon
ㅈㅜㄹㅠ	t͡ɕuɾju
ㅈㅏㅇㅕㄴ	t͡ɕajʌn
ㅈㅓㄴㅅㅔ	t͡ɕɘnsʰe
ㅁㅏㅌㅡㄹㅛㅅㅣㅋㅏ	matʰɯɾjoɕʰikʰa
ㅎㅡㄶ	xɯn
ㅇㅕㄹㅇㅕㅅㅓㅅ	jʌʎʎjʌsʰʌt̚
ㅇㅏㅇㅖ	aje
ㅇㅠㅅㅣㄴㄹㅗㄴ	juɕʰinnon
ㅂㅜㄴㅅㅓㄱ	punsʰʌk̚
ㅇㅜㄴㅡㄴㅌㅗㄲㅣ	unɯntʰoki
ㄹㅣㄹㄹㅗㅇㄱㅞ	ɾiɭɭoŋɡwe
ㅋㅡㄴㄴㅏㅂㅈㅣㄹㅣ	kxɯnnap̚t͡ɕiɾi
ㅇㅏㄱㅏㅁㅣ	aɡami
ㅎㅔㄹㅡㅁㅔㅅㅡ	heɾɯmesʰɯ
ㄷㅏㄹㅣㅁㅈㅣㄹ	taɾimd͡ʑiɭ
ㅊㅏㅁㅇㅚ	t͡ɕʰamwe
ㄱㅐㄲㅝㅇ	kɛkwʌŋ
ㅈㅏㅃㅓㄱ	t͡ɕapʌk̚
ㅊㅔㅋㅡㅇㅓ	t͡ɕʰekxɯʌ
ㅇㅏㄹㅏ	aɾa
ㅎㅏㄹㅇㅏㅂㅓㄴㅣㅁ	haɾabʌnim
ㅁㅏㄴㅇㅣㄹ	maniɭ
ㅇㅢㄷㅗ	ɰido
ㅊㅓㅂ	t͡ɕʰʌp̚
ㄱㅣㅁㅊㅣㅈㅓㄴ	kimt͡ɕʰid͡ʑʌn
ㄷㅔㅇㅣㅌㅡㅎㅏㄷㅏ	teitʰɯɦada
ㅅㅓㄱㅌㅏㄴㅅㅏㄴ	sʰʌk̚tʰansʰan
ㅂㅜㅊㅓㄴㅣㅁ	put͡ɕʰʌnim
ㅇㅡㅇㅈㅣㅂㄹㅕㄱ	ɯŋd͡ʑimɲjʌk̚
ㄱㅕㄴㄱㅘ	kjʌnɡwa
ㅈㅔㅈㅗ	t͡ɕed͡ʑo
ㅇㅛㄱㅜㄹㅡㅌㅡ	joɡuɾɯtʰɯ
ㅁㅗㄱㅌㅏㄴ	mok̚tʰan
ㄱㅘㅌㅣㅇ	kwatʰiŋ
ㄴㅏㅅㅓㄷㅏ	nasʰʌda
ㅈㅚㅅㅗㅇ	t͡ɕwesʰoŋ
ㄱㅣㅎㅏㅂ	kiɦap̚
ㅋㅗㅇㅏㄹㄹㅏ	kʰoaɭɭa
ㅇㅑㄱㄹㅕㄱ	jaŋɲjʌk̚
ㄱㅡㄹㅓㅎㄷㅏ	kɯɾʌtʰa
ㄱㅗㅁㅏㅇㅝ	komawʌ
ㅂㅏㅇㅅㅗㅇㄱㅜㄱ	paŋsʰoŋɡuk̚
ㅋㅏㅇㅜㅊㅣ	kʰaut͡ɕʰi
ㅂㅜㄹㄹㅠㄴㅎㅏㄷㅏ	puʎʎjunɦada
ㄷㅏㅁㄱㅡㄷㅏ	tamɡɯda
ㅌㅏㅁㄹㅏ	tʰamna
ㅇㅏㄹㅏㅁㅇㅓ	aɾamʌ
ㅈㅔㅅㅓㄹㅊㅏ	t͡ɕesʰʌʎt͡ɕʰa
ㅅㅣㅂㅈㅏㄱㅏ	ɕʰip̚t͡ɕaɡa
ㅍㅜㄹㄴㅔㅇㅣㅁ	pʰuɭɭeim
ㅋㅡㄴㅇㅣㄹ	kxɯnniɭ
ㄱㅖㅅㅣ	kjeɕʰi
ㄷㅡㅇㄱㅘㅇ	tɯŋɡwaŋ
ㅁㅣㅅㅓㅇ	misʰʌŋ
ㅈㅓㅂㅅㅓㄴ	t͡ɕʌpsʌn
ㅈㅜㅇㄱㅗㅇ	t͡ɕuŋɡoŋ
ㅈㅏㅇㅅㅜ	t͡ɕaŋsʰu
ㅍㅜㅇㅂㅜㅎㅏㄷㅏ	pʰuŋbuɦada
ㅅㅜㅇㅣㅂ	sʰuip̚
ㅋㅗㅌㅡㄴ	kʰotʰɯn
ㅊㅗㄱㅂㅓㅂㅅㅗㄴㅕㄴ	t͡ɕʰok̚pʌpsoɲjʌn
ㅊㅓㅇㄷㅗㅇ	t͡ɕʰʌŋdoŋ
ㅇㅛㄹㅡㄷㅏㄴ	joɾɯdan
ㅋㅏ	kʰa
ㄱㅣㄴㅣ	kini
ㄱㅣㅊㅣㅁㅎㅏㄷㅏ	kit͡ɕʰimɦada
ㅈㅏㅇㅈㅓㅁ	t͡ɕaŋt͡ɕʌm
ㅇㅞㄹㄹㅣㅇㅌㅓㄴ	weʎʎiŋtʰʌn
ㅈㅏㅅㅣㄱ	t͡ɕaɕʰik̚
ㅇㅜㅊㅔㅂㅜ	ut͡ɕʰebu
ㄱㅡㅇㅈㅓㅇㅈㅓㄱ	kɯŋd͡ʑʌŋd͡ʑʌk̚
ㅎㅏㄹㅜㅅㅂㅏㅁ	haɾut̚pam
ㅅㅣㄷㅡㄹㄷㅏ	ɕʰidɯɭda
ㅅㅣㄴㅏㅂㅡㄹㅗ	ɕʰinabɯɾo
ㅇㅝㄴㅈㅜㅇㅠㄹ	wʌɲd͡ʑujuɭ
ㄱㅏㅂㅏㅇ	kabaŋ
ㄷㅜㄱㅕㄴ	tuɡjʌn
ㄱㅗㄷㄷㅏ	kot̚ta
ㅍㅟㄴ	pʰɥin
ㅎㅏㅇㅘ	hawa
ㄷㅗㅇㅇㅏㄹㅣ	toŋaɾi
ㄹㅔㅁㅗㄴ	ɾemon
ㅂㅣㅅㅗ	pisʰo
ㅍㅗㄱㅍㅜㅇㅇㅜ	pʰok̚pʰuŋu
ㅅㅓㄹㄹㅣㅂㅎㅏㄷㅏ	sʰʌʎʎipʰada
ㅂㅜㄱㄷㅜㅊㅣㄹㅅㅓㅇ	puk̚tut͡ɕʰiɭsʰʌŋ
ㄱㅓㅇㅣㄴ	kɘin
ㄱㅛㅇㅢ	kjoɰi
ㅅㅣㄹ	ɕʰiɭ
ㅎㅏㄴㄱㅏㅇ	hanɡaŋ
ㄱㅗㅇㅇㅏㄹ	koŋaɭ
ㄸㅗㅇㅆㅏㄷㅏ	toŋsada
ㄴㅏㅅㅓㄴㅎㅕㅇ	nasʰʌnʝjʌŋ
ㅌㅔㅁㅍㅡㄹㄹㅔㅅ	tʰempʰɯɭɭet̚
ㅈㅗㄹㅏㅇㅁㅏㄹ	t͡ɕoɾaŋmaɭ
ㅌㅏㄱㅇㅏㅅㅗ	tʰaɡasʰo
ㄷㅡㅅㅣㄷㅏ	tɯɕʰida
ㅇㅏㄹㄹㅣㄱㅗ	aʎʎiɡo
ㄴㅏㅇㅏㅈㅣㄷㅏ	naad͡ʑida
ㅅㅏㅇㅇㅣㄴ	sʰaŋin
ㅎㅚㅇㅢ	ɸweɰi
ㅇㅕㄴㄱㅣ	jʌnɡi
ㅈㅣㅂㅈㅜㅇㄷㅚㄷㅏ	t͡ɕip̚t͡ɕuŋdweda
ㅂㅔㅉㅏㅇㅇㅣ	pet͡ɕaŋi
ㄱㅏㄴㅍㅕㄴㅎㅏㄷㅏ	kanpʰjʌnɦada
ㄷㅣㅋㅏ	tikʰa
ㅈㅣㄹㅣㅅㅏㄴ	t͡ɕiɾisʰan
ㄹㅗㅁㅏㅇㅅㅡ	ɾomaŋsʰɯ
ㅂㅏㄹㅎㅛ	paɾʝjo
ㅋㅟㅈㅡ	kʰɥid͡ʑɯ
ㄱㅜㄱㅎㅘ	kukʰwa
ㅇㅗㄴ	on
ㅅㅔㄱㅖㅈㅓㄱ	sʰeɡjed͡ʑʌk̚
ㅂㅗㅎㅗㅎㅏㄷㅏ	poβoɦada
ㅈㅏㅇㅇㅣㄴ	t͡ɕaŋin
ㅇㅓㅁㅈㅣㅅㅗㄴㄱㅏㄹㅏㄱ	ʌmd͡ʑisʰonɡaɾak̚
ㅊㅜㄹㄱㅡㄴㅎㅏㄷㅏ	t͡ɕʰuɭɡɯnɦada
ㅅㅓㄹㄱㅓㅈㅣ	sʰʌɭɡʌd͡ʑi
ㅇㅟ	ɥi
ㅊㅏㅇㅈㅗㅈㅓㄱ	t͡ɕʰaŋd͡ʑod͡ʑʌk̚
ㅅㅣㅂㅈㅏㄱㅗㅅㅏㅇ	ɕʰip̚t͡ɕaɡosʰaŋ
ㄸㅟㄹㅡㄲㅣㅇㅖ	tɥiɾɯkije
ㅈㅗㅅㅣㅁ	t͡ɕoɕʰim
ㅌㅔㄹㄹㅔㅌㅏㅇㅣㅍㅡ	tʰeɭɭetʰaipʰɯ
ㄱㅏㄲ	kak̚
ㅎㅘㄱㅇㅣㄴㄷㅚㄷㅏ	ɸwaɡindweda
ㅁㅔㅅㅣㅇㅏ	meɕʰia
ㅈㅓㄱㅡㅂ	t͡ɕɘɡɯp̚
ㅇㅣㄱㅓ	iɡʌ
ㅂㅐㄱㅅㅜ	pɛksu
ㅇㅣㄴㅈㅓㅇㅎㅏㄷㅏ	iɲd͡ʑʌŋɦada
ㅋㅗㅋㅏㅇㅣㄴ	kʰokʰain
ㅇㅛㅇ	joŋ
ㅈㅣㄹㄹㅑㅇ	t͡ɕiʎʎjaŋ
ㄴㅏㅈㅈㅏㅁ	nat̚t͡ɕam
ㄱㅖㅎㅚㄱ	kjeβwek̚
ㄷㅡㄹㄷㅏ	tɯɭda
ㅈㅣㄴㅈㅓㅇㅎㅏㄷㅏ	t͡ɕiɲd͡ʑʌŋɦada
ㄱㅘㄹㅎㅗ	kwaɾβo
ㅇㅏㅁㅈㅏ	amd͡ʑa
ㅁㅜㄱㄷㅏ	muk̚ta
ㄱㅏㄱㅏㅇㅅㅜㄹㅑㅇ	kaɡaŋsʰuɾjaŋ
ㅇㅕㅇㅎㅏ	jʌŋɦa
ㅍㅜㄲㅔㅅ	pʰuket̚
ㅋㅡㄹㅗㅁ	kxɯɾom
ㅇㅛㄱㅈㅗ	jok̚t͡ɕo
ㄴㅏㄷ	nat̚
ㅁㅐㅈㅏㅇ	mɛd͡ʑaŋ
ㄱㅟㅈㅓㄹ	kɥid͡ʑʌɭ
ㄸㅓㄹㅇㅓㅈㅣㄷㅏ	tʌɾʌd͡ʑida
ㅋㅗㄴㅑㄱ	kʰoɲjak̚
ㅇㅗㄻㅇㅏㄱㅏㄷㅏ	oɭmaɡada
ㅈㅜㅇㄱㅜㄱㅈㅣㅂ	t͡ɕuŋɡuk̚t͡ɕip̚
ㅂㅜㅈㅓㅇㅅㅏ	pud͡ʑʌŋsʰa
ㅁㅣㄱㅅㅓ	miksʌ
ㅈㅣㅇㅝㄴㅈㅏ	t͡ɕiwʌɲd͡ʑa
ㅇㅓㄹ	ʌɭ
ㅅㅡㅌㅗㄴㅎㅔㄴㅈㅣ	sʰɯtʰonɦeɲd͡ʑi
ㅅㅔㅌㅏㄱㅎㅏㄷㅏ	sʰetʰakʰada
ㄱㅡㄴㄷㅔ	kɯnde
ㅋㅗㅊㅣ	kʰot͡ɕʰi
ㅅㅏㄹㅅㅏㄹㅎㅏㄷㅏ	sʰaɭsʰaɾɦada
ㅈㅜㅇㅈㅓㄱㅂㅜㄴ	t͡ɕuŋd͡ʑʌk̚pun
ㅁㅜㄴㅈㅏㅇ	muɲd͡ʑaŋ
ㄱㅜㄻㅈㅜㄹㅣㅁ	kumd͡ʑuɾim
ㅂㅣㅇㅈㅓㅁ	piŋd͡ʑʌm
ㅇㅣㄴㅁㅜㄹ	inmuɭ
ㅅㅏㅈㅡㅇ	sʰat͡ɕɯŋ
ㅇㅏㄵㄷㅏ	anta
ㄲㅘㄱ	kwak̚
ㅕ	jʌ
ㅇㅚㅈㅓㅂㅇㅝㄴ	wed͡ʑʌbwʌn
ㅈㅔㅈㅜㅁㅗㅊㅣㅁㅏㅇㄷㅜㄱ	t͡ɕed͡ʑumot͡ɕʰimaŋduk̚
ㅂㅓㅁㅏㅇㅓ	pʌmaʌ
ㅂㅏㅇㅇㅓㄴ	paŋʌn
ㅂㅗㄱ	pok̚
ㄱㅣㅇㅝㄴ	kiwʌn
ㅌㅜㅁㅕㅇ	tʰumjʌŋ
ㅎㅘㄱㅈㅏㅇ	ɸwak̚t͡ɕaŋ
ㅇㅠㅇㅏㅇㅝㄴ	juawʌn
ㄱㅗㄹㅅㅜ	koɭsu
ㅁㅜㄱㅜㅇㅎㅘ	muɡuŋβwa
ㅅㅓㅂㅏㄴㅇㅏ	sʰʌbana
ㅎㅟㄹㅊㅔㅇㅓ	hɥiʎt͡ɕʰeʌ
ㄴㅗㅅㅜㄱㅎㅏㄷㅏ	nosʰukʰada
ㄱㅏㅁㅈㅏㅌㅟㄱㅣㅁ	kamd͡ʑatʰɥiɡim
ㅁㅗㅂ	mop̚
ㅁㅐㅊㅜㄹ	mɛt͡ɕʰuɭ
ㄱㅣㅁㅂㅏㅂ	kimpap̚
ㅅㅏㅎㅏㅇ	sʰaɦaŋ
ㅂㅏㄹㄱㅏㄴ	paɭɡan
ㄷㅗㄱㅇㅣㄹㅇㅓ	toɡiɾʌ
ㅌㅗㅇㅇㅕㄱㅈㅏ	tʰoŋjʌk̚t͡ɕa
ㄱㅡㄹㅆㅔ	kɯɭse
ㅅㅏㅇㅅㅏㅇㅎㅏㄷㅏ	sʰaŋsʰaŋɦada
ㅅㅡㅍㅜㄴ	sʰɯpʰun
ㅋㅗㄹㄹㅔㅅㅡㅌㅔㄹㅗㄹ	kʰoɭɭesʰɯtʰeɾoɭ
ㅌㅔㄴㅣㅅㅡㅈㅏㅇ	tʰenisʰɯd͡ʑaŋ
ㅅㅣㅅㅜㄱ	ɕʰisʰuk̚
ㅅㅏㅇㅝㄹ	sʰawʌɭ
ㄴㅚ	nwe
ㄷㅟㅈㅣㅂㄷㅏ	tɥid͡ʑip̚ta
ㄱㅓㅁㅈㅓㅇ	kʌmd͡ʑʌŋ
ㅉㅣㄹㅣㅅㅎㅏㄷㅏ	t͡ɕiɾitʰada
ㅇㅠㄷㅗㄱㅣ	judoɡi
ㅇㅕㅂ	jʌp̚
ㄱㅗㄷㅗㄱㅎㅏㄷㅏ	kodokʰada
ㄹㅏㄱ	ɾak̚
ㅌㅚㄱㅡㄴ	tʰweɡɯn
ㅁㅣㅇㅣㄴ	miin
ㅋㅡㅁㅔㄹㅡㅇㅓ	kxɯmeɾɯʌ
ㅁㅏㄹㄸㅗㅇㄱㅜㄹㅣ	maɭtoŋɡuɾi
ㅆㅡㅇㅣㄷㅏ	sɯida
ㄷㅗㅇㄴㅏㅁ	toŋnam
ㅇㅣㄱㅅㅏㄹㅅㅡㄹㅓㅂㄷㅏ	iksaɭsʰɯɾʌp̚ta
ㄱㅗㅎㅘㄴ	koβwan
ㅎㅏㄱㄱㅗㅇㅊㅣ	hak̚koŋt͡ɕʰi
ㅂㅡㄹㅟㅅㅔㄹ	pɯɾɥisʰeɭ
ㅇㅣㅁㅗㅂㅜ	imobu
ㅃㅏㄴㅉㅡ	paɲt͡ɕɯ
ㅇㅞㅂㅅㅏㅇㅣㅌㅡ	wepsaitʰɯ
ㅈㅓㄴㅎㅘㅎㅏㄷㅏ	t͡ɕʌnβwaɦada
ㅂㅗㅇㅑㅇㅌㅏㅇ	pojaŋtʰaŋ
ㅈㅜㅇㅣㄴㄱㅗㅇ	t͡ɕuinɡoŋ
ㅁㅜㄱㅓㅂㄷㅏ	muɡʌp̚ta
ㄱㅜㄱㅕㄹㅈㅏ	kuɡjʌʎd͡ʑa
ㅁㅔㄹㅂㅓㄹㅡㄴ	meɭbʌɾɯn
ㄱㅗㅇㅅㅣㄱ	koŋɕʰik̚
ㅊㅏㅁㅅㅏ	t͡ɕʰamsʰa
ㅅㅣㄴㄱㅣㅎㅏㄷㅏ	ɕʰinɡiɦada
ㅎㅗㄹㄹㅣㄷㅏ	ɸʷoʎʎida
ㅇㅓㄷㅗ	ʌdo
ㄱㅏㅇㅇㅝㄴㄷㅗ	kaŋwʌndo
ㅉㅣㄱㅡㄹㅓㅈㅣㄷㅏ	t͡ɕiɡɯɾʌd͡ʑida
ㅈㅣㄱㅜㅇㅢ	t͡ɕiɡuɰi
ㅇㅏㅅㅡㅋㅗㄹㅂㅣㄱㅅㅏㄴ	asʰɯkʰoɭbiksan
ㅈㅣㅂㄱㅝㄴㄷㅏㅇ	t͡ɕip̚kwʌndaŋ
ㅁㅕㅇㅇㅜㄴ	mjɘŋun
ㅇㅏㅌㅔㄴㅏ	atʰena
ㅅㅣㄲㅓㅁㅓㅎㄷㅏ	ɕʰikʌmʌtʰa
ㅊㅏㅈㅇㅏㅂㅗㄷㅏ	t͡ɕʰad͡ʑaboda
ㅇㅏㅇㅣㅅㅡㅋㅔㅇㅣㅋㅡ	aisʰɯkʰeikxɯ
ㅉㅏㅁㅃㅗㅇ	t͡ɕampoŋ
ㅂㅡㄱㅡㅁ	pɯɡɯm
ㅇㅣㅆㄷㅏ	it̚ta
ㅇㅕㄴㄹㅕㅇ	jʌʎʎjʌŋ
ㅈㅓㄱㄷㅏㅇ	t͡ɕʌk̚taŋ
ㅅㅜㄹㄷㅗㄱ	sʰuɭdok̚
ㅂㅏㄴㅂㅗㄱ	panbok̚
ㅆㅣㅂㄷㅜㄷㅓㅇ	ɕip̚tudʌŋ
ㅍㅔㄹㅡㅅㅑㅇㅓ	pʰeɾɯɕʰaʌ
ㅇㅓㄴㅇㅓㅎㅏㄱ	ʌnʌɦak̚
ㅂㅏㅇㅂㅓㅂㄹㅗㄴ	paŋbʌmnon
ㅂㅏㄴㅊㅣㅁ	paɲt͡ɕʰim
ㅋㅗㅁㅍㅠㅌㅓ	kʰompʰjutʰʌ
ㅇㅣㅂㅇㅝㄴ	ibwʌn
ㅌㅓㄹㅓㄱ	tʰʌɾʌk̚
ㅈㅗㅈㅣㅇㅏㅇㅓ	t͡ɕod͡ʑiaʌ
ㅅㅣㄴㄱㅛㄷㅗ	ɕʰinɡjodo
ㄱㅚㄹㅗㅂㅎㅣㄷㅏ	kweɾopʰida
ㅁㅜㅋㅜㄹㅣ	mukʰuɾi
ㅎㅘㅅㅓㄱ	ɸwasʰʌk̚
ㅅㅏㅅㅣㄹ	sʰaɕʰiɭ
ㅈㅏ	t͡ɕa
ㅉㅓㅇ	t͡ɕʌŋ
ㄱㅕㄹㅈㅓㅇㅎㅘ	kjʌʎt͡ɕʌŋβwa
ㄷㅏㄹㄷㅏ	taɭda
ㅇㅕㄴㅅㅡㅂ	jɘnsʰɯp̚
ㅌㅗㅍㅣㄱ	tʰopʰik̚
ㅂㅜㄷㅡㄹ	pudɯɭ
ㅈㅔㅅㅣ	t͡ɕeɕʰi
ㄷㅏㅁㅇㅛ	tamɲjo
ㅈㅣㅂㅜㅇ	t͡ɕibuŋ
ㅈㅜㅇㅅㅏ	t͡ɕuŋsʰa
ㅇㅣㄹㅂㅜ	iɭbu
ㄱㅡㄴㅁㅜ	kɯnmu
ㄱㅗㄱㅣㅎㅜㅎㅏㄱ	koɡiβuɦak̚
ㅂㅏㄷㅏㅅㅁㅜㄹㄱㅗㄱㅣ	padanmuɭɡoɡi
ㄱㅗㅅㅏㄹㅣ	kosʰaɾi
ㅅㅏㄴㄷㅜㅇ	sʰanduŋ
ㅂㅕㄹㅅㅔㅎㅏㄷㅏ	pjʌɭseɦada
ㄱㅡㅇㅡㄹㄷㅏ	kɯɯɭda
ㄱㅖㅈㅣㅂ	kjed͡ʑip̚
ㅃㅏㅇㅈㅣㅂ	paŋt͡ɕip̚
ㅇㅏㄴㅏㅋㅗㄴㄷㅏ	anakʰonda
ㄷㅜㄲㅓㅂㄷㅏ	tukʌp̚ta
ㅊㅏㄴㄹㅏㄴㅎㅏㄷㅏ	t͡ɕʰaɭɭanɦada
ㅈㅓㄱㅓ	t͡ɕʌɡʌ
ㅂㅗㅇㅁㅣㄹ	poŋmiɭ
ㅇㅢㅁㅣ	ɰimi
ㅎㅏㅍㅡㄹㄹㅗㄱㅡㄹㅜㅂ	hapʰɯɭɭoɡɯɾup̚
ㅅㅡㅌㅡㄹㅗㄴㅌㅠㅁ	sʰɯtʰɯɾontʰjum
ㅇㅗㅅㅡㅁㅠㅁ	osʰɯmjum
ㅎㅘㄷㅏㄴ	ɸwadan
ㄸㅏㄲㅏㄴ	takan
ㄱㅚㅅㅜ	kwesʰu
ㄴㅗㅇㅕㅂㄷㅏ	nojʌp̚ta
ㄷㅡㄹㅇㅓㅅㅓㄷㅏ	tɯɾʌsʰʌda
ㅁㅔㄱㅅㅣㅋㅗㅅㅣㅌㅣ	mekɕikʰoɕʰitʰi
ㅇㅠㅊ	jut̚
ㅍㅖㄹㅕㅁ	pʰjeɾjʌm
ㄱㅏㄹㄹㅣㅁㄱㅣㄹ	kaʎʎimkiɭ
ㄷㅔㅇㅣㅌㅓ	teitʰʌ
ㅎㅏㄱㄱㅣ	hak̚ki
ㅋㅡㄹㅣㅁ	kxɯɾim
ㅎㅏㄴㅏㄴㅣㅁ	hananim
ㅎㅡㄱㅊㅔ	xɯk̚t͡ɕʰe
ㅁㅗㅊㅓㄹㅓㅁ	mot͡ɕʰʌɾʌm
ㄴㅏㅎㄷㅏ	natʰa
ㄱㅏㅂㅏㄹ	kabaɭ
ㅂㅕㄱㅎㅘ	pjʌkʰwa
ㅎㅏㅁ	ham
ㅅㅠㄴㅣㅊㅔㄹ	ɕʰunit͡ɕʰeɭ
ㅅㅣㅂㄴㅏㄹ	ɕʰimnaɭ
ㅈㅣㅊㅜㄹ	t͡ɕit͡ɕʰuɭ
ㅎㅘㄴㅇㅕㅇㅎㅏㄷㅏ	ɸwaɲjʌŋɦada
ㅁㅏㄹㄹㅏㅇㅟ	maɭɭaɥi
ㄱㅘㅇㅕㄴ	kwajʌn
ㄱㅏㄹㅗㅁㅏㄱ	kaɾomak̚
ㅊㅜㅅㅓㄱ	t͡ɕʰusʰʌk̚
ㅁㅣㄴㅈㅗㄱㅈㅜㅇㅢ	miɲd͡ʑok̚t͡ɕuɰi
ㄷㅗㅍㅏㅁㅣㄴ	topʰamin
ㅅㅣㄴㄷㅔㄹㅔㄹㄹㅏ	ɕʰindeɾeɭɭa
ㅈㅡㅇㅁㅕㅇ	t͡ɕɯŋmjʌŋ
ㅂㅗㄱㅅㅡㅂㅎㅏㄷㅏ	poksɯpʰada
ㅅㅏㄱㅣ	sʰaɡi
ㄲㅓㄲㄷㅏ	kʌk̚ta
ㅈㅣㄴㄱㅠㄴ	t͡ɕinɡjun
ㅊㅜㄱㅏ	t͡ɕʰuɡa
ㅊㅏㄱㅅㅓㄱ	t͡ɕʰaksʌk̚
ㄷㅐㄹㅑㅇ	tɛɾjaŋ
ㄴㅡㅇ	nɯŋ
ㅈㅏㅇㅏ	t͡ɕaa
ㅁㅏㅇㅊㅣ	maŋt͡ɕʰi
ㅈㅜㅇㄹㅕㄱㅈㅏ	t͡ɕuŋɲjʌk̚t͡ɕa
ㄷㅏㄴㄱㅖ	tanɡje
ㅊㅣㄴ	t͡ɕʰin
ㄱㅣㄴㅂㅏㄹㅌㅗㅂㅊㅓㅁㅅㅓ	kinbaɭtʰop̚t͡ɕʰʌmsʰʌ
ㅁㅜㄱ	muk̚
ㅈㅗㄴㄴㅏ	t͡ɕonna
ㅍㅡㄹ	pʰɯɭ
ㄱㅓㅁㄷㅗ	kɘmdo
ㅊㅓㄴ	t͡ɕʰʌn
ㄱㅗㄹㅜ	koɾu
ㅇㅣㄴㅅㅏㅁㅊㅏ	insʰamt͡ɕʰa
ㅁㅣㅅㅜ	misʰu
ㅅㅡㄹ	sʰɯɭ
ㅅㅣㄴㄱㅗ	ɕʰinɡo
ㄴㅗㄹㅏㅇ	noɾaŋ
ㅂㅏㅇㅊㅜ	paŋt͡ɕʰu
ㄱㅕㅇㅇㅜ	kjʌŋu
ㅃㅏㅎㄷㅏ	patʰa
ㅇㅕㄱㅅㅏㅈㅓㄱ	jʌksad͡ʑʌk̚
ㅂㅏㅇㅅㅗㅇㅅㅏ	paŋsʰoŋsʰa
ㅅㅏㄱㅘㅎㅏㄷㅏ	sʰaɡwaɦada
ㄱㅜㄹㅏㅍㅏ	kuɾapʰa
ㅅㅔㅁㅔㄴㅌㅡ	sʰementʰɯ
ㅊㅣㄹㅁㅕㄴㅈㅗ	t͡ɕʰiɭmjʌɲd͡ʑo
ㅃㅡㄹㄹㅠㅅㅡ	pɯʎʎjusʰɯ
ㄹㅏㄱㅅㅏ	ɾaksa
ㅂㅜㄱㅅㅓ	puksʌ
ㄷㅏㅇㅎㅏㄷㅏ	taŋɦada
ㅇㅜㄴㅅㅓㄱ	unsʰʌk̚
ㅇㅗㅂㅏㅁㅏ	obama
ㄱㅡㄹㅣㅅㅡㄷㅗㄱㅛ	kɯɾisʰɯdoɡjo
ㅊㅏㅈㅣㅎㅏㄷㅏ	t͡ɕʰad͡ʑiɦada
ㄱㅗㅈㅓㄴㅈㅓㄱ	kod͡ʑʌɲd͡ʑʌk̚
ㅂㅗㄱㅅㅗㅅㅜ	poksosu
ㄷㅓㄱㅌㅡ	tʌk̚tʰɯ
ㄹㅕㄴ	ɾjʌn
ㄴㅕㅅㅓㄱ	ɲjʌsʰʌk̚
ㅎㅗㅎㅡㅂ	ɸʷoɣɯp̚
ㅍㅡㄹㅓㅍㅗㅈㅡ	pʰɯɾʌpʰod͡ʑɯ
ㅅㅓㄴㄱㅛㅅㅏ	sʰʌnɡjosʰa
ㄹㅗㄱㅡㅇㅏㅇㅜㅅ	ɾoɡɯaut̚
ㄷㅏㅇㅑㅇ	tajaŋ
ㅇㅏㅂ	ap̚
ㄱㅜㄱㅎㅏㄴ	kukʰan
ㅅㅓㅂㅡㅋㅓㄹㅊㅓ	sʰʌbɯkʰʌʎt͡ɕʰʌ
ㅅㅓㄹㅌㅏㅇ	sʰʌɭtʰaŋ
ㅆㅓㄹㅣㄷㅏ	sɘɾida
ㄴㅜㄱㅜㅅㅔㅇㅛ	nuɡusʰejo
ㅇㅐㄱㅜㄱㅈㅜㅇㅢ	ɛɡuk̚t͡ɕuɰi
ㅂㅗㄴㅣㅅ	ponit̚
ㄷㅡㄹ	tɯɭ
ㅁㅜㄱㅘㄴㅅㅣㅁㅎㅏㄷㅏ	muɡwanɕʰimɦada
ㅈㅏㅇㄹㅗㄱㅛㅎㅚ	t͡ɕaŋnoɡjoβwe
ㄴㅔㅇㅣㅁㅓㅇㄱㅜ	neimʌŋɡu
ㅊㅏㄹㅣㄷㅏ	t͡ɕʰaɾida
ㄱㅘㄴㄹㅛㅈㅔ	kwaʎʎjod͡ʑe
ㄸㅓㅅㄸㅓㅅㅎㅏㄷㅏ	tʌt̚tʌtʰada
ㅍㅣㄹㅅㅡㅇ	pʰiɭsʰɯŋ
ㅁㅏㅊㅣ	mat͡ɕʰi
ㅍㅗㄹㄹㅏㄴㄷㅡㅇㅣㄴ	pʰoɭɭandɯin
ㄹㅏㄷㅣㅇㅔㅇㅣㅌㅓ	ɾadieitʰʌ
ㅅㅏㅇㅣㄷㅏ	sʰaida
ㄴㅏㅁㅅㅓㅇㄱㅗㅇㅡㅁ	namsʰʌŋɡoɯm
ㅁㅏㅅㅣㄷㅏ	maɕʰida
ㅈㅓㅇㄹㅠㅈㅏㅇ	t͡ɕʌŋɲjud͡ʑaŋ
ㅅㅣㄴㅇㅣㅁㅎㅏㄷㅏ	ɕʰinimɦada
ㅇㅓㅂㄷㅏ	ʌp̚ta
ㅅㅣㅂㅇㅣㄹ	ɕʰibiɭ
ㅈㅏㅁㅏㄱ	t͡ɕamak̚
ㅇㅏㄱㅇㅣㄴ	aɡin
ㅊㅗㅅㅣㄴㅅㅓㅇ	t͡ɕʰoɕʰinsʰʌŋ
ㅂㅣㄲㅣㄷㅏ	pikida
ㅌㅣㅅㅠ	tʰiɕʰu
ㅂㅜㄹㄱㅏㅍㅣ	puɭɡapʰi
ㅂㅏㄹㅡㅅㅑㅂㅏ	paɾɯɕʰaba
ㅅㅔㅌㅏㄱㅅㅗ	sʰetʰakso
ㅇㅡㅂ	ɯp̚
ㄱㅘㅇㄱㅜ	kwaŋɡu
ㄴㅓㅁㅇㅓㅈㅣㄷㅏ	nʌmʌd͡ʑida
ㅂㅜㄹㅎㅘㅇ	puɾβwaŋ
ㅂㅜㅅㅍㅔㄴ	put̚pʰen
ㅇㅣㅌㅔㄹㅡㅂㅠㅁ	itʰeɾɯbjum
ㄱㅡㅇㅑㅁㅏㄹㄹㅗ	kɯjamaɭɭo
ㄱㅕㄹㅅㅓㄱㅎㅏㄷㅏ	kjʌɭsʌkʰada
ㄸㅗㅇㅊㅏ	toŋt͡ɕʰa
ㅇㅢㅅㅣㅁㄷㅚㄷㅏ	ɰiɕʰimdweda
ㅇㅣㄹㄲㅜㄴ	iɭkun
ㅁㅣㄲㅡㄴㅁㅏㅇㄷㅜㄱ	mikɯnmaŋduk̚
ㅉㅏㄹㅣㅅㅎㅏㄷㅏ	t͡ɕaɾitʰada
ㅇㅐㄱㅛ	ɛɡjo
ㅋㅏㅅㅔㅌㅡ	kʰasʰetʰɯ
ㅁㅏㄹㅎㅏㄱㅣ	maɾɦaɡi
ㅇㅣㄴㄹㅕㄱㄱㅓ	iʎʎjʌk̚kʌ
ㄴㅐㅈㅓㅂㅇㅝㄴ	nɛd͡ʑʌbwʌn
ㅍㅣㅇㅜㄷㅏ	pʰiuda
ㅎㅗㄴㅎㅏㅂ	ɸʷonɦap̚
ㅈㅓㅇㄱㅛㅎㅚ	t͡ɕɘŋɡjoβwe
ㅈㅏㅇㅈㅏㄱ	t͡ɕaŋd͡ʑak̚
ㅍㅔㅈㅣ	pʰed͡ʑi
ㄱㅓㄴㄷㅡㄹㅣㄷㅏ	kɘndɯɾida
ㅁㅗㅇㄱㅗㄹㅇㅓ	moŋɡoɾʌ
ㄴㅏㅅㅓㅇ	nasʰʌŋ
ㅅㅜㄱㅡㅂ	sʰuɡɯp̚
ㅇㅘㅇㄱㅏ	waŋɡa
ㅅㅓㅇㅊㅔㅅㅓㅇㅅㅏ	sʰɘŋt͡ɕʰesʰʌŋsʰa
ㅇㅓㅊㅣ	ʌt͡ɕʰi
ㅊㅏㄱㅇㅛㅇㅎㅏㄷㅏ	t͡ɕʰaɡjoŋɦada
ㅅㅓㄹㅠ	sʰʌɾju
ㄷㅗㅇㅇㅑㅇ	toŋjaŋ
ㄴㅐㄱㅏㅇ	nɛɡaŋ
ㅅㅡㄹㄱㅣㄹㅗㅂㄷㅏ	sʰɯɭɡiɾop̚ta
ㅇㅡㅁㅅㅓㅇ	ɯmsʰʌŋ
ㅅㅜㄴㅅㅓ	sʰunsʰʌ
ㅂㅜㄴㅅㅏ	punsʰa
ㄱㅡㄴㅕ	kɯɲjʌ
ㅇㅓㄹㅍㅣㅅ	ʌɭpʰit̚
ㄷㅓㅍㄷㅏ	tʌp̚ta
ㅂㅏㄴㅇㅡㅇ	panɯŋ
ㅂㅔㄹㄹㅏㄹㅜㅅㅡㅇㅓ	peɭɭaɾusʰɯʌ
ㄱㅡㄹㅓㅎㅈㅣㅁㅏㄴ	kɯɾʌt͡ɕʰiman
ㅌㅏㄴㅏㅌㅗㅅㅡ	tʰanatʰosʰɯ
ㅈㅓㄴㅈㅏㅇ	t͡ɕɘɲd͡ʑaŋ
ㅈㅏㅇㅠㄹ	t͡ɕajuɭ
ㅋㅗㄹㄹㅔㄹㅏ	kʰoɭɭeɾa
ㅇㅛㅇㅇㅣ	joŋi
ㅂㅏㄴㅁㅜㄹㅈㅣㄹ	panmuʎt͡ɕiɭ
ㅂㅓㅂㅇㅣㄴ	pʌbin
ㅇㅏㅂㄹㅗㄱㄱㅏㅇ	amnok̚kaŋ
ㅈㅏㄱㅇㅓㅂㅂㅗㄱ	t͡ɕaɡʌp̚pok̚
ㄴㅏㅁㅉㅗㄱ	namt͡ɕok̚
ㅂㅏㄷㅡㅅㅎㅏㄷㅏ	padɯtʰada
ㅈㅣㅈㅓㄱ	t͡ɕit͡ɕʌk̚
ㅈㅔㅈㅜ	t͡ɕed͡ʑu
ㅇㅣㄱㅅㅜㄱㅎㅏㄷㅏ	iksukʰada
ㅇㅗㄹㄹㅏㄱㅏㄷㅏ	oɭɭaɡada
ㅇㅕㄼㄷㅏ	jɘɭta
ㅁㅏㄴㅎㅏㄷㅏ	manɦada
ㅅㅗㅌ	sʰot̚
ㅈㅣㄴㅏㄷㅏ	t͡ɕinada
ㄷㅗㄱㅜ	toɡu
ㅇㅣㅅㄷㅏ	it̚ta
ㅎㅓㄴㅂㅓㅂ	hɘnpʌp̚
ㅈㅜㅇ	t͡ɕuŋ
ㅇㅛㅇㄱㅣ	joŋɡi
ㄱㅜㄹ	kuɭ
ㅌㅟㄱㅏㄱ	tʰɥiɡak̚
ㅁㅏㄹㄹㅏㅃㅏㅈㅣㄷㅏ	maɭɭapad͡ʑida
ㅎㅘㅇㅎㅗㄴ	ɸwaŋβon
ㅇㅜㅋㅡㄹㅏㅇㅣㄴㅏ	ukxɯɾaina
ㅇㅣㄹㅅㅏㅇ	iɭsʰaŋ
ㅅㅣㄱㄹㅛ	ɕʰiŋɲjo
ㅈㅣㄹ	t͡ɕiɭ
ㅁㅏㄹㄱㅓㅁㅓㄹㅣ	maɭɡʌmʌɾi
ㅇㅗㄴㅡㄹㄴㅏㄹ	onɯɭɭaɭ
ㄷㅐㅂㅕㄴ	tɛbjʌn
ㄷㅏㅇㄷㅏㅇㅎㅏㄷㅏ	taŋdaŋɦada
ㅁㅣㄴㄱㅏㅁ	minɡam
ㅁㅜㅇㅓ	muʌ
ㅍㅏㄹㄹㅏㄷㅠㅁ	pʰaɭɭadjum
ㅇㅠㄹㅠㄴ	juɾjun
ㅇㅖ	je
ㄱㅏㅇㄷㅗ	kaŋdo
ㅇㅏㄱㄷㅗㅇ	ak̚toŋ
ㅈㅏㄹㅁㅗㅅㄷㅚㄷㅏ	t͡ɕaɭmot̚tweda
ㅅㅡㅇㅎㅘ	sʰɯŋβwa
ㅍㅡㅌㅏㄹㄹㅏㅈㅣㄴ	pʰɯtʰaɭɭad͡ʑin
ㅇㅗㅁㅏㄴ	oman
ㅇㅣㄲㅣ	iki
ㅈㅓㅅㄱㅏㄹㅏㄱㅈㅣㄹ	t͡ɕʌt̚kaɾak̚t͡ɕiɭ
ㅁㅜㅅㅣㅎㅏㄷㅏ	muɕʰiɦada
ㄷㅗㄹㅈㅏㄴㅊㅣ	toʎd͡ʑaɲt͡ɕʰi
ㅅㅏㅊㅏㄹ	sʰat͡ɕʰaɭ
ㅊㅣㄹㅣ	t͡ɕʰiɾi
ㅂㅕ	pjʌ
ㅈㅣㅂㄱㅔ	t͡ɕip̚ke
ㅇㅣㄸㅏㄹㄹㅣㅇㅏ	itaʎʎia
ㅉㅏㅈㅏㅇㅁㅕㄴ	t͡ɕad͡ʑaŋmjʌn
ㅎㅘㄱㄹㅠㄹ	ɸwaŋɲjuɭ
ㄱㅜㅁㅜ	kumu
ㅌㅔㄹㄹㅔㅂㅣㅈㅛㄴ	tʰeɭɭebid͡ʑon
ㄷㅗㅇㅁㅜ	toŋmu
ㅍㅏㄹㄲㅜㅁㅊㅣ	pʰaɭkumt͡ɕʰi
ㅇㅘㄴㄷㅜ	wandu
ㄴㅣㄹ	niɭ
ㄱㅐㄴㅕㅁ	kɛɲjʌm
ㅂㅜㄹㅍㅗㅎㅘ	puɭpʰoβwa
ㄱㅡㅁㄱㅗ	kɯmɡo
ㅈㅓㄴㅁㅜㄴㅎㅘ	t͡ɕʌnmunβwa
ㄷㅗㅇ	toŋ
ㄲㅚㄲㅗㄹㅣ	kwekoɾi
ㄱㅜㄴㄱㅜㄱㅈㅜㅇㅢ	kunɡuk̚t͡ɕuɰi
ㅅㅓㅁㅜㄴ	sʰɘmun
ㅂㅗㅍㅕㄴㅈㅓㄱ	popʰjʌɲd͡ʑʌk̚
ㅈㅣㅂㄷㅡㄹㅇㅣ	t͡ɕip̚tɯɾi
ㅊㅔ	t͡ɕʰe
ㅎㅗㄱㅅㅣㄴㅏ	ɸʷokɕina
ㅇㅓㅂㅅㅣㄴㅇㅕㄱㅣㄷㅏ	ɘpɕinɲjʌɡida
ㅇㅕㅈㅓㅇ	jʌd͡ʑʌŋ
ㅈㅏㄴㅈㅓㅁㅂㅏㄱㅇㅣㅁㅜㄹㅂㅓㅁ	t͡ɕaɲd͡ʑʌmbaɡimuɭbʌm
ㄱㅛㅅㅣㄹ	kjoɕʰiɭ
ㄱㅞㄷㅗ	kwedo
ㄱㅚ	kwe
ㄱㅜㄹㅏㄱㅂㅜ	kuɾak̚pu
ㅎㅗㅁㅗㅍㅗㅂㅣㅇㅏ	ɸʷomopʰobia
ㄱㅡㄴㅡㄹ	kɯnɯɭ
ㅇㅕㄱㅣㅈㅓㄱㅣ	jʌɡid͡ʑʌɡi
ㅈㅓㄴㅕㄱㅂㅏㅂ	t͡ɕʌɲjʌk̚pap̚
ㄱㅏㄹㅕㅂㄷㅏ	kaɾjʌp̚ta
ㅌㅔㄴㅌㅡ	tʰentʰɯ
ㅊㅏㄱㄱㅏㄱ	t͡ɕʰak̚kak̚
ㅇㅖㄹㅔㅂㅏㄴ	jeɾeban
ㅇㅕㅇㅑ	jɘja
ㄹㅕ	ɾjʌ
ㄸㅗㄱㄸㅗㄱ	tok̚tok̚
ㄷㅐㅍㅗㄱㅈㅓㄱ	tɛpʰok̚t͡ɕʌk̚
ㄷㅏㄹㄹㅕㄱㅏㄷㅏ	taʎʎjʌɡada
ㅇㅠㄷㅗㄱㅎㅏㄷㅏ	judokʰada
ㅈㅡㅇㅎㅜㄱㅜㄴ	t͡ɕɯŋβuɡun
ㄱㅜㅇㅣㅂㅎㅏㄷㅏ	kuipʰada
ㅅㅣ	ɕʰi
ㄴㅏㄴㅅㅗ	nansʰo
ㅈㅏㅇㄴㅏㄴㄱㅏㅁ	t͡ɕaŋnankam
ㄱㅗㅅㅡㅁㄷㅗㅊㅣ	kosʰɯmdot͡ɕʰi
ㅁㅏㅇㅁㅏㄱ	maŋmak̚
ㅍㅜㅇㅂㅜ	pʰuŋbu
ㄱㅜㅊㅜㄱ	kut͡ɕʰuk̚
ㅎㅏㄱㅅㅏㄹ	haksaɭ
ㅇㅣㅀㄷㅏ	iɭtʰa
ㅇㅜㄹㅣㅈㅣㅂ	uɾid͡ʑip̚
ㅅㅓㅈㅏㅇ	sʰʌd͡ʑaŋ
ㅍㅗㄱㅂㅏㄹㅁㅜㄹ	pʰok̚paɭmuɭ
ㅊㅣㄹㅍㅏㄴ	t͡ɕʰiɭpʰan
ㅂㅏㅇㅇㅟㄱㅏㄱ	paŋɥiɡak̚
ㄹㅣㅇㅋㅡ	ɾiŋkxɯ
ㅅㅔㅇㅣㄴㅌㅡㄹㅜㅅㅣㅇㅏ	sʰeintʰɯɾuɕʰia
ㄱㅏㅇㅅㅔ	kaŋsʰe
ㅎㅓㄴ	hʌn
ㅊㅓㅇㄴㅕㄴ	t͡ɕʰʌŋɲjʌn
ㅎㅐㅈㅜ	hɛd͡ʑu
ㅇㅑㅇ	jaŋ
ㅁㅜㄹㄴㅗㄹㅇㅣㅈㅏㅇ	muɭɭoɾid͡ʑaŋ
ㅅㅓㄴㅂㅏㄱ	sʰʌnbak̚
ㄹㅣㅍㅗㅌㅡ	ɾipʰotʰɯ
ㅇㅗㄴㅁㅗㅁ	onmom
ㅁㅜㅁㅂㅏㅇㅣ	mumbai
ㅇㅠㄱㅅㅣㅂ	jukɕip̚
ㅇㅗㅁㅏㄴ	oman
ㅇㅜㄴㅈㅓㄴㄱㅣㅅㅏ	uɲd͡ʑʌnɡisʰa
ㄹㅣㄱㅏ	ɾiɡa
ㅊㅏㅂㅆㅏㄹ	t͡ɕʰapsaɭ
ㅆㅡㄹㄷㅔㅇㅓㅄㄷㅏ	sɯɭteʌp̚ta
ㅁㅏㄹㄹㅣㄷㅏ	maʎʎida
ㅌㅜㄹㅡ	tʰuɾɯ
ㅂㅡㄹㅏㅈㅏㅂㅣㄹ	pɯɾad͡ʑabiɭ
ㅈㅣㄴㄹㅏㅂ	t͡ɕiɭɭap̚
ㄱㅕㄹㅔ	kjʌɾe
ㄷㅏㅎㅏㄷㅏ	taɦada
ㅋㅏㅁㅔㄹㅏ	kʰameɾa
ㅅㅣㅂㅇㅠㄱ	ɕʰimɲjuk̚
ㅈㅓㅂㅜㄴ	t͡ɕʌbun
ㄱㅗㅃㅜ	kopu
ㅅㅓㄴㅁㅜㄹ	sʰɘnmuɭ
ㄸㅓㄹㅇㅓㄸㅡㄹㅣㄷㅏ	tʌɾʌtɯɾida
ㅍㅏㅌㅡㄴㅓ	pʰatʰɯnʌ
ㅈㅗㅁㅣㄹㅛ	t͡ɕomiɾjo
ㅈㅓㅂㄱㅗㄹ	t͡ɕʌp̚koɭ
ㅂㅓㄹㅣㄷㅏ	pʌɾida
ㅎㅏㄴㄱㅜㄱㅇㅣㄴ	hanɡuɡin
ㄴㅗㅍㄷㅏ	nop̚ta
ㅂㅏㄱㅁㅜㄹㄱㅘㄴ	paŋmuɭɡwan
ㅊㅏㅅㅈㅣㅂ	t͡ɕʰat̚t͡ɕip̚
ㅂㅏㅌㅔㄴㄷㅓ	patʰendʌ
ㅈㅓㅇ	t͡ɕʌŋ
ㅈㅜㄴㅂㅣㅎㅏㄷㅏ	t͡ɕunbiɦada
ㅁㅜㄹㅅㅗㄱ	muɭsok̚
ㄴㅗㄹㅇㅣㄱㅏㅁ	noɾiɡam
ㅇㅑㄱㄱㅜㄱ	jak̚kuk̚
ㅁㅜㄴㅈㅔ	muɲd͡ʑe
ㅁㅕㄴㅅㅔ	mjɘnsʰe
ㄱㅏㄹㅏㄱㅈㅣㅃㅏㅇ	kaɾak̚t͡ɕipaŋ
ㄲㅗㅊㅣㄱㅜㅇㅣ	kot͡ɕʰiɡui
ㅁㅜㅅㅏㅎㅏㄷㅏ	musʰaɦada
ㅁㅏㅇㅇㅕㄴ	maŋjʌn
ㅃㅕㅆ	pjʌt̚
ㅈㅗㅎㅕㄴㅂㅕㅇ	t͡ɕoʝjʌnbjʌŋ
ㅍㅔㄹㅔㅅㅡㅌㅡㄹㅗㅇㅣㅋㅏ	pʰeɾesʰɯtʰɯɾoikʰa
ㅁㅕㅇㅁㅕㅇㅂㅓㅂ	mjɘŋmjʌŋbʌp̚
ㄷㅏㅅㅜ	tasʰu
ㄷㅗㄱㄷㅗ	tok̚to
ㅎㅏㅂㅂㅓㅂㅎㅘㄷㅚㄷㅏ	hap̚pʌpʰwadweda
ㅊㅗㄱㅣ	t͡ɕʰoɡi
ㅅㅓㅇㅑㅇㅇㅣㄴ	sʰʌjaŋin
ㅍㅗㅇㅗㅇ	pʰooŋ
ㅇㅓㄹㅏㄴ	ʌɾan
ㅊㅐㅇㅛㅇㅎㅏㄷㅏ	t͡ɕʰɛjoŋɦada
ㅂㅜㅅㅜ	pusʰu
ㅍㅜㄱ	pʰuk̚
ㅂㅕㄴ	pjʌn
ㅁㅏㅌㄷㅏ	mat̚ta
ㅇㅔㄴㅈㅣㄴ	eɲd͡ʑin
ㅇㅣㅁㅏㅁ	imam
ㅇㅣㄹ	iɭ
ㅅㅏㅇㅣㄴ	sain
ㅈㅓㅇㅇㅝㄴ	t͡ɕʌŋwʌn
ㄸㅣ	ti
ㄱㅘㅇㅣㄹㄷㅏㄴㅁㅜㄹ	kwaiɭdanmuɭ
ㅇㅗㄹㅏㅇㅇㅜㅌㅏㄴ	oɾaŋutʰan
ㄷㅜㅂㅓㄹㅅㅣㄱ	tubʌɭɕʰik̚
ㅇㅓㄱㅏㄴ	ɘɡan
ㅇㅏㅈㅣㄱ	ad͡ʑik̚
ㅈㅓㄴㄹㅏㅁㅎㅚ	t͡ɕɘɭɭamβwe
ㅂㅜㄹㅇㅓ	puɾʌ
ㅎㅘㅊㅏㅇㅎㅏㄷㅏ	ɸwat͡ɕʰaŋɦada
ㅋㅗㄲㅣㄹㅣ	kʰokiɾi
ㄷㅟㅅㄱㅏㄴ	tɥit̚kan
ㅂㅏㅇㅅㅜ	paŋsʰu
ㄱㅜㅇㅅㅜ	kuŋsʰu
ㅈㅓㅇㅂㅜ	t͡ɕʌŋbu
ㅇㅑㄱㅅㅗㄱ	jaksok̚
ㄱㅝㄴㅇㅟㅈㅜㅇㅢ	kwʌnɥid͡ʑuɰi
ㅂㅜㅈㅔ	pud͡ʑe
ㅈㅓㅇㄱㅠ	t͡ɕʌŋɡju
ㅍㅡㄹㅗㅍㅏㄱㅣㄹ	pʰɯɾopʰaɡiɭ
ㅍㅏㄴㄷㅗ	pʰando
ㅁㅜㄴㅈㅏㅂㅏㄴ	muɲt͡ɕaban
ㄱㅏㄱㄱㅏㄱ	kak̚kak̚
ㅋㅗㅌㅗㄹㅔㅌㅏ	kʰotʰoɾetʰa
ㅋㅔㄹㅂㅣㄴ	kʰeɭbin
ㄱㅓㅅㅔ	kʌsʰe
ㄱㅗㅇㅅㅔ	koŋsʰe
ㅇㅚㅅㅏㅁㅊㅗㄴ	wesʰamt͡ɕʰon
ㄸㅡㅅ	tɯt̚
ㅇㅏㄹㄹㅏ	aɭɭa
ㅇㅑㅇㅁㅕㄴ	jaŋmjʌn
ㅁㅗㄱㄹㅕㄴ	moŋɲjʌn
ㅈㅓㄴㅅㅓㄹ	t͡ɕɘnsʰʌɭ
ㅎㅏㄹㅇㅏㅂㅓㅈㅣ	haɾabʌd͡ʑi
ㅈㅓㄴㅊㅏ	t͡ɕɘɲt͡ɕʰa
ㄴㅗㅁㅕㄴㅈㅓㄴㅊㅏ	nomjʌɲd͡ʑʌɲt͡ɕʰa
ㅇㅏㅊㅣㅁ	at͡ɕʰim
ㅍㅗㄱㅣㅎㅏㄷㅏ	pʰoɡiɦada
ㅁㅗㄱㅎㅘ	mokʰwa
ㄱㅛㅎㅘㄴ	kjoβwan
ㅇㅣㅇㅣㄱ	iik̚
ㅇㅗㅇ	oŋ
ㄱㅗㅅㅣㅇㅝㄴ	koɕʰiwʌn
ㅈㅓㅇㅊㅣㄱㅏ	t͡ɕʌŋt͡ɕʰiɡa
ㄱㅓㅇㅑ	kʌja
ㅅㅏㅇㅑㅇ	sʰajaŋ
ㅇㅝㄴㅈㅗ	wɘɲd͡ʑo
ㅋㅗㅅㅡ	kʰosʰɯ
ㅅㅓㄹㅠㅊㅓㄹ	sʰʌɾjut͡ɕʰʌɭ
ㅅㅓㄱㅟㅍㅗ	sʰʌɡɥipʰo
ㅂㅗㄴㅅㅓㅇ	ponsʰʌŋ
ㄱㅣㅅㅜㄹㅈㅏ	kisʰuʎt͡ɕa
ㅅㅜㄹㅣ	sʰuɾi
ㅂㅓㅂㄹㅏㅇㅈㅣㄹ	pʌmnaŋd͡ʑiɭ
ㄱㅡㅁㄴㅕㄴ	kɯmɲjʌn
ㅇㅏㅅ	at̚
ㅁㅏㄴㄴㅕㄴㅍㅣㄹ	manɲjʌnpʰiɭ
ㅁㅏㅁㅅㅗㄱ	mamsok̚
ㄱㅏㄹㅂㅏㅌㅈㅟ	kaɭbat̚t͡ɕɥi
ㅅㅓㄹㄱㅓㅈㅣㅎㅏㄷㅏ	sʰʌɭɡʌd͡ʑiɦada
ㅊㅏㅇㅈㅗㅈㅏ	t͡ɕʰaŋd͡ʑod͡ʑa
ㅈㅜㄱㅇㅡㅁ	t͡ɕuɡɯm
ㅂㅣㄹㅣㄷㅏ	piɾida
ㄱㅘㄴㅈㅏㄴㅗㄹㅇㅣ	kwaɲd͡ʑanoɾi
ㄱㅣㅁ	kim
ㅎㅘㄱㅇㅣㄴ	ɸwaɡin
ㅇㅝㄴㅅㅣ	wɘnɕʰi
ㅇㅡㅁㅍㅛ	ɯmpʰjo
ㅊㅚㄱㅏㅇ	t͡ɕʰweɡaŋ
ㅇㅖㅈㅓㄹ	jed͡ʑʌɭ
ㄱㅜㄱㅅㅏㄴ	kuksan
ㅊㅏㅇ	t͡ɕʰaŋ
ㅅㅓㄹㄱㅖ	sʰʌɭɡje
ㅎㅏㄴㄹㅠ	haʎʎju
ㅇㅡㅅㅡㄹㅡㅁㅎㅏㄷㅏ	ɯsʰɯɾɯmɦada
ㅅㅣㄴㅅㅣㅅㅏㅇㅣㅈㅓ	ɕʰinɕʰisʰaid͡ʑʌ
ㅅㅜㄱㅁㅕㅇ	sʰuŋmjʌŋ
ㅅㅗㅇㅇㅓ	sʰoŋʌ
ㄷㅐㅎㅘㅇㅇㅓ	tɛβwaŋʌ
ㄴㅏㅈㅊㅜㄷㅏ	nat̚t͡ɕʰuda
ㄹㅣㅌㅓ	ɾitʰʌ
ㅂㅗㄷㅣㅂㅣㄹㄷㅣㅇ	podibiɭdiŋ
ㄷㅓㅍㅇㅣㄷㅏ	tʌpʰida
ㄴㅜ	nu
ㅁㅏㄹㅊㅏ	maʎt͡ɕʰa
ㅅㅑㅁㅍㅜ	ɕʰampʰu
ㅇㅘㄴㄱㅗㄱㅎㅏㄷㅏ	wanɡokʰada
ㅁㅜㄲㄷㅏ	muk̚ta
ㅇㅑㅇㅂㅗㅇ	jaŋboŋ
ㅁㅗㅅㅎㅏㄷㅏ	motʰada
ㅎㅚㅇㅈㅓㄱ	ɸweŋt͡ɕʌk̚
ㄱㅡㄴㄱㅓ	kɯnɡʌ
ㅁㅜㄹㅁㅏㄴㄷㅜ	muɭmandu
ㅆㅗㄷㅇㅏㅈㅣㄷㅏ	sodad͡ʑida
ㄴㅏㄹㅅㅜㅁ	naɭsʰum
ㅇㅗㄹㅡㄱㅏㄴ	oɾɯɡan
ㅋㅗ	kʰo
ㅁㅓㅁㅜㄹㅡㄷㅏ	mʌmuɾɯda
ㄱㅓㄹㄹㅔ	kʌɭɭe
ㄱㅏㄱㅈㅜㄱㅜㄱㅓㅁ	kak̚t͡ɕuɡuɡʌm
ㅅㅏㄱㅗ	sʰaɡo
ㅂㅏㅇㅗㄹㅗ	paoɾo
ㅊㅕㅈㅜㄱㅇㅣㄷㅏ	t͡ɕʰʌd͡ʑuɡida
ㄴㅠㅇㅛㄱ	ɲjujok̚
ㅅㅏㄹㅕㅇㅂㅜ	sʰaɾjʌŋbu
ㄷㅗㄱㅇㅡㅁ	toɡɯm
ㅂㅣㅊ	pit̚
ㅈ	t͡ɕ
ㅇㅣㅇㅓ	iʌ
ㅇㅡㅁ	ɯm
ㄱㅗㅇㅈㅏ	koŋd͡ʑa
ㅎㅜㄴㅈㅔ	ɸʷuɲd͡ʑe
ㅅㅜㅅㅗㄱ	sʰusʰok̚
ㄷㅚㄴㅚㄷㅏ	twenweda
ㅂㅜㅌㅈㅏㅂㅎㅣㄷㅏ	put̚t͡ɕapʰida
ㅈㅣㄷㅏ	t͡ɕida
ㄹㅓㅂㅡㅎㅗㅌㅔㄹ	ɾʌbɯβotʰeɭ
ㄱㅣㅈㅣ	kid͡ʑi
ㄴㅗㄹㄹㅏㅇㅜㅁ	noɭɭaum
ㅇㅑㄷㅏㅇ	jadaŋ
ㅂㅓㄹ	pɘɭ
ㄱㅣㄷㅗㄱ	kidok̚
ㅂㅜㄺㄷㅏ	puk̚ta
ㅅㅓㅇㅅㅏ	sʰɘŋsʰa
ㅂㅏㅃㅡㄷㅏ	papɯda
ㅈㅔㄹㅗ	t͡ɕeɾo
ㄱㅣㄱㅗㅇ	kiɡoŋ
ㄴㅗㄹㄷㅏ	noɭda
ㅈㅣㄹㅜㅎㅏㄷㅏ	t͡ɕiɾuɦada
ㅇㅣㅂㅜㄹ	ibuɭ
ㅇㅓㄸㅓㄱㅎㅏㄷㅏ	ʌtʌkʰada
ㅇㅑㅇㅅㅓㅇㅈㅏ	jaŋsʰʌŋd͡ʑa
ㅅㅏㅇㅇㅓ	sʰaŋʌ
ㅇㅣㅇㅓㅇ	iʌŋ
ㅎㅏㅇㅣㄷㅡㄹㅏㅈㅗㄴ	haidɯɾad͡ʑon
ㄱㅣㄹㅣㄴ	kiɾin
ㅇㅣㄱㅁㅕㅇ	iŋmjʌŋ
ㅂㅜㅇㅇㅓ	puŋʌ
ㅍㅜㄹㅡㄷㅏ	pʰuɾɯda
ㄷㅗㅁㅏ	toma
ㄲㅐㅈㅣㄷㅏ	kɛd͡ʑida
ㄴㅣㅇㅡㄴ	niɯn
ㅇㅣㅌㅡㄹ	itʰɯɭ
ㅋㅏㅈㅣㄴㅗ	kʰad͡ʑino
ㅁㅓㅅㅇㅓㅄㄷㅏ	mʌdʌp̚ta
ㄱㅓㄴㄷㅏㄹ	kʌndaɭ
ㅅㅏㄱ	sʰak̚
ㅅㅣㄴㅅㅓㄴ	ɕʰinsʰʌn
ㅅㅣㄴㄱㅏㅇ	ɕʰinɡaŋ
ㄱㅘㅇㅎㅏㄱ	kwaŋɦak̚
ㄱㅖㅈㅓㄹㅈㅓㄱ	kjed͡ʑʌʎt͡ɕʌk̚
ㅂㅗㅅㅜㅈㅜㅇㅢ	posʰud͡ʑuɰi
ㅍㅕㄴㄷㅗ	pʰjʌndo
ㅁㅏㄹㅡㅌㅣㄴㅣㅋㅡ	maɾɯtʰinikxɯ
ㄴㅗㅌㅡ	notʰɯ
ㅈㅣㄱ	t͡ɕik̚
ㅇㅢㅈㅗㄴㅎㅏㄷㅏ	ɰid͡ʑonɦada
ㅊㅣㄴㄱㅡㄴㄱㅏㅁ	t͡ɕʰinɡɯnɡam
ㄴㅜㄹㅓㅎㄷㅏ	nuɾʌtʰa
ㅅㅏㄴㄱㅘ	sʰanɡwa
ㅊㅣㅁㅁㅜㄱㅎㅏㄷㅏ	t͡ɕʰimmukʰada
ㅇㅏㄹㅈㅔ	aʎd͡ʑe
ㄴㅏㅁㄱㅣㄷㅏ	namɡida
ㅈㅏㅇㅅㅗ	t͡ɕaŋsʰo
ㅈㅗㅁ	t͡ɕom
ㅇㅕㅇㅠ	jʌju
ㅂㅜㄷㅏㅁ	pudam
ㅇㅔㄹㅡㅂㅠㅁ	eɾɯbjum
ㅇㅕㄴㅇㅗㄱ	jɘnok̚
ㅈㅣㄱㅇㅝㄴ	t͡ɕiɡwʌn
ㅇㅜㄱ	uk̚
ㅅㅓㅅㅜㄹ	sʰɘsʰuɭ
ㅂㅜㄹㅎㅘ	puɾβwa
ㅋㅟㄴㅏㅈㅗㄹㄹㅣㄴ	kʰɥinad͡ʑoʎʎin
ㄸㅏㄴ	tan
ㅈㅓㄱㅇㅡㅇㄷㅗ	t͡ɕʌɡɯŋdo
ㅇㅓㅂㅓㅇㅣ	ʌbʌi
ㅁㅏㄴㅇㅑㄱ	maɲjak̚
ㅅㅜㅎㅏㄱㅈㅏ	sʰuɦak̚t͡ɕa
ㄱㅘㅈㅏㅇ	kwad͡ʑaŋ
ㅈㅏㅇㅅㅣ	t͡ɕaŋɕʰi
ㅂㅕㄹㅈㅏㄹㅣ	pjɘʎd͡ʑaɾi
ㄴㅏㅇㅣㅌㅣㅇㄱㅔㅇㅣㄹ	naitʰiŋɡeiɭ
ㅇㅣㅅㅏㅎㅏㄷㅏ	isʰaɦada
ㅅㅓㄴㅇㅣㄴㅈㅏㅇ	sʰʌniɲd͡ʑaŋ
ㅅㅣㄹㅁㅏㄹㅣ	ɕʰiɭmaɾi
ㄸㅡㄹㅣㄷㅏ	tɯɾida
ㅈㅜㅃㅕㅅㅈㅜㅃㅕㅅ	t͡ɕupjʌt̚t͡ɕupjʌt̚
ㅎㅏㄴ	han
ㅂㅜㅈㅓㅇㄱㅘㄴㅅㅏ	pud͡ʑʌŋɡwansʰa
ㅂㅜㄴㄹㅠㅎㅏㄱ	puʎʎjuɦak̚
ㅋㅗㅌㅗㄴㅜ	kʰotʰonu
ㅂㅏㅅㅈㅜㄹ	pat̚t͡ɕuɭ
ㅍㅣㄴㄹㅏㄴㄷㅡㅇㅓ	pʰiɭɭandɯʌ
ㄲㅜㄹ	kuɭ
ㅅㅜㄴㅇㅟ	sʰunɥi
ㅅㅣㄹㅣㅂ	ɕʰiɾip̚
ㅎㅏㄴㄱㅜㄱㅎㅏㄱ	hanɡukʰak̚
ㄴㅗㅇ	noŋ
ㅂㅗㄴㅂㅏㄷㄷㅏ	ponbat̚ta
ㅂㅜㄹㅔ	puɾe
ㅌㅜㄹㅡㅋㅡㅁㅔㄴㅣㅅㅡㅌㅏㄴ	tʰuɾɯkxɯmenisʰɯtʰan
ㅇㅏㅍㄷㅟ	ap̚tɥi
ㅍㅕㅇㅁㅣㄴ	pʰjʌŋmin
ㅅㅑㅆㅡ	ɕʰasɯ
ㄹㅗㅁㅏ	ɾoma
ㅈㅣㄴㅈㅜㅊㅡㅇ	t͡ɕiɲd͡ʑut͡ɕʰɯŋ
ㄱㅕㅂ	kjʌp̚
ㅂㅣㄷㅏㄴㅌㅓㄹㅈㅟ	pidantʰʌʎd͡ʑɥi
ㅇㅛㅇㄱㅘ	joŋɡwa
ㅈㅗㅇㅇㅏㄹㅣ	t͡ɕoŋaɾi
ㅅㅣㄱㅊㅗ	ɕʰik̚t͡ɕʰo
ㄱㅣㅂㅓㅂ	kipʌp̚
ㅈㅣㅌㅍㅜㄹㅡㄷㅏ	t͡ɕit̚pʰuɾɯda
ㄷㅏㅁㅇㅣㅁ	tamim
ㅇㅏㅇㅕㄴ	ajʌn
ㅍㅏㄴㄷㅏㄴㅎㅏㄷㅏ	pʰandanɦada
ㄷㅗㅇㅇㅢㅎㅏㄷㅏ	toŋɰiɦada
ㄱㅜㄴㅣㅎㅏㄷㅏ	kuniɦada
ㄷㅗㅇㅅㅓㅇ	toŋsʰʌŋ
ㄱㅜㅇㅕㄱㅈㅣㄹ	kujʌk̚t͡ɕiɭ
ㅁㅏㄴㅡㄹ	manɯɭ
ㅇㅓㄹㅆㅜ	ʌɭsu
ㄴㅏㅇㅏㄱㅏㄷㅏ	naaɡada
ㅇㅕㄹㄷㅗ	jʌɭto
ㄹㅔㅅㅡㅌㅗㄹㅏㅇ	ɾesʰɯtʰoɾaŋ
ㄸㅏㄷㅏ	tada
ㅂㅗㄹㅇㅣㄹ	poʎʎiɭ
ㅈㅡㅇㅇㅗㅅㅣㅁ	t͡ɕɯŋoɕʰim
ㄴㅏㅇㅣㅈㅣㄹㅣㅇㅏ	naid͡ʑiɾia
ㄱㅕㄱ	kjʌk̚
ㅅㅓㄴㅊㅏㅇ	sʰʌɲt͡ɕʰaŋ
ㄴㅡㄹㄹㅣㄷㅏ	nɯʎʎida
ㄱㅗㄷㅡㅇㅇㅓ	kodɯŋʌ
ㄱㅡㄹㅡㅅㄷㅚㄷㅏ	kɯɾɯt̚tweda
ㄷㅏㅌㅜㅁ	tatʰum
ㅇㅣㅅㅏ	isʰa
ㅁㅜㄹㅇㅡㅁ	muɾɯm
ㅎㅏㅂㅂㅓㅂㅎㅘ	hap̚pʌpʰwa
ㄱㅕㄱㄹㅣ	kjʌŋni
ㄷㅗㅇㅜㅁㅁㅏㄹ	toummaɭ
ㅂㅕㄱㄴㅏㄴㄹㅗ	pjʌŋnaɭɭo
ㄷㅏㄹㄹㅣ	taʎʎi
ㄱㅛㄱㅜ	kjoɡu
ㅊㅜㄱㅕㄱ	t͡ɕʰuɡjʌk̚
ㅇㅣㅂㅆㅏㄹ	ipsaɭ
ㅊㅣㅁㄹㅑㄱ	t͡ɕʰimɲjak̚
ㄷㅗㅎㅏ	toɦa
ㅍㅡㄹㅗㅇㅣㅅㅔㄴ	pʰɯɾoisʰen
ㅇㅓㄴㅈㅔㄴㄱㅏ	ɘɲd͡ʑenɡa
ㅁㅗㅅㅡㅋㅡㅂㅏ	mosʰɯkxɯba
ㅇㅘㄴㄹㅛ	waʎʎjo
ㅅㅣㅁㅔㄴㅌㅡ	ɕʰimentʰɯ
ㄹㅏㅁ	ɾam
ㄴㅗㅎㅘㄴ	noβwan
ㄱㅓㄹㅍㅣㅅㄱㅓㄹㅍㅣㅅ	kʌɭpʰit̚kʌɭpʰit̚
ㄱㅜㄴㅈㅜㄱㅜㄱ	kuɲd͡ʑuɡuk̚
ㄱㅕㅇㅎㅑㅇ	kjʌŋʝjaŋ
ㅇㅝㄴㅍㅗㄱ	wʌnpʰok̚
ㄹㅏㅇ	ɾaŋ
ㅇㅕㄴㅅㅗㄱ	jʌnsʰok̚
ㅁㅜㄴㅎㅘㅇㅓ	munβwaʌ
ㅇㅢㅂㅗㄱ	ɰibok̚
ㅊㅣㄺ	t͡ɕʰik̚
ㅇㅢㅅㅣㅁ	ɰiɕʰim
ㅎㅘㄱ	ɸwak̚
ㄸㅏㄹㅡㄷㅏ	taɾɯda
ㄷㅏㄺ	tak̚
ㅍㅏㄴㄱㅗㅇㅅㅣㄹ	pʰanɡoŋɕʰiɭ
ㅊㅓㄴㄹㅣㅇㅏㄴ	t͡ɕʰʌʎʎian
ㅈㅓㅇㄹㅣㅎㅏㄷㅏ	t͡ɕɘŋniɦada
ㅅㅗㄴㅂㅏㄷㅏㄱ	sʰonpadak̚
ㄱㅓㄹㅣ	kʌɾi
ㄴㅏㅁ	nam
ㄱㅗㅅㅗㅎㅏㄷㅏ	kosʰoɦada
ㅈㅡㄱㅅㅣ	t͡ɕɯkɕi
ㄴㅐㅇㅁㅕㄴ	nɛŋmjʌn
ㅅㅣㅂㅗㄱㅠㅁ	ɕʰiboɡjum
ㅇㅠㅈㅣㄴ	jud͡ʑin
ㅇㅏㅇㅣㄱㅗ	aiɡo
ㄱㅘ	kwa
ㅈㅜㅁㅓㄴㅣ	t͡ɕumʌni
ㅈㅜㄹ	t͡ɕuɭ
ㅈㅗㄹㅎㅗㄴ	t͡ɕoɾβon
ㅅㅣㄷㅣ	ɕʰidi
ㄴㅏㅅㄷㅏ	nat̚ta
ㅂㅜㄹㅠ	puɾju
ㅅㅡㅇ	sʰɯŋ
ㅁㅜㄴ	mun
ㄸㅣㄱㅓㄹㅇㅣ	tiɡʌɾi
ㅂㅏㄷㅏㅍㅛㅂㅓㅁ	padapʰjobʌm
ㅈㅏㄴㄱㅏㅅㅣㄱㅗㄱㅣ	t͡ɕanɡaɕʰiɡoɡi
ㄱㅠㅅㅗ	kjusʰo
ㅁㅏㄱㅜ	maɡu
ㅂㅓㅌㅣㄷㅏ	pʌtʰida
ㅂㅕㅇ	pjʌŋ
ㅈㅏㅅㅣㄴ	t͡ɕaɕʰin
ㄱㅓㅂㄴㅏㄷㅏ	kʌmnada
ㅇㅡㄴㅎㅏㄱㅖ	ɯnɦaɡje
ㅇㅏㄴㄴㅕㅇ	anɲjʌŋ
ㄸㅟㅇㅓㄴㅓㅁㄷㅏ	tɥiʌnʌmta
ㅅㅣㄱㅅㅏ	ɕʰiksa
ㅂㅏㄹㅏㅁㄷㅜㅇㅇㅣ	paɾamduŋi
ㅅㅣㄷㅗ	ɕʰido
ㅂㅡㄹㅏㄷㅓ	pɯɾadʌ
ㄱㅖㅁㅗ	kjemo
ㄱㅏㅁㅏㅊㅣ	kamat͡ɕʰi
ㄴㅏㄴㅅㅜ	nansʰu
ㅅㅏㄴㅏ	sʰana
ㄸㅗㅇㅇㅑㅇㅇㅣㄴ	toŋjaŋin
ㅂㅏㄴㅊㅏㄴ	paɲt͡ɕʰan
ㅅㅏㅁㅏㄱ	sʰamak̚
ㅇㅛㅎㅏㄷㅏ	joɦada
ㄷㅗㄱㄹㅣㅂㅅㅓㅇ	toŋnipsʌŋ
ㄱㅓㅈㅣㅅㅁㅏㄹ	kɘd͡ʑinmaɭ
ㅁㅏㄹㅡㅋㅗ	maɾɯkʰo
ㅌㅟㄴㅣㅅㅡ	tʰɥinisʰɯ
ㄱㅓㅁㅇㅕㄹ	kɘmɲjʌɭ
ㅈㅣㄴㅏㄱㅏㄷㅏ	t͡ɕinaɡada
ㅊㅡㄱ	t͡ɕʰɯk̚
ㄷㅗㄹㅁㅔㅇㅇㅣ	toɭmeŋi
ㅁㅗㄷㅜ	modu
ㄹㅏㅇㅣㅌㅓㄷㅗㄹ	ɾaitʰʌdoɭ
ㅈㅓㅇㄱㅜ	t͡ɕʌŋɡu
ㄸㅗㄱㄸㅗㄱㅇㅣ	tok̚toɡi
ㄱㅣㄹㄹㅣㅁ	kiʎʎim
ㅉㅣㅍㅜㄹㅣㄷㅏ	t͡ɕipʰuɾida
ㅈㅜㅇㅟ	t͡ɕuɥi
ㅇㅣㄹㅈㅓㅇㅎㅏㄷㅏ	iʎd͡ʑʌŋɦada
ㅁㅣㄲㅜㄹㅏㅈㅣ	mikuɾad͡ʑi
ㅊㅣㅇㅏㅇㅁㅏㅇㅣ	t͡ɕʰiaŋmai
ㅁㅐㅇㄹㅕㄹㅎㅏㄷㅏ	mɛŋɲjʌɾɦada
ㅁㅕㄴㅡㄹㅣ	mjʌnɯɾi
ㄱㅏㅌㅏㄴㅏ	katʰana
ㄱㅏㄹㅂㅣ	kaɭbi
ㅅㅓㄴㅓ	sʰʌnʌ
ㅇㅕㄴㄱㅜㅅㅗ	jʌnɡusʰo
ㅁㅓㄹㅉㅓㅇ	mʌʎt͡ɕʌŋ
ㅇㅢㅁㅜㄴ	ɰimun
ㅎㅏㅇㄱㅜ	haŋɡu
ㅊㅗㅇㅝㄴ	t͡ɕʰowʌn
ㄱㅛㅈㅓㄴ	kjod͡ʑʌn
ㄷㅜㄹㄹㅓㅂㅗㄷㅏ	tuɭɭʌboda
ㅈㅣㄴㄱㅗㅇㅊㅓㅇㅅㅗㄱㅣ	t͡ɕinɡoŋt͡ɕʰʌŋsʰoɡi
ㅇㅓㄴㅁㅜㄴ	ɘnmun
ㅎㅏㄴㅅㅓㅇ	hansʰʌŋ
ㄴㅏㄹㅏㄴㅎㅣ	naɾanʝi
ㅅㅣㄴㄷㅗ	ɕʰindo
ㄷㅏㄹㅎㅏㄷㅏ	taɾɦada
ㄱㅏㄱㅈㅏ	kak̚t͡ɕa
ㄴㅏㅇㅣㅌㅡ	naitʰɯ
ㅊㅗㅋㅗㄹㄹㅣㅅ	t͡ɕʰokʰoʎʎit̚
ㅈㅗㄱㅓㄴ	t͡ɕokʌn
ㅂㅜㄹㅓㅈㅣㄷㅏ	puɾʌd͡ʑida
ㄱㅕㄹㅈㅓㅇㄷㅚㄷㅏ	kjʌʎt͡ɕʌŋdweda
ㅎㅏㅇㄱㅗㅇㄱㅣ	haŋɡoŋɡi
ㅇㅑㄱㅇㅓ	jaɡʌ
ㅅㅑㅇㅝ	ɕʰawʌ
ㅁㅣㅌㅜㄹㅣ	mitʰuɾi
ㅎㅓㄹ	hʌɭ
ㅌㅟㄴㅣㅈㅣ	tʰɥinid͡ʑi
ㅎㅏㅇㅣㅍㅓㄹㅣㅇㅋㅡ	haipʰʌɾiŋkxɯ
ㅌㅗㅇㄱㅡㄴㅎㅏㄷㅏ	tʰoŋɡɯnɦada
ㅇㅢㅈㅣㅎㅏㄷㅏ	ɰid͡ʑiɦada
ㅎㅜㅋㅜㅅㅣㅁㅏ	ɸʷukʰuɕʰima
ㄱㅡㄹㄲㅗㄹ	kɯɭkoɭ
ㅇㅕㅇㅇㅝㄴㅎㅣ	jɘŋwʌnʝi
ㅅㅜㄱㅊㅟ	sʰuk̚t͡ɕʰɥi
ㅇㅗㅌㅗㅂㅏㅇㅣ	otʰobai
ㅅㅜㅇㅓㅂ	sʰuʌp̚
ㄹㅔㅇㅟㄱㅣ	ɾeɥiɡi
ㅂㅗㄲㅇㅣ	poki
ㅇㅖㅂㅏㅇ	jebaŋ
ㅎㅏㄱㅎㅚ	hakʰwe
ㅎㅐㄱㅕㄹ	hɛɡjʌɭ
ㅎㅘㄴㅅㅗㅇㅎㅏㄷㅏ	ɸwansʰoŋɦada
ㅎㅗㅅㅜㅅㄱㅏ	ɸʷosʰut̚ka
ㅂㅜㄱㅈㅗㅅㅓㄴ	puk̚t͡ɕosʰʌn
ㄱㅏㅇㄱㅏㄴ	kaŋɡan
ㅂㅗㄱㅇㅛㅇㄹㅑㅇ	poɡjoŋɲjaŋ
ㅍㅏㅅㅡㅌㅏ	pʰasʰɯtʰa
ㅇㅕㅅㅓㅇ	jʌsʰʌŋ
ㅇㅘㅇㄱㅜㄱ	waŋɡuk̚
ㅂㅏㅇㅅㅗㅇㅇㅝㄴ	paŋsʰoŋwʌn
ㅇㅣㄹㅔ	iɾe
ㅅㅚㄱㅣㄹㅓㄱㅣ	sʰweɡiɾʌɡi
ㅍㅜㄹㅁㅜ	pʰuɭmu
ㅌㅡㄹㅗㅍㅣ	tʰɯɾopʰi
ㅁㅣㅂㅜㄴ	mibun
ㅇㅢㅇㅕㄴㄱㅡㅁ	ɰijʌnɡɯm
ㅇㅕㅇㅘ	jʌwa
ㅂㅣㄴㅁㅣㄴㄱㅜㄹ	pinminɡuɭ
ㅎㅓㅂㅡㅌㅣ	hʌbɯtʰi
ㅇㅣㄴㄱㅡㄴ	inɡɯn
ㅈㅓㄴㄷㅗㅅㅏ	t͡ɕʌndosʰa
ㄱㅣㅁㅣㄴㅎㅏㄷㅏ	kiminɦada
ㄷㅗㅈㅏㄱㅣ	tod͡ʑaɡi
ㄴㅏㅇㅣㄹㅌㅣㄹㄹㅏㅍㅣㅇㅏ	naiɭtʰiɭɭapʰia
ㄷㅜㄴㅊㅣㄷㅏ	tuɲt͡ɕʰida
ㅌㅡㄱㅅㅓㅇ	tʰɯksʌŋ
ㄷㅜㅅㅑㄴㅂㅔ	tuɕʰanbe
ㅇㅏㄴㅁㅗㄱ	anmok̚
ㅂㅣㅈㅏㄴㅌㅣㅇㅜㅁ	pid͡ʑantʰium
ㅈㅏㄱㅇㅡㄴㄷㅜㄲㅓㅂㅣ	t͡ɕaɡɯndukʌbi
ㄱㅏㄴㅍㅏㄴ	kanpʰan
ㅎㅡㄹㄹㅓㄴㅏㅇㅗㄷㅏ	xɯɭɭʌnaoda
ㅂㅏㄹㄲㅡㅌ	paɭkɯt̚
ㅂㅜㄹㄱㅠㅊㅣㄱㅎㅏㄷㅏ	puɭɡjut͡ɕʰikʰada
ㅂㅜㅇㅣㄴ	puin
ㅁㅣㄷㅇㅡㅁ	midɯm
ㅊㅔㅍㅗㅎㅏㄷㅏ	t͡ɕʰepʰoɦada
ㅅㅗㄴㅅㅜㄱㅓㄴ	sʰonsuɡʌn
ㅁㅣㄹㅇㅝㄹ	miɾwʌɭ
ㅅㅗㅅㅣㄱ	sʰoɕʰik̚
ㄱㅏㅁㅇㅕㅁ	kamjʌm
ㅁㅕㄴㅍㅗ	mjʌnpʰo
ㅎㅡㄴㅡㄲㅣㄷㅏ	xɯnɯkida
ㅇㅘㄱㅈㅏㅈㅣㄲㅓㄹㅎㅏㄷㅏ	wak̚t͡ɕad͡ʑikʌɾɦada
ㄱㅗㄻㄷㅏ	komta
ㅍㅕㄴㅈㅣ	pʰjɘɲd͡ʑi
ㄷㅐㄹㅑㄱ	tɛɾjak̚
ㄱㅖㅂㅜ	kjebu
ㅂㅓㅂㄱㅘㄴ	pʌp̚kwan
ㄷㅡㄹㄹㅕㅇㅗㄷㅏ	tɯʎʎjʌoda
ㅈㅡㅇㄱㅣ	t͡ɕɯŋɡi
ㅇㅏㄴㅎㅟ	anɦɥi
ㅌㅗㅇㅈㅣ	tʰoŋd͡ʑi
ㅇㅣㄴㅎㅕㅇ	inʝjʌŋ
ㅅㅣㅌㅗㅎㅚ	ɕʰitʰoβwe
ㅇㅠㅈㅚ	jud͡ʑwe
ㅅㅗㄱㅜㄹ	sʰoɡuɭ
ㅈㅏㅇㄴㅚ	t͡ɕaŋnwe
ㅈㅗㅇㅛㅇㅎㅏㄷㅏ	t͡ɕojoŋɦada
ㅍㅣㄹㅎㅚㄱ	pʰiɾβwek̚
ㅈㅓㄴㄷㅗ	t͡ɕʌndo
ㅋㅡㄹㅣㅅㅡㅁㅏㅅㅡ	kxɯɾisʰɯmasʰɯ
ㄱㅗㄹㅕㅎㅏㄷㅏ	koɾjʌɦada
ㅇㅠㄱㄱㅏㄱㅅㅜ	juk̚kaksu
ㅇㅣㅈㅎㅣㄷㅏ	it͡ɕʰida
ㄱㅘㄱㅓㅎㅕㅇ	kwaɡʌʝjʌŋ
ㅊㅘㄹㅇㅕㅇ	t͡ɕʰwaɾjʌŋ
ㅇㅜㅍㅕㄴㅂㅓㄴㅎㅗ	upʰjʌnbʌnβo
ㅎㅐㅅㅓㄱㅎㅏㄷㅏ	hɛsʰʌkʰada
ㅅㅏ	sʰa
ㅁㅓㄱㅁㅜㄹ	mʌŋmuɭ
ㅅㅓㅇㅊㅔ	sʰɘŋt͡ɕʰe
ㅅㅗㅂㅣㅇㅔㅌㅡ	sʰobietʰɯ
ㅇㅛㅇㅣㄹ	joiɭ
ㄷㅜㄹㅕㅇㅜㅁ	tuɾjʌum
ㄸㅓㅇㅗㄹㄹㅣㄷㅏ	tʌoʎʎida
ㄷㅡㄱㄷㅗ	tɯk̚to
ㅇㅓㄸㅓㅎㅏㄷㅏ	ʌtʌɦada
ㅇㅔㄱㅔ	eɡe
ㅅㅓㄴㅂㅣ	sʰʌnbi
ㅈㅗㄷㅗㅇㅅㅏ	t͡ɕodoŋsʰa
ㅈㅓㄱㅗㅅ	t͡ɕʌɡot̚
ㅁㅕㅇㅈㅓㄹ	mjʌŋd͡ʑʌɭ
ㅁㅗㄱㅜㄱㅇㅓ	moɡuɡʌ
ㅍㅗㄱㄱㅜㄴ	pʰok̚kun
ㅇㅣㅁㅗㅈㅣ	imod͡ʑi
ㅂㅗㅁㅜㄹ	pomuɭ
ㅇㅔㅍㅣㅅㅗㄷㅡ	epʰisʰodɯ
ㄱㅓㄷㅡㅂㅎㅗㄹㅅㅗㄹㅣ	kʌdɯpʰoɭsʰoɾi
ㅂㅣㅊㄲㅏㄹ	pit̚kaɭ
ㅈㅏㄱㄱㅗㄱㄱㅏ	t͡ɕak̚kok̚ka
ㅁㅔㅅㅓㄷㅡ	mesʰʌdɯ
ㅍㅏㄹㅂㅏㅇㅁㅣㅇㅣㄴ	pʰaɭbaŋmiin
ㅊㅏ	t͡ɕʰa
ㅅㅚㄷㅟㅈㅟ	sʰwedɥid͡ʑɥi
ㅁㅏㅇ	maŋ
ㅅㅏㄹㅊㅣ	sʰaʎt͡ɕʰi
ㅂㅜㅅㅡㄹㅓㄱㅣ	pusʰɯɾʌɡi
ㄱㅓㅁㅏㄴㅎㅏㄷㅏ	kɘmanɦada
ㅈㅡㅇㅅㅓㄹ	t͡ɕɯŋsʰʌɭ
ㅋㅓㅂㅡ	kʰʌbɯ
ㄱㅏㅁㅈㅓㅇ	kamd͡ʑʌŋ
ㅌㅓㅂㅠㅁ	tʰʌbjum
ㄹㅔㅇㅟㄴㅣㅇㅗㅇ	ɾeɥinioŋ
ㅌㅔㅇㅣㅂㅡㄹ	tʰeibɯɭ
ㄱㅡㄹㅔㄴㅏㄷㅏ	kɯɾenada
ㅈㅏㅁㅂㅣㅇㅏ	t͡ɕambia
ㄱㅐㄴㅏㄹㅣㄲㅗㅊ	kɛnaɾikot̚
ㄷㅡㅇㅂㅏㄴ	tɯŋban
ㅁㅏㄱㅂㅜ	mak̚pu
ㅁㅣㄹㅈㅓㅂㅎㅏㄷㅏ	miʎt͡ɕʌpʰada
ㅈㅜㅇㅓㅈㅣㄷㅏ	t͡ɕuʌd͡ʑida
ㄷㅏㄺㅅㅏㄹ	taksaɭ
ㅊㅓㄴㅁㅏㄴ	t͡ɕʰʌnman
ㅍㅜㄹㄷㅏ	pʰuɭda
ㅅㅠㅌㅡ	ɕʰutʰɯ
ㅍㅕㄲ	pʰjʌk̚
ㅇㅣㄴㅇㅝㄴ	inwʌn
ㅅㅗㄱㅂㅗ	sʰok̚po
ㅈㅓㄴㅇㅏㅂ	t͡ɕɘnap̚
ㅍㅔㄴㅣ	pʰeni
ㅅㅡㄹㅍㅡㄷㅏ	sʰɯɭpʰɯda
ㅍㅡㄹㄹㅜㅇㅗㄹㅔㄴ	pʰɯɭɭuoɾen
ㅅㅜ	sʰu
ㄷㅗㅇㅅㅣ	toŋɕʰi
ㅂㅜㄹㄹㅑㅇ	puʎʎjaŋ
ㄱㅏㅅㅣㄱㅗㄱㅣ	kaɕʰiɡoɡi
ㅈㅔㄱㅘㅈㅓㅁ	t͡ɕeɡwad͡ʑʌm
ㄱㅗㄱ	kok̚
ㅇㅓㅁㅓㄴㅏ	ɘmʌna
ㅅㅔㅇ	sʰeŋ
ㅂㅜㄹㅡㅁ	puɾɯm
ㄱㅏㅇㄷㅏㅇ	kaŋdaŋ
ㅇㅓㅇㅇㅓㅇ	ʌŋʌŋ
ㅇㅗㅌㅡㅁㅣㄹ	otʰɯmiɭ
ㅈㅓㄱㄱㅡㄱ	t͡ɕʌk̚kɯk̚
ㄱㅗㅁㅣㄴㅎㅏㄷㅏ	kominɦada
ㄱㅣㅇㅓㅂㅇㅣㄴ	kiʌbin
ㄷㅏㄴ	tan
ㅇㅏㄹㅋㅗㅇㅗㄹ	aɭkʰooɭ
ㅂㅜㄷㅣㅈㅎㅣㄷㅏ	pudit͡ɕʰida
ㅇㅟㄱㅅㅕㄴㅓㄹㅣ	ɥikɕʌnʌɾi
ㅇㅡㄴ	ɯn
ㄷㅗㅇㄱㅣ	toŋɡi
ㅍㅕㄴㅈㅣㅂㅎㅏㄷㅏ	pʰjʌɲd͡ʑipʰada
ㅇㅡㄴㅎㅏㅅㅜ	ɯnɦasʰu
ㅊㅣㄹㄹㅣ	t͡ɕʰiʎʎi
ㅂㅔㄹㅡㄹㄹㅣㄴ	peɾɯʎʎin
ㄱㅏㅂㅇㅗㅅ	kabot̚
ㅇㅣㅇㅝㄹ	iwʌɭ
ㅈㅣㅂ	t͡ɕip̚
ㄴㅜㄴㅅㅗㅇㅇㅣ	nunsoŋi
ㄱㅐㄲㅜㅁ	kɛkum
ㅍㅡㄹㅔㅈㅔㄴㅌㅔㅇㅣㅅㅕㄴ	pʰɯɾed͡ʑentʰeiɕʰʌn
ㅈㅓㅇㄷㅏㅇ	t͡ɕʌŋdaŋ
ㅋㅓㅌㅡㄴ	kʰʌtʰɯn
ㅂㅏㄷㅏㅅㅏㅈㅏ	padasʰad͡ʑa
ㅇㅜㅈㅓㅇ	ud͡ʑʌŋ
ㅅㅜㄹㅏ	sʰuɾa
ㅎㅏㄴㄷㅗ	hando
ㅈㅡㅇㅅㅏㅇ	t͡ɕɯŋsʰaŋ
ㅅㅣㄴㅈㅏㅇ	ɕʰiɲd͡ʑaŋ
ㅁㅓㄹㅣㅌㅗㅇ	mʌɾitʰoŋ
ㄱㅗㅍㅡㄷㅏ	kopʰɯda
ㅇㅡㅇㄱㅏ	ɯŋɡa
ㄱㅘㅂㅜ	kwabu
ㅇㅓㅇㅝㄴㅎㅏㄱ	ɘwʌnɦak̚
ㄹㅠㅇㅡㅁ	ɾjuɯm
ㅂㅜㄹㄱㅜㄹ	puɭɡuɭ
ㅆㅏㄹ	saɭ
ㅈㅏㄹㅣ	t͡ɕaɾi
ㅅㅡㄹㄹㅗㄱㅓㄴ	sɯɭɭoɡʌn
ㄱㅡㄴㅊㅓ	kɯɲt͡ɕʰʌ
ㅍㅗㅇㅣㄴㅌㅡ	pʰointʰɯ
ㅇㅑㄱㅈㅏ	jak̚t͡ɕa
ㅅㅓㄼㄷㅏ	sʰɘɭta
ㅇㅏㄴㄹㅏㄱㅅㅏ	aɭɭaksa
ㄱㅏㄹㄱㅗㄹㅏㅇㅇㅣ	kaɭɡoɾaŋi
ㅅㅣㄴㅈㅏㅇ	ɕʰiɲd͡ʑaŋ
ㅍㅣㄷㅏ	pʰida
ㄱㅡㄹㅓㅁㅕㄴ	kɯɾʌmjʌn
ㅁㅗㅇㅡㅁ	moɯm
ㅂㅜㄷㄷㅏ	put̚ta
ㅁㅏㅈㅇㅣㅎㅏㄷㅏ	mad͡ʑiɦada
ㅇㅓㄴㄴㅣ	ʌnni
ㅇㅕㅇㅈㅓㄱ	jʌŋt͡ɕʌk̚
ㅈㅏㅁㅅㅣ	t͡ɕamɕʰi
ㅂㅜㄱㅉㅓㅇ	puk̚t͡ɕʌŋ
ㅁㅗㅊㅣㅁㅏㅇㄷㅜㄱ	mot͡ɕʰimaŋduk̚
ㅈㅗㅇㄷㅏㄹㅣ	t͡ɕoŋdaɾi
ㅆㅡㄹㅔㄱㅣ	sɯɾeɡi
ㅇㅣㄹㅝㅈㅣㄷㅏ	iɾwʌd͡ʑida
ㅌㅜㅂㅏㄹㄹㅜ	tʰubaɭɭu
ㅇㅕㅇㅈㅏㅍㅏㄹㅂㅓㅂ	jʌŋd͡ʑapʰaɭbʌp̚
ㅇㅛㅋㅡㅅㅕ	jokxɯɕʰʌ
ㅇㅕㅇㅎㅑㅇㄹㅕㄱ	jɘŋʝjaŋɲjʌk̚
ㅈㅓㅇㅇㅡㄴ	t͡ɕɘŋɯn
ㅂㅜㅌㅇㅣㅁㅍㅛ	put͡ɕʰimpʰjo
ㅇㅏㅇㅣㅍㅗㄴ	aipʰon
ㄱㅏㅇㅅㅜㄹㅑㅇ	kaŋsʰuɾjaŋ
ㅁㅏㅅㅈㅣㅂ	mat̚t͡ɕip̚
ㅃㅔㅁ	pem
ㅇㅓㄴㄷㅓㄱ	ʌndʌk̚
ㅇㅕㅇ	jʌŋ
ㅉㅓㄱㄷㅏ	t͡ɕʌk̚ta
ㅌㅗㅇㅎㅘ	tʰoŋβwa
ㅊㅏㅇㅈㅏ	t͡ɕʰaŋd͡ʑa
ㅁㅏㄴㄴㅡㅇ	mannɯŋ
ㅈㅣㅁㅕㅇㅎㅏㄱ	t͡ɕimjʌŋɦak̚
ㅂㅐ	pɛ
ㄱㅡㅁㅈㅣ	kɯmd͡ʑi
ㄱㅓㅁㄷㅜㅇㅇㅣ	kʌmduŋi
ㅂㅏㄴㅁㅕㄴ	panmjʌn
ㄹㅔㅇㅣㄹ	ɾeiɭ
ㅆㅏㅇㄱㅗㄱㅅㅓㄴ	saŋɡoksʌn
ㅇㅏㅇㅣㄴㅜㅇㅓ	ainuʌ
ㅇㅣㅇㅜㅅ	iut̚
ㅈㅓㅂㅈㅓㄴ	t͡ɕʌp̚t͡ɕʌn
ㅉㅗㅊㄷㅏ	t͡ɕot̚ta
ㅎㅚㅇㅝㄴ	ɸwewʌn
ㅅㅐㅇㅈㅟ	sʰɛŋd͡ʑɥi
ㄴㅏㅂㅈㅏㄱㅎㅏㄷㅏ	nap̚t͡ɕakʰada
ㅃㅔㅇ	peŋ
ㅇㅟㅇㅡㅁㅅㅓㅇ	ɥiɯmsʰʌŋ
ㅈㅏㅅㅔ	t͡ɕasʰe
ㅍㅕㅇㄱㅏ	pʰjɘŋka
ㄲㅗㅊㅣ	kot͡ɕʰi
ㅇㅘㅇㄱㅘㄴ	waŋɡwan
ㅅㅣㄴㅇㅢㅈㅜ	ɕʰinɰid͡ʑu
ㄱㅜㅅㅓㅇㄷㅚㄷㅏ	kusʰʌŋdweda
ㅅㅣㄹㅓㅂ	ɕʰiɾʌp̚
ㄱㅏㄹㄱㅗㄹㅣ	kaɭɡoɾi
ㅍㅏㄹㅏㅇ	pʰaɾaŋ
ㅇㅛㅎㅏㄴ	joɦan
ㄱㅗㅇㄱㅏㄹㅊㅣㄷㅏ	koŋɡaʎt͡ɕʰida
ㅍㅛㅈㅣㅍㅏㄴ	pʰjod͡ʑipʰan
ㄴㅗㅅㅜㄱㅎㅏㄷㅏ	nosʰukʰada
ㅌㅜㄱㅣ	tʰuɡi
ㄱㅗㄴㅣ	koni
ㅇㅏㅅㅜㄴㅅㅣㅇㅗㄴ	asʰunɕʰion
ㅁㅜㄹㄷㅏ	muɭda
ㅊㅣㄹㅅㅣㅂ	t͡ɕʰiɭɕip̚
ㅁㅣㅅㅗㅈㅣㅅㄷㅏ	misʰod͡ʑit̚ta
ㅇㅡㅇㄱㅕㄹ	ɯŋɡjʌɭ
ㅇㅑㅋㅜㅊㅡㅋㅡ	jakʰut͡ɕʰɯkxɯ
ㄴㅗㄹㅡㄴㅈㅏ	noɾɯɲd͡ʑa
ㅇㅓㅁㄱㅕㄱㅎㅏㄷㅏ	ʌmkjʌkʰada
ㅈㅣㄱㅕㅇ	t͡ɕiɡjʌŋ
ㅂㅓㄹㅡㅅ	pʌɾɯt̚
ㅠ	ju
ㄱㅜㄷㅡㄹ	kudɯɭ
ㅊㅏㅈㅇㅏㅇㅗㄷㅏ	t͡ɕʰad͡ʑaoda
ㅂㅏㄹㅠㅁ	paɾjum
ㅊㅓㄴㅅㅏ	t͡ɕʰʌnsʰa
ㅎㅘㅅㅏㄹㅍㅛ	ɸwasʰaɭpʰjo
ㄲㅗㅊㅂㅗㅇㅇㅗㄹㅣ	kot̚poŋoɾi
ㅇㅓㄹㅣㄴㅇㅣㅈㅣㅂ	ʌɾinid͡ʑip̚
ㅍㅗㅋㅓ	pʰokʰʌ
ㅇㅖㅅㅜ	jesʰu
ㅍㅏㄱㅚ	pʰaɡwe
ㅎㅓㅁ	hʌm
ㅂㅐㅂㅏㄴ	pɛban
ㅅㅏㄱㅟㄷㅏ	sʰaɡɥida
ㅂㅓㅂ	pʌp̚
ㅊㅣㄴㅅㅏㅁㅊㅗㄴ	t͡ɕʰinsʰamt͡ɕʰon
ㄷㅏㅇㄱㅡㄴ	taŋɡɯn
ㄱㅗㅇㅅㅣㄱㅇㅓ	koŋɕʰiɡʌ
ㄸㅐㄹㄴㅏㅁㅜ	tɛɭɭamu
ㄹㅏㄴㅈㅔㄹㅣ	ɾaɲd͡ʑeɾi
ㄱㅡㄹㅣㅁ	kɯɾim
ㅈㅏㅈㅓㄴㄱㅓ	t͡ɕad͡ʑʌnɡʌ
ㄱㅏㅊㅣㄱㅘㄴ	kat͡ɕʰiɡwan
ㅇㅏㄹㅈㅔㄹㅣ	aʎd͡ʑeɾi
ㅂㅏㄴㅜㅇㅏㅌㅜ	panuatʰu
ㅇㅢㅅㅓㅇㅇㅓ	ɰisʰʌŋʌ
ㅇㅏㄴㄷㅡㄹㅔㅇㅣ	andɯɾei
ㅇㅜㄹㅔ	uɾe
ㅇㅓㅂㅜ	ʌbu
ㅇㅑㅇㅉㅗㄱ	jaŋt͡ɕok̚
ㄴㅐㅇㄷㅗㅇㄱㅗ	nɛŋdoŋɡo
ㅊㅔㅊㅔㄴㅇㅓ	t͡ɕʰet͡ɕʰenʌ
ㅇㅛㄱㅅㅣㅁ	jokɕim
ㅍㅏㅇㅏㄱㅎㅏㄷㅏ	pʰaakʰada
ㅎㅡㄱ	xɯk̚
ㅁㅓㄹㅣㅎㅏㄷㅏ	mʌɾiɦada
ㅇㅏㄱㅁㅏ	aŋma
ㅈㅓㅇㅊㅣㅈㅣㄹ	t͡ɕʌŋt͡ɕʰid͡ʑiɭ
ㅂㅜㄱㅂㅏㅇㅎㅢㄴㅃㅑㅁㅇㅗㄹㅣ	puk̚paŋʝinpjamoɾi
ㅅㅗㅂㅣㅎㅏㄷㅏ	sʰobiɦada
ㄱㅗㄱㅊㅏㅇ	kok̚t͡ɕʰaŋ
ㅅㅓㄱㄱㅘㄴ	sʰʌk̚kwan
ㅍㅕㅇㅊㅏㅇ	pʰjʌŋt͡ɕʰaŋ
ㅆㅏㄴㄹㅜㄴㅊㅓ	saɭɭuɲt͡ɕʰʌ
ㅅㅏㅎㅚㅈㅓㄱ	sʰaβwed͡ʑʌk̚
ㅇㅓㅉㅓㄷㅏ	ʌt͡ɕʌda
ㅁㅜㄹㅇㅓㄸㅡㄷㄷㅏ	muɾʌtɯt̚ta
ㅅㅜㄷㅏㄸㅓㄹㄷㅏ	sʰudatʌɭda
ㅈㅔㅎㅘ	t͡ɕeβwa
ㅂㅜㄴㅏㅁ	punam
ㅁㅣㄹㅊㅣㄷㅏ	miʎt͡ɕʰida
ㅈㅏㅅㅗㄴ	t͡ɕasʰon
ㅊㅗㄹㅗㄱ	t͡ɕʰoɾok̚
ㅈㅐㅇㅑㄷㅏㅇ	t͡ɕɛjadaŋ
ㄱㅣㅂㅜㄴ	kibun
ㅊㅗㅇ	t͡ɕʰoŋ
ㅎㅏㄴㅁㅣㄴㅈㅗㄱ	hanmiɲd͡ʑok̚
ㅇㅠㄱㅗㅅㅡㄹㄹㅏㅂㅣㅇㅏ	juɡosʰɯɭɭabia
ㅇㅣㅇ	iŋ
ㅁㅓㅇㅊㅓㅇㅇㅣ	mʌŋt͡ɕʰʌŋi
ㅂㅕㅇㅅㅏ	pjʌŋsʰa
ㄲㅡㄹㄷㅏ	kɯɭda
ㅈㅣㄹㅣㅎㅏㄱ	t͡ɕiɾiɦak̚
ㄱㅗㅇㅅㅜㄷㅗ	koŋsʰudo
ㅇㅗㄱㅌㅗ	ok̚tʰo
ㅂㅜㄺㅇㅡㄴㄱㅏㅅㅡㅁㅎㅢㄴㅈㅜㄱㅈㅣ	puɭɡɯnɡasʰɯmʝiɲd͡ʑuk̚t͡ɕi
ㅂㅜㅁㅗㄴㅣㅁ	pumonim
ㄱㅐㅊㅔ	kɛt͡ɕʰe
ㅌㅡㄹㄹㅣㄷㅏ	tʰɯʎʎida
ㅅㅏㄴㅅㅓ	sʰansʰʌ
ㅅㅏㄹㅉㅣㅇㅜㄷㅏ	sʰaʎt͡ɕiuda
ㄲㅏㅂㅜㄹㄷㅏ	kabuɭda
ㅂㅏㅇㅈㅓㅇㅅㅣㄱ	paŋd͡ʑʌŋɕʰik̚
ㄱㅑㅇㅜㄹㄷㅏ	kjauɭda
ㄹㅏㅁㅕ	ɾamjʌ
ㅊㅗㅂㅏㅂ	t͡ɕʰobap̚
ㅇㅘ	wa
ㅃㅕㄷ	pjʌt̚
ㅇㅓㄸㅓㄴ	ʌtʌn
ㅍㅏㄱㅚㅎㅏㄷㅏ	pʰaɡweɦada
ㄷㅐㅁㅜㄴ	tɛmun
ㄴㅏㅁㅂㅏㅇㄷㅗㅇㅅㅏㄹㅣ	nambaŋdoŋsʰaɾi
ㅁㅗㅁㅂㅣㄴㅜ	mombinu
ㅁㅗㄱㅇㅛㄱㅌㅏㅇ	moɡjok̚tʰaŋ
ㅋㅗㄴㅓ	kʰonʌ
ㅊㅔㅅㅡㄲㅗㅅㅡㄹㄹㅗㅂㅔㄴㅅㅡㄲㅗ	t͡ɕʰesʰɯkosʰɯɭɭobensʰɯko
ㄱㅏㅇㅁㅜㄹ	kaŋmuɭ
ㄱㅕㄹㅈㅓㅇㅎㅏㄷㅏ	kjʌʎt͡ɕʌŋɦada
ㅊㅜㄱㅂㅗㄱ	t͡ɕʰuk̚pok̚
ㅅㅣㅅㅡㅌㅔㅁ	ɕisʰɯtʰem
ㅁㅗㅅㅓㄹㅣ	mosʰʌɾi
ㅇㅠㅈㅣ	jud͡ʑi
ㅇㅠㄴㄹㅣㅎㅏㄱ	juʎʎiɦak̚
ㅂㅏㅇㄱㅟㄲㅟㄷㅏ	paŋɡɥikɥida
ㄱㅏㄱㅏㅁ	kaɡam
ㅅㅣㄹㅎㅕㄴ	ɕʰiɾʝjʌn
ㅇㅏㅁㅣㄴㅗ	amino
ㅈㅣㅂㅍㅣㄹ	t͡ɕip̚pʰiɭ
ㅍㅜㅇㅅㅜ	pʰuŋsʰu
ㄴㅔㅌㅣㅈㅡㄴ	netʰid͡ʑɯn
ㅂㅏㄹㄹㅔ	paɭɭe
ㅈㅓㄴㅁㅗ	t͡ɕʌnmo
ㅂㅏㅈㅏㅎㅚ	pad͡ʑaβwe
ㅂㅣㅊㅣㄷㅏ	pit͡ɕʰida
ㅅㅣㄴㅁㅣ	ɕʰinmi
ㅂㅜㄲㅡㄹㅓㅇㅜㅁ	pukɯɾʌum
ㅋㅓㅅㅓ	kʰʌsʰʌ
ㄲㅡㅁㅉㅣㄱㅎㅏㄷㅏ	kɯmt͡ɕikʰada
ㄷㅔㄴㅍㅜㄹㅏ	tenpʰuɾa
ㄱㅘㅇㄷㅗㅇ	kwaŋdoŋ
ㅆㅓㄹㅔ	sʌɾe
ㅇㅚㅇㅜㄷㅏ	weuda
ㅅㅓㄹㄹㅔㄷㅏ	sʰʌɭɭeda
ㅇㅣㄴㄱㅣ	inki
ㄱㅏㅇㄹㅕㄹㅎㅏㄷㅏ	kaŋɲjʌɾɦada
ㄱㅖㅅㅗㄱ	kjesʰok̚
ㅎㅘㅇㅎㅏㄱㄹㅜ	ɸwaŋɦaŋnu
ㅂㅜㅇ	puŋ
ㅇㅜㄷㅜㅋㅓㄴㅣ	udukʰʌni
ㄴㅏㅁㅂㅏㅇ	nambaŋ
ㅎㅘㅊㅏ	ɸwat͡ɕʰa
ㅂㅜㄴㅅㅜ	punsʰu
ㅂㅓㅅㄱㅕㅈㅣㄷㅏ	pʌt̚kjʌd͡ʑida
ㅈㅜㅇㅁㅣㅈㅜ	t͡ɕuŋmid͡ʑu
ㄴㅗㄹㅣㄷㅏ	noɾida
ㅂㅜㄹㄱㅏㄹㅣㅇㅏㅇㅓ	puɭɡaɾiaʌ
ㅇㅕㄱㅅㅣ	jʌkɕi
ㅁㅓㄹㅣㅁㅏㅌ	mʌɾimat̚
ㄹㅠㅂㅡㄹㄹㅑㄴㅏ	ɾjubɯʎʎjana
ㅎㅗㅂㅓㅋㅡㄹㅏㅍㅡㅌㅡ	ɸʷobʌkxɯɾapʰɯtʰɯ
ㅍㅗㄱㄹㅕㄱㄷㅏㄴ	pʰoŋɲjʌk̚tan
ㅇㅣㄷㅔㅇㅗㄹㄹㅗㄱㅣ	ideoɭɭoɡi
ㅈㅣㄱㅏㅂ	t͡ɕiɡap̚
ㅂㅜㅁㅜㄴ	pumun
ㄷㅏㅇㅎㅘㅇㅎㅏㄷㅏ	taŋβwaŋɦada
ㅊㅏㅇㅈㅗ	t͡ɕʰaŋd͡ʑo
ㅊㅜㅇㅟ	t͡ɕʰuɥi
ㅍㅏㄹㅅㅣㅂ	pʰaɭɕip̚
ㄱㅗㅇㅈㅣㄱㅈㅏ	koŋd͡ʑik̚t͡ɕa
ㅅㅗㄱㅡㅁ	sʰoɡɯm
ㅇㅑㄱㄹㅣㅎㅏㄱ	jaŋniɦak̚
ㅈㅗㄹㅗㅇ	t͡ɕoɾoŋ
ㅇㅣㄹㅓㄴ	iɾʌn
ㄹㅛㅂㅓㅂ	ɾjobʌp̚
ㅂㅏㅌㅏㅇ	patʰaŋ
ㄱㅕㅇㅇㅓ	kjɘŋʌ
ㅍㅜㅇㄷㅔㅇㅇㅣ	pʰuŋdeŋi
ㅁㅜㅅㅓㄴ	musʰʌn
ㄱㅗㅈㅗㄷㅚㄷㅏ	kod͡ʑodweda
ㅎㅘㄱㄹㅣㅂ	ɸwaŋnip̚
ㄱㅡㄷㅗㅇㅇㅏㄴ	kɯdoŋan
ㄱㅗㅈㅓㄴ	kod͡ʑʌn
ㅇㅕㄱㅝㄴ	jʌkwʌn
ㅂㅗㄱㅗㅌㅏ	poɡotʰa
ㄱㅓ	kʌ
ㄷㅏㅁㅏㅅㅡㅋㅜㅅㅡ	tamasʰɯkʰusʰɯ
ㅈㅣㅅ	t͡ɕit̚
ㅇㅜㅅㅇㅡㅁ	usʰɯm
ㅌㅏㄴㄷㅗ	tʰando
ㅈㅓㄴㅈㅏㅁㅔㅇㅣㄹ	t͡ɕʌɲd͡ʑameiɭ
ㄱㅡㄴㅇㅠㄱ	kɯɲjuk̚
ㄱㅗㅇㅅㅏㄴㅈㅜㅇㅢ	koŋsʰaɲd͡ʑuɰi
ㅈㅗㅅㅜ	t͡ɕosʰu
ㅇㅡㅁㅊㅣㅁㅎㅏㄷㅏ	ɯmt͡ɕʰimɦada
ㅂㅐㅌㄷㅏ	pɛt̚ta
ㅆㅜㅅㅣㄷㅏ	suɕʰida
ㅎㅔㄹㄹㅣㅋㅗㅂㅌㅓ	heʎʎikʰop̚tʰʌ
ㅗ	o
ㅅㅡㅍㅔㅇㅣㄴ	sʰɯpʰein
ㅎㅏㄹㄹㅔㄹㄹㅜㅇㅑ	haɭɭeɭɭuja
ㅎㅗㅈㅣㅁㅕㅇ	ɸʷod͡ʑimjʌŋ
ㅋㅓㅂ	kʰʌp̚
ㅍㅏㄹㅕㅁㅊㅣㅎㅏㄷㅏ	pʰaɾjʌmt͡ɕʰiɦada
ㅊㅗㅅㅂㅜㄹ	t͡ɕʰot̚puɭ
ㄱㅏㄱㅡㄱ	kaɡɯk̚
ㄱㅣㅅㅏ	kisʰa
ㅂㅗㄱㅂㅏㄷㅊㅣㄷㅏ	pok̚pat̚t͡ɕʰida
ㅅㅓㄱㄱㅓ	sʰʌk̚kʌ
ㄷㅓㄱㅊㅓㄴ	tʌk̚t͡ɕʰʌn
ㅇㅏㄲㅏ	aka
ㅁㅜㅇㅏ	mua
ㅂㅣㅈ	pit̚
ㄷㅜㄴㅚ	tunwe
ㅂㅜㄷㅗ	pudo
ㅎㅚㅇㄷㅏㄴ	ɸweŋdan
ㅍㅛㅎㅕㄴ	pʰjoʝjʌn
ㄷㅗㅈㅏㅇ	tod͡ʑaŋ
ㅁㅜㄷㅣㄷㅏ	mudida
ㅇㅠㅇㅣㄴㅇㅝㄴ	juinwʌn
ㅅㅏㅅㅍㅗㄹㅗ	sʰat̚pʰoɾo
ㅂㅏㄴㄱㅏㅄ	panɡap̚
ㅇㅗㅁㅗㄱㅎㅏㄷㅏ	omokʰada
ㅍㅜㅇㅅㅗㄱ	pʰuŋsʰok̚
ㅍㅓㄷ	pʰʌt̚
ㅍㅕㅊ	pʰjʌt̚
ㅅㅗㅈㅔ	sʰod͡ʑe
ㅈㅓㄱㅇㅛㅇㄷㅚㄷㅏ	t͡ɕʌɡjoŋdweda
ㅃㅗㄹㅅㅡㄲㅏ	poɭsʰɯka
ㅂㅏㄲㅏㅌㅉㅗㄱ	pakat̚t͡ɕok̚
ㅇㅛㅅㅜㄹ	josʰuɭ
ㅅㅜㅊㅜㄹㅍㅜㅁ	sʰut͡ɕʰuɭpʰum
ㅂㅏㄹㄱㅕㄴㄷㅚㄷㅏ	paɭɡjʌndweda
ㅅㅓㄱㅜ	sʰʌɡu
ㄱㅕㅇㅅㅏㅇㅂㅜㄱㄷㅗ	kjɘŋsʰaŋbuk̚to
ㅂㅡㄹㅏㅈㅣㄹ	pɯɾad͡ʑiɭ
ㄷㅗㅅㅈㅏㄹㅣ	tot̚t͡ɕaɾi
ㅎㅜㅂㅔㅇㅣ	ɸʷubei
ㅅㅓㄴㅈㅗㅇ	sʰʌɲd͡ʑoŋ
ㄸㅓㄹㄷㅏ	tɘɭda
ㄱㅏㅈㅊㅜㄷㅏ	kat̚t͡ɕʰuda
ㅇㅗㄹ	oɭ
ㅎㅡㄹ	xɯɭ
ㅇㅢㄹㅖ	ɰiɾje
ㅊㅜㅁ	t͡ɕʰum
ㅁㅔㅅㄷㅏㄺ	met̚tak̚
ㄱㅏㅇㅍㅑㄱㅎㅏㄷㅏ	kaŋpʰjakʰada
ㅎㅚㅅㅏㅇ	ɸwesʰaŋ
ㅁㅏㅇㄷㅜㄱ	maŋduk̚
ㅆㅡㄷㅏㄷㅡㅁㄷㅏ	sɯdadɯmda
ㄷㅜㅌㅗㅇ	tutʰoŋ
ㄱㅖㄴ	kjen
ㄷㅗㅈㅜㅇ	tod͡ʑuŋ
ㅂㅗㅅㅏㅇㅎㅏㄷㅏ	posʰaŋɦada
ㄱㅗㄱㅁㅜㄹ	koŋmuɭ
ㅆㅗㄴㅅㅏㄹㄱㅏㅌㅇㅣ	sonsʰaɭɡat͡ɕʰi
ㅇㅓㅄㅇㅓㅈㅣㄷㅏ	ɘpsʌd͡ʑida
ㄱㅏㅇㅎㅘㅎㅏㄷㅏ	kaŋβwaɦada
ㅇㅘㅇㅈㅘ	waŋd͡ʑwa
ㄷㅏㄹㄷㅏ	taɭda
ㄹㅔㄹㅜ	ɾeɾu
ㄱㅕㄹㅈㅓㅇㅈㅣㅅㄷㅏ	kjʌʎt͡ɕʌŋd͡ʑit̚ta
ㅇㅗㄴㅌㅗㅇ	ontʰoŋ
ㅊㅜㅇㅅㅓㅇ	t͡ɕʰuŋsʰʌŋ
ㅉㅡㅁ	t͡ɕɯm
ㅇㅗㄹㅡㄷㅚㅂㅡㄹㅡ	oɾɯdwebɯɾɯ
ㅇㅝㄴㅈㅏ	wʌɲd͡ʑa
ㅂㅜㅍㅣ	pupʰi
ㄲㅓㅁ	kʌm
ㅅㅏㄹㅇㅣㄴㅈㅏ	sʰaɾiɲd͡ʑa
ㄷㅗㄱㅣ	toɡi
ㄸㅡㄹ	tɯɭ
ㅇㅣㄹㅓㅋㅜㅇㅈㅓㄹㅓㅋㅜㅇ	iɾʌkʰuŋd͡ʑʌɾʌkʰuŋ
ㅂㅣㅅㅠㅋㅔㅋㅡ	piɕʰukʰekxɯ
ㄱㅜㄱㅈㅔㅂㅗㅈㅗㅇㅓ	kuk̚t͡ɕebod͡ʑoʌ
ㄱㅏㄷㅎㅣㄷㅏ	katʰida
ㅁㅕㅇㅎㅏㄷㅏ	mjɘŋɦada
ㄱㅟㄷㅜ	kɥidu
ㄱㅡㅁㅇㅛㅇㅣㄹ	kɯmjoiɭ
ㅂㅏㄹㅂㅏㄹㅣㅊㅏ	paɭbaɾit͡ɕʰa
ㅍㅜㅇㄹㅕㅇ	pʰuŋɲjʌŋ
ㅇㅕㄱㅕㅈㅣㄷㅏ	jʌɡjʌd͡ʑida
ㅎㅏㄱㄴㅕㄴ	haŋɲjʌn
ㅇㅣㅂㅊㅓㄴㅈㅏㅇ	ip̚t͡ɕʰʌɲd͡ʑaŋ
ㅈㅜㅁㅜㄴ	t͡ɕumun
ㅋㅗㅇㄴㅏㅁㅜㄹ	kʰoŋnamuɭ
ㅎㅏㄱㅅㅣㄱ	hakɕik̚
ㅎㅘㅇㄱㅡㅁ	ɸwaŋɡɯm
ㅅㅏㅁㅏㄹㅠㅁ	sʰamaɾjum
ㅂㅣㄴㅡㄹㅎㅢㄴㅂㅏㄹㅁㅏㅇㄷㅜㄱ	pinɯɾʝinbaɭmaŋduk̚
ㄴㅓㄹㄷㅏ	nɘɭda
ㅊㅣㄴㅈㅓㄹ	t͡ɕʰiɲd͡ʑʌɭ
ㅉㅣㅊㅏㅇ	t͡ɕit͡ɕʰaŋ
ㅈㅓㅂㅅㅜㅎㅏㄷㅏ	t͡ɕʌpsuɦada
ㄱㅜㄹㅡㅁㄷㅏㄹㅣ	kuɾɯmdaɾi
ㄷㅏㄴㅇㅟ	tanɥi
ㅍㅡㄹㄹㅜㅌㅡ	pʰɯɭɭutʰɯ
ㅊㅓㄴㅁㅏㄴㅇㅔㅇㅛ	t͡ɕʰʌnmanejo
ㅅㅜㄴㅎㅡㅇ	sʰunɣɯŋ
ㅅㅜㅅㅣㅁ	sʰuɕʰim
ㅇㅕㅇㅅㅏㅇ	jʌŋsʰaŋ
ㅁㅜㄱㅇㅡㄴㅈㅣ	muɡɯɲd͡ʑi
ㅎㅘㅇㄷㅗㅇ	ɸwaŋdoŋ
ㅁㅜㄴㄱㅜ	munɡu
ㄹㅕㅇㄷㅗㅈㅏ	ɾjʌŋdod͡ʑa
ㄱㅕㅇㅊㅣ	kjʌŋt͡ɕʰi
ㅅㅏㄱㅣㅈㅚ	sʰaɡid͡ʑwe
ㅌㅔㄴㄱㅜ	tʰenɡu
ㅌㅔㄹㅔㅂㅣ	tʰeɾebi
ㄴㅡㄹ	nɯɭ
ㅅㅓㄴㅈㅓㄴ	sʰɘɲd͡ʑʌn
ㅅㅏ	sʰa
ㅁㅗㅇㅣ	moi
ㅇㅠㅎㅢ	juʝi
ㅋㅏㅂㅡ	kʰabɯ
ㅁㅏㅋㅔㄷㅗㄴㅣㅇㅏ	makʰedonia
ㄱㅛㅁㅣㅎㅏㄷㅏ	kjomiɦada
ㄷㅏㅅㅗ	tasʰo
ㅎㅘㄹㅂㅏㄹㅎㅏㄷㅏ	ɸwaɭbaɾɦada
ㅇㅑㅁㅏㅇ	jamaŋ
ㄱㅘㅇㅅㅓㄴ	kwaŋsʰʌn
ㅅㅡㅂㄱㅕㄱ	sʰɯp̚kjʌk̚
ㄱㅓㄹㅇㅓㄱㅏㄷㅏ	kʌɾʌɡada
ㅈㅓㅇㅈㅣㄱ	t͡ɕɘŋd͡ʑik̚
ㅍㅛㅁㅕㄴㅈㅏㅇㄹㅕㄱ	pʰjomjʌɲd͡ʑaŋɲjʌk̚
ㄱㅏㄴㄱㅗㄱ	kanɡok̚
ㅇㅜㄹㅓㄹㅓㅂㅗㄷㅏ	uɾʌɾʌboda
ㄱㅛㅇㅕㄱ	kjojʌk̚
ㅂㅗㅇㄱㅡㅂ	poŋɡɯp̚
ㅅㅡㅍㅣㅋㅓ	sɯpʰikʰʌ
ㅁㅏㄴㄴㅕㄴ	manɲjʌn
ㅍㅐㅈㅓㄴ	pʰɛd͡ʑʌn
ㅁㅛㄹㄴㅣㄹㅡ	mjoʎʎiɾɯ
ㅈㅣㄹㅣㄴ	t͡ɕiɾin
ㄴㅜㅋㅜㅇㅏㄹㄹㅗㅍㅏ	nukʰuaɭɭopʰa
ㅅㅣㄱㄹㅑㅇ	ɕʰiŋɲjaŋ
ㄱㅜㅅㅡㄹ	kusʰɯɭ
ㄱㅜㄱㅏㅇ	kuɡaŋ
ㅊㅓㄴㅂㅜ	t͡ɕʰʌnbu
ㅅㅜㄱㄹㅕㄴㅈㅏ	sʰuŋɲjʌɲd͡ʑa
ㄴㅡㄲㅣㅁ	nɯkim
ㅇㅏㄱㄹㅕㄱ	aŋɲjʌk̚
ㄱㅖㅈㅓㄹ	kjed͡ʑʌɭ
ㅁㅔㄱㅏㄴㅏ	meɡana
ㅇㅔㅌㅓ	etʰʌ
ㅁㅣㅅㅏㅇㅣㄹ	misʰaiɭ
ㅇㅣㄹㅏㄴ	iɾan
ㄱㅜㄷㅇㅣ	kud͡ʑi
ㄱㅡㅁㅈㅣㅎㅏㄷㅏ	kɯmd͡ʑiɦada
ㅈㅓㄴㄱㅜ	t͡ɕɘnɡu
ㅁㅣㄴㅅㅓ	minsʌ
ㄱㅓㅁㅇㅡㄴㄸㅏㄹㄱㅣ	kʌmɯntaɭɡi
ㅍㅏㄴㄱㅝㄴ	pʰanɡwʌn
ㅅㅏㄹㄱㅕㄹ	sʰaɭɡjʌɭ
ㅈㅜㅇㅅㅓㅇㅈㅏ	t͡ɕuŋsʰʌŋd͡ʑa
ㅂㅜㄹㅇㅏㄴ	puɾan
ㄱㅘㅇㅊㅗ	kwaŋt͡ɕʰo
ㅈㅔㄱㅜㄱㅈㅜㅇㅢ	t͡ɕeɡuk̚t͡ɕuɰi
ㅎㅘㄹㅇㅛㅇ	ɸwaɾjoŋ
ㅍㅏㅇㅣ	pʰai
ㅈㅗㅇㅇㅓ	t͡ɕoŋʌ
ㅂㅏㄱ	pak̚
ㅇㅣㅇㅇㅕ	iŋjʌ
ㅎㅘㅇㅛㅇㅣㄹ	ɸwajoiɭ
ㅁㅜㄴㅈㅔㅈㅓㅁ	muɲd͡ʑed͡ʑʌm
ㅍㅣㄹㅏㅁㅣ	pʰiɾami
ㅅㅏㅇㄴㅗㅁ	sʰaŋnom
ㅁㅕㄴㅈㅓㄱ	mjɘɲd͡ʑʌk̚
ㅇㅜㅍㅓㄴㄱㅜㄱ	upʰʌnɡuk̚
ㅇㅕㄹㅇㅣㄹㄱㅗㅂ	jʌʎʎiɭɡop̚
ㅂㅏㅇㅏㄹ	paaɭ
ㅁㅏㅇㄱㅏㄴ	maŋɡan
ㄷㅏㅂㅈㅏㅇ	tap̚t͡ɕaŋ
ㅊㅓㄹ	t͡ɕʰʌɭ
ㄷㅡㄱㄷㅗㅎㅏㄷㅏ	tɯk̚toɦada
ㅈㅓㅇㅂㅣ	t͡ɕɘŋbi
ㅁㅜㅅㅓㅇㅝㅎㅏㄷㅏ	musʰʌwʌɦada
ㅈㅣㅂㅜㄹㅎㅏㄷㅏ	t͡ɕibuɾɦada
ㅅㅔㄱㅅㅣㅎㅏㄷㅏ	sʰekɕiɦada
ㅇㅣㅂㅁㅏㅈㅊㅜㅁ	immat̚t͡ɕʰum
ㅅㅐ	sʰɛ
ㅈㅏㅅㅔㅎㅏㄷㅏ	t͡ɕasʰeɦada
ㅅㅜㅍㅕㅇㅅㅓㄴ	sʰupʰjʌŋsʰʌn
ㄱㅗㅁㅗ	komo
ㅂㅏㄹㅈㅏㄱㅜㄱ	paʎt͡ɕaɡuk̚
ㅁㅜㄹㅌㅗㅇ	muɭtʰoŋ
ㄱㅏㄴㅆㅜ	kansu
ㅅㅣㄴㅌㅏㄱㅌㅗㅇㅊㅣ	ɕʰintʰak̚tʰoŋt͡ɕʰi
ㅅㅓㅇㅂㅕㅇ	sʰɘŋpjʌŋ
ㅁㅔㄹㄹㅏㄴㅣㄴ	meɭɭanin
ㅅㅐㅇ	sʰɛŋ
ㅅㅔㅇㅜㄷㅏ	sʰeuda
ㅈㅗㅊㅣ	t͡ɕot͡ɕʰi
ㅁㅗㅇㄹㅗㅇ	moŋnoŋ
ㅅㅣㅁㅅㅓㅇ	ɕʰimsʰʌŋ
ㅈㅔㄴㅗㄴ	t͡ɕenon
ㅈㅓㅇㅎㅘㄱㅎㅏㄷㅏ	t͡ɕɘŋβwakʰada
ㅅㅜㄱㅈㅜㄴㅏㅁㅜㄹ	sʰuk̚t͡ɕunamuɭ
ᆸㅅㅣㄷㅏ	pɕida
ㅍㅕㅇㅇㅑㅇ	pʰjʌŋjaŋ
ㅌㅏㄴㅎㅘㄴ	tʰanβwan
ㅋㅗㅂㅏㄹㅌㅡ	kʰobaɭtʰɯ
ㄷㅏㅁㄷㅏㅁㅎㅏㄷㅏ	tamdamɦada
ㅍㅗㄱㄴㅓㄼㄷㅏ	pʰoŋnʌɭta
ㅇㅏㄱㄷㅓㄱ	ak̚tʌk̚
ㄱㅏㅇㅊㅜ	kaŋt͡ɕʰu
ㅂㅜㄹㅂㅏㄷㅏ	puɭbada
ㅂㅜㄴㅈㅏ	puɲd͡ʑa
ㅈㅜㅍㅏㄴ	t͡ɕupʰan
ㄲㅡㄹㄹㅣㄷㅏ	kɯʎʎida
ㄱㅓㄴㅈㅗㄱㅣ	kʌɲd͡ʑoɡi
ㄷㅓㅂㅡㄹㅇㅠ	tʌbɯʎʎju
ㅇㅣㄹㅎㅘ	iɾβwa
ㄱㅡㄹㅡㅊㅣㄷㅏ	kɯɾɯt͡ɕʰida
ㄷㅙㅈㅣㄲㅜㅁ	twɛd͡ʑikum
ㅃㅕㅁ	pjɘm
ㅇㅠㄹㅣㅎㅏㄷㅏ	juɾiɦada
ㄱㅏㅁㅅㅏㅇ	kamsʰaŋ
ㅍㅕㅇㅍㅏㄴ	pʰjɘŋpʰan
ㅍㅛㄱㅗ	pʰjoɡo
ㅎㅗㄱㅇㅕㄴㅏ	ɸʷoɡjʌna
ㄷㅏㅇㅇㅕㄴㅎㅣ	taŋjʌnʝi
ㅂㅓㅁㅈㅜ	pɘmd͡ʑu
ㅁㅔㄹㄹㅗㄷㅣ	meɭɭodi
ㅅㅐㅇㅂㅏㅇㅅㅗㅇ	sʰɛŋbaŋsʰoŋ
ㅂㅏㄲㅇㅔ	pake
ㅂㅜㄹㄷㅗㅈㅓ	puɭdod͡ʑʌ
ㄴㅜㄹㅡㄷㅏ	nuɾɯda
ㄱㅡㄴㄱㅛ	kɯnɡjo
ㄱㅓㅈㅓㄹㅎㅏㄷㅏ	kɘd͡ʑʌɾɦada
ㅇㅟㅌㅏㄱ	ɥitʰak̚
ㄱㅜㄹㄱㅗㄱㅇㅟ	kuɭɡoɡɥi
ㄹㅗㄱㅗ	ɾoɡo
ㅇㅟㄱㅜㄹㅡㅇㅓ	ɥiɡuɾɯʌ
ㄴㅡㅈㄷㅏ	nɯt̚ta
ㅇㅏㄴㅌㅏㄲㅏㅂㄷㅏ	antʰakap̚ta
ㄱㅣㅁㅇㅣㄹㅅㅓㅇㅎㅘ	kimiɭsʰʌŋβwa
ㄹㅣㄷㅡㅁ	ɾidɯm
ㅇㅢㄱㅕㄴ	ɰiɡjʌn
ㅎㅓㄴㅂㅕㅇ	hɘnbjʌŋ
ㅈㅏㅇㅚㅅㅓㄴ	t͡ɕawesʰʌn
ㄱㅡㄹㅜㅈㅣㅇㅑ	kɯɾud͡ʑija
ㄸㅚㅇㅑㄱㅂㅕㅌ	twejak̚pjʌt̚
ㅈㅏㅇㅠㄹㅗㅂㄷㅏ	t͡ɕajuɾop̚ta
ㅎㅗㅇㅇㅓ	ɸʷoŋʌ
ㄱㅜㄱㅎㅚㅇㅢㅇㅝㄴ	kukʰweɰiwʌn
ㅈㅓㄴㅅㅓㄴ	t͡ɕʌnsʰʌn
ㅇㅣㅂㅂㅏㅇㅊㅔ	ip̚paŋt͡ɕʰe
ㅈㅡㅇㄱㅏㅎㅏㄷㅏ	t͡ɕɯŋɡaɦada
ㅇㅏㅍㅡㄹㅗㄷㅣㅌㅔ	apʰɯɾoditʰe
ㄱㅓㅈㅜㅎㅏㄷㅏ	kʌd͡ʑuɦada
ㄴㅣㅁ	nim
ㄱㅛㅅㅓㅂ	kjosʰʌp̚
ㄱㅘㄴㄹㅕㄴ	kwaʎʎjʌn
ㅌㅗㅇㅈㅡㅇ	tʰoŋd͡ʑɯŋ
ㅅㅗㄴㅕ	sʰoɲjʌ
ㅂㅣㅅㅛㅂ	piɕʰop̚
ㅅㅜㅅㅣㅂ	sʰuɕʰip̚
ㄹㅜㅁㅏㄴㅣㅇㅏ	ɾumania
ㄴㅏㅂㄹㅑㅇ	namɲjaŋ
ㄱㅣㅂㄷㅏ	kip̚ta
ㅎㅐㄱㅗㅎㅏㄷㅏ	hɛɡoɦada
ㅂㅜㄹㅍㅕㄴ	puɭpʰjʌn
ㄱㅜㅁㅏㅁㅗㄸㅗ	kumamoto
ㅈㅜㄹㄱㅗㄷ	t͡ɕuɭɡot̚
ㅈㅓㅇㅅㅏㅇㅊㅣ	t͡ɕɘŋsʰaŋt͡ɕʰi
ㄱㅜㄱㄱㅏ	kuk̚ka
ㅁㅛ	mjo
ㅈㅣㄴㅈㅜ	t͡ɕiɲd͡ʑu
ㅂㅓㄴㄷㅔㄱㅣ	pʌndeɡi
ㅎㅓㅇㄱㅏㄹㅣ	hʌŋɡaɾi
ㅎㅏㅍㅡㄴㅠㅁ	hapʰɯɲjum
ㅅㅓㅇㄱㅗㅇㅎㅏㄷㅏ	sʰʌŋɡoŋɦada
ㅊㅜㄴㅎㅏㅊㅜㄷㅗㅇ	t͡ɕʰunɦat͡ɕʰudoŋ
ㅇㅕㅅㄱㅣㄹㅡㅁ	jʌt̚kiɾɯm
ㅇㅜㄹㄹㅣㅉㅏ	uʎʎit͡ɕa
ㅁㅜㄹㅕ	muɾjʌ
ㅈㅓㄴㅅㅔ	t͡ɕʌnsʰe
ㅅㅚㅍㅜㄹ	sʰwepʰuɭ
ㅇㅑㄱㅎㅗㄴ	jakʰon
ㄱㅗㅂㅅㅔㅁ	kopsem
ㅂㅣㄱㅡㄱ	piɡɯk̚
ㅂㅏㄷㅇㅏㄷㅡㄹㅇㅣㄷㅏ	padadɯɾida
ㅌㅡㅁ	tʰɯm
ㄷㅗㅈㅓㄱ	tod͡ʑʌk̚
ㅊㅔㅎㅕㅇ	t͡ɕʰeʝjʌŋ
ㄱㅡㄴㅁㅕㄴㅎㅏㄷㅏ	kɯnmjʌnɦada
ㄴㅗㄴㅂㅕㅇㅇㅏㄹㅣ	nonbjʌŋaɾi
ㅈㅓㄴㅌㅜ	t͡ɕʌntʰu
ㄷㅗㄱㅛ	toɡjo
ㅅㅣㄴㄹㅚ	ɕʰiɭɭwe
ㄷㅐㄱㅣㅇㅓㅂ	tɛɡiʌp̚
ㅇㅣㅇㅡㅇ	iɯŋ
ㅂㅕㄴㅇㅣㅎㅏㄷㅏ	pjɘniɦada
ㅂㅗㄱㅇㅡㅁㅅㅓ	poɡɯmsʰʌ
ㄱㅓㅅㅣㄹ	kʌɕʰiɭ
ㅂㅓㅂㄱㅏ	pɘp̚ka
ㄱㅜㄱㅁㅣㄴㅎㅏㄱㄱㅛ	kuŋminɦak̚kjo
ㅇㅝㄹㄷㅡㅋㅓㅂ	wʌɭdɯkʰʌp̚
ㅂㅏㄹㅋㅗㄴㅣ	paɭkʰoni
ㅎㅘㅈㅏㅇㅈㅣ	ɸwad͡ʑaŋd͡ʑi
ㅂㅏㄹㅣ	paɾi
ㅈㅣㅅㅏ	t͡ɕisʰa
ㅂㅜㅈㅓㅇㅎㅏㄷㅏ	pud͡ʑʌŋɦada
ㅂㅏㅇㅗㅈㅡ	paod͡ʑɯ
ㅈㅓㄹㅓㅎㄱㅔ	t͡ɕʌɾʌkʰe
ㅍㅏㅂㅓㄹ	pʰabʌɭ
ㄱㅏㅁㅅㅜㄱ	kamsʰuk̚
ㅅㅗㄱ	sʰok̚
ㅁㅣㄹㄷㅏㅇ	miɭtaŋ
ㄴㅏㄴㅜㅇㅣㄷㅏ	nanuida
ㅋㅏㅇㅣㄴ	kʰain
ㅍㅕㅇㅎㅘㄹㅗㅂㄷㅏ	pʰjʌŋβwaɾop̚ta
ㅈㅜㅇㅎㅏㄱㄱㅛ	t͡ɕuŋɦak̚kjo
ㅍㅗㄱㅍㅜㅇ	pʰok̚pʰuŋ
ㅅㅏㅇㅣㅅㅣㅇㅗㅅ	sʰaiɕʰiot̚
ㅎㅐㅇㅂㅗㄱㅎㅏㄷㅏ	hɛŋbokʰada
ㄷㅗㅇㅇㅕㄱㅎㅏㄱ	toŋjʌkʰak̚
ㄹㅓㄷㅓㅍㅗㄷㅠㅁ	ɾʌdʌpʰodjum
ㄷㅗㅍㅛ	topʰjo
ㄴㅏㅊㅇㅣㄱㄷㅏ	nannik̚ta
ㅅㅓㄹㅊㅣㅎㅏㄷㅏ	sʰʌʎt͡ɕʰiɦada
ㅈㅏㅇㅅㅜ	t͡ɕaŋsʰu
ㄹㅣㄹ	ɾiɭ
ㅁㅔㅅㅗㄷㅡ	mesʰodɯ
ㄷㅐㅎㅕㅇ	tɛʝjʌŋ
ㅁㅣㅎㅏㅇㅣㄹ	miɦaiɭ
ㄱㅣㅇㅓㄱㅏㄷㅏ	kiʌɡada
ㅂㅜㄹㅌㅏ	puɭtʰa
ㅅㅗㅈㅜ	sod͡ʑu
ㅇㅕㄴㄱㅕㄹㅎㅏㄷㅏ	jʌnɡjʌɾɦada
ㄷㅏㅎㅅㅗㄹㅣ	tasoɾi
ㅇㅠㄹㅣㄱㅣ	juɾiɡi
ㅊㅔㅁㅗ	t͡ɕʰemo
ㅌㅜㅇㅏㄹㅖ	tʰuaɾje
ㅊㅏㅇㅇㅝㄴ	t͡ɕʰaŋwʌn
ㄷㅔㄱㅅㅡㅌㅡㄹㅣㄴ	teksɯtʰɯɾin
ㅅㅔㄴㅌㅓ	sʰentʰʌ
ㅎㅘㅅㅓㅇ	ɸwasʰʌŋ
ㄷㅏㅇㄱㅜ	taŋɡu
ㅇㅢㅇㅢ	ɰiɰi
ㅂㅣㄱㅣㅁ	piɡim
ㄱㅣㅍㄷㅏ	kip̚ta
ㄸㅡㅅㅎㅏㄷㅏ	tɯtʰada
ㅁㅗㅅ	mot̚
ㄴㅏㅁㅁㅣ	nammi
ㅇㅟㅈㅡㅇ	ɥid͡ʑɯŋ
ㅅㅣㅎㅏㅂ	ɕʰiɦap̚
ㅇㅖㄴㅣㄹㅔ	jeniɾe
ㅈㅏㄹㄷㅏ	t͡ɕaɭda
ㅎㅏㄴㅁㅏㄷㅣ	hanmadi
ㄷㅣㄹ	tiɭ
ㄱㅘㅇㅇㅑ	kwaŋja
ㅇㅓㅁㅓㄴㅣㅁ	ʌmʌnim
ㅊㅣㄴㅈㅗㄱ	t͡ɕʰiɲd͡ʑok̚
ㅁㅣㄴㅜㅅㅡ	minusʰɯ
ㅌㅗㄴㅏㅁㅔㄴㅌㅡ	tʰonamentʰɯ
ㅂㅏㅌㅣㅋㅏㄴ	patʰikʰan
ㅈㅣㅁㅕㅇ	t͡ɕimjʌŋ
ㅂㅏㄴㄷㅣㅅㅂㅜㄹ	pandit̚puɭ
ㅍㅠㄹㅏㄴ	pʰjuɾan
ㅇㅏㅇㅣㅅㅡㅋㅡㄹㅣㅁ	aisʰɯkxɯɾim
ㅅㅔㅇㅣㄴㅌㅡㅈㅗㅈㅣㅅㅡ	sʰeintʰɯd͡ʑod͡ʑisʰɯ
ㅂㅏㄹㄹㅏㄷㅡ	paɭɭadɯ
ㅁㅜㄹㅛ	muɾjo
ㅋㅏㄹㅡㅂㅗㄴㅣㄹㄱㅣ	kʰaɾɯboniɭɡi
ㄱㅡㄹ	kɯɭ
ㅅㅏㄴㄷㅗㅇ	sʰandoŋ
ㅅㅣㅂㅇㅗ	ɕʰibo
ㅇㅜㄴㅈㅓㄴㅅㅏ	uɲd͡ʑʌnsʰa
ㄷㅏㄹㅁㅏㄷㅏ	taɭmada
ㅅㅗㄱㄷㅏㅁ	sʰok̚tam
ㅍㅡㄹㅣㄴㅌㅓ	pʰɯɾintʰʌ
ㅇㅕㅅ	jʌt̚
ㅅㅣㄴㄱㅕㅇ	ɕʰinɡjʌŋ
ㅎㅔㄹㅗㅇㅣㄴ	heɾoin
ㅊㅜㄹㅇㅕㄴ	t͡ɕʰuɾjʌn
ㅅㅔㄹㅡㅂㅣㅇㅏ	seɾɯbia
ㅊㅣㄴㄱㅡㄴㅎㅏㄷㅏ	t͡ɕʰinɡɯnɦada
ㅅㅓㅇㄷㅏㅇ	sʰɘŋdaŋ
ㄱㅏㄴㅅㅓㅇ	kansʰʌŋ
ㅁㅏㄹㅣㅎㅘㄴㅏ	maɾiβwana
ㅅㅏㅇㅟ	sʰaɥi
ㄷㅗㅇㄱㅏㅂ	toŋɡap̚
ㅊㅣㄴㅁㅣㄹ	t͡ɕʰinmiɭ
ㄲㅗㄹㅣㅍㅛ	koɾipʰjo
ㅇㅜㅅㄷㅏ	ut̚ta
ㅇㅣㄴㄱㅜ	inɡu
ㅎㅐㄹㅗㅂㄷㅏ	hɛɾop̚ta
ㅇㅓㄹㄹㅣㄷㅏ	ʌʎʎida
ㅊㅔㅋㅗ	t͡ɕʰekʰo
ㅍㅗㄱㅣ	pʰoɡi
ㅍㅣㄴㄹㅏㄴㄷㅡ	pʰiɭɭandɯ
ㅅㅡㅌㅔㅇㅏㄹㅡㅅㅏㄴ	sʰɯtʰeaɾɯsʰan
ㅇㅓㄹㅛㅇ	ʌɾjoŋ
ㄱㅓㄴㅁㅜㄹ	kɘnmuɭ
ㅇㅏㅁㅣㄴㅗㅅㅏㄴ	aminosʰan
ㅇㅛㄹㅏㅁㅂㅗㄴ	joɾambon
ㅎㅘㄴㄹㅏㄱ	ɸwaɭɭak̚
ㄷㅐㅊㅔㄹㅗ	tɛt͡ɕʰeɾo
ㄴㅓㄼㄷㅏ	nʌɭta
ㄴㅣㅋㅏㄹㅏㄱㅘ	nikʰaɾaɡwa
ㅈㅣㄴㅇㅕㄹㅈㅏㅇ	t͡ɕiɲjʌʎd͡ʑaŋ
ㅍㅕㅇㅇㅢㅎㅚ	pʰjɘŋɰiβwe
ㅊㅔㄴㅕㅁ	t͡ɕʰeɲjʌm
ㅍㅕㅇㅈㅓㅇ	pʰjʌŋd͡ʑʌŋ
ㅁㅏㅅㅇㅣㅆㄷㅏ	maɕʰit̚ta
ㅍㅗㄹㄹㅗㄴㅠㅁ	pʰoɭɭoɲjum
ㅈㅗㅇㅑㄱ	t͡ɕojak̚
ㅊㅏㄴㅅㅏ	t͡ɕʰansʰa
ㅅㅣㅇ	ɕʰiŋ
ㅊㅓㄴㅅㅓㅇ	t͡ɕʰʌnsʰʌŋ
ㄴㅏㅊㅣㅈㅡㅁ	nat͡ɕʰid͡ʑɯm
ㅊㅔㅋㅓ	t͡ɕʰekʰʌ
ㅅㅗㅇㅛㅇ	sʰojoŋ
ㄴㅏㄹㄷㅏ	naɭda
ㅍㅣㄹㅌㅗㅇ	pʰiɭtʰoŋ
ㅅㅏㄷㅏ	sʰada
ㅇㅕㅈㅏㅊㅣㄴㄱㅜ	jʌd͡ʑat͡ɕʰinɡu
ㅍㅛㅇㅓ	pʰjoʌ
ㅇㅓㄹㅁㅏㄴㅏ	ʌɭmana
ㅇㅕㄴㄹㅏㄱㅊㅓ	jʌɭɭak̚t͡ɕʰʌ
ㅅㅡㅌㅔㅂ	sʰɯtʰep̚
ㄴㅣㅋㅔㅇㅏ	nikʰea
ㅎㅗㄴㄷㅗㄴ	ɸʷondon
ㄱㅡ	kɯ
ㄷㅜㅅㅓㄴㅓ	tusʰʌnʌ
ㄱㅜㅎㅏㄷㅏ	kuɦada
ㅅㅐㄸㅗㅇ	sʰɛtoŋ
ㅊㅣㅁㅁㅜㄱ	t͡ɕʰimmuk̚
ㅇㅜㅍㅕㄴㅎㅏㅁ	upʰjʌnɦam
ㄱㅏㄹㅕㄴㅎㅏㄷㅏ	kaɾjʌnɦada
ㅍㅔㄹㅡㅁㅠㅁ	pʰeɾɯmjum
ㅁㅏㅇㄱㅗ	maŋɡo
ㅍㅔㅁㅣㄴㅣㅈㅡㅁ	pʰeminid͡ʑɯm
ㅅㅓㄱㅂㅏㅇ	sʰʌk̚paŋ
ㄴㅡㄴㅈㅣ	nɯɲd͡ʑi
ㅈㅓㅇㅊㅣㅇㅣㄴ	t͡ɕʌŋt͡ɕʰiin
ㅎㅗㄱㅇㅕ	ɸʷoɡjʌ
ㅅㅣㅁㅅㅏ	ɕʰimsʰa
ㄱㅗㅁㅜ	komu
ㅇㅠㅂㅏㅇ	jubaŋ
ㄱㅗㅇㅅㅜㅂㅕㅇ	koŋsʰubjʌŋ
ㅂㅗㅇㅣㅍㅡㄹㅔㄴㄷㅡ	poipʰɯɾendɯ
ㅂㅗㄲㄷㅏ	pok̚ta
ㄷㅐㅎㅏㄱㅇㅝㄴ	tɛɦaɡwʌn
ㄷㅏㅁㅂㅏㄱㅎㅏㄷㅏ	tambakʰada
ㅃㅗㅂㅎㅣㄷㅏ	popʰida
ㄱㅓㄹㄷㅏ	kɘɭda
ㅈㅣㅁㅂㅏㅂㅡㅇㅞ	t͡ɕimbabɯwe
ㅂㅏ	pa
ㅁㅗㅅㅡㅋㅡ	mosʰɯkxɯ
ㅊㅓㄴㅈㅏㅇ	t͡ɕʰʌɲd͡ʑaŋ
ㄱㅡㄹㅓㅎㄱㅔ	kɯɾʌkʰe
ㄱㅣㅅㅜㄱㅅㅏ	kisʰuksa
ㅂㅗㄴㄴㅡㅇ	ponnɯŋ
ㄱㅡㄴㅅㅣ	kɯnɕʰi
ㅆㅢㅇㅜㄷㅏ	ɕiuda
ㅅㅜㅇ	sʰuŋ
ㅇㅑㅊㅏ	jat͡ɕʰa
ㅂㅓㅋㅡㄹ	pʌkxɯɭ
ㅍㅣㅆㅣㅂㅏㅇ	pʰiɕibaŋ
ㅍㅕㅇㄱㅠㄴ	pʰjʌŋɡjun
ㄱㅡㅂㄱㅣㅇㅑ	kɯp̚kija
ㄱㅗㄹㄷㅏ	koɭda
ㅅㅓㅁㄴㅔㅇㅣㄹ	sʰʌmneiɭ
ㅇㅣㄹㄱㅣ	iɭɡi
ㄴㅏㅁㅂㅣ	nambi
ㅎㅏㄴㅈㅏㄴ	haɲd͡ʑan
ㄸㅗㅎㅏㄴ	toɦan
ㅍㅜㄹㄹㅣㄷㅏ	pʰuʎʎida
ㄱㅗㅇㅂㅕㅇ	koŋbjʌŋ
ㅁㅏㄹㄹㅔㅇㅣㅅㅣㅇㅏ	maɭɭeiɕʰia
ㅂㅜㄹㅅㅏㅇㄴㅗㅁ	puɭsʰaŋnom
ㅅㅜㅈㅗ	sʰud͡ʑo
ㅅㅜㅁㅏㄹ	sʰumaɭ
ㅎㅏㄴㄹㅏㅅㅏㄴ	haɭɭasʰan
ㅉㅏㄷㅏ	t͡ɕada
ㄱㅏㅁㅕㄴㄱㅡㄱ	kamjʌnɡɯk̚
ㄲㅔ	ke
ㅇㅏㅁㅏㄷㅗ	amado
ㅊㅓㄴㄱㅜㄱ	t͡ɕʰʌnɡuk̚
ㄱㅏㅅㅡㅁㅃㅕ	kasʰɯmpjʌ
ㅇㅟㄴㄴㅏㄴ	ɥinnan
ㅈㅏㅇㅟㅎㅏㄷㅏ	t͡ɕaɥiɦada
ㅇㅣㅁㅁㅕㅇ	immjʌŋ
ㅁㅗㄹㄷㅏ	moɭda
ㅍㅗㄷㅗㅌㅏㄴ	pʰodotʰan
ㅍㅣㅍㅗㄱㅈㅏ	pʰipʰok̚t͡ɕa
ㅃㅏㄹㄷㅏ	paɭda
ㅌㅗㅇㄱㅡㄴ	tʰoŋɡɯn
ㅅㅜㄴㅅㅜ	sʰunsʰu
ㄱㅣㅈㅜㄴ	kid͡ʑun
ㅁㅕㅇㅈㅏ	mjʌŋt͡ɕa
ㅉㅗㄹㅁㅕㄴ	t͡ɕoɭmjʌn
ㅅㅏㅅㅣ	sʰaɕʰi
ㅈㅓㅂㅊㅗㄱ	t͡ɕʌp̚t͡ɕʰok̚
ㅅㅣㄱㅏㄴㅍㅛ	ɕʰiɡanpʰjo
ㅌㅏㄹㄹㅣㄴ	tʰaʎʎin
ㄷㅗㅎㅏㅂ	toɦap̚
ㄱㅘㄴㄹㅣ	kwaʎʎi
ㅈㅜㄹㄴㅏㅂㅈㅏㄹㅜ	t͡ɕuɭɭap̚t͡ɕaɾu
ㅂㅣㅍㅏㄴㅈㅓㄱ	pipʰaɲd͡ʑʌk̚
ㅍㅡㅇ	pʰɯŋ
ㄴㅏㄺ	nak̚
ㅇㅕㄹㅂㅕㅇ	jʌɭbjʌŋ
ㅅㅏㅇㅇㅏ	sʰaŋa
ㅇㅓㄱㅡㅅㄴㅏㄷㅏ	ʌɡɯnnada
ㅅㅗㄱㅅㅏㄱㅇㅣㄷㅏ	sʰoksaɡida
ㅈㅣㅂㅈㅜㅇㅎㅏㄷㅏ	t͡ɕip̚t͡ɕuŋɦada
ㅇㅜㅂㅏㄱ	ubak̚
ㅇㅑㅇㅈㅜ	jaŋd͡ʑu
ㄱㅡㄴㅡㄹㅈㅣㄷㅏ	kɯnɯʎd͡ʑida
ㅅㅜㅇㅕㅇㅈㅏㅇ	sʰujʌŋd͡ʑaŋ
ㅍㅣㅌㅗㅇ	pʰitʰoŋ
ㅎㅏㅁㄹㅑㅇ	hamɲjaŋ
ㅂㅏㅇㅎㅏㄱ	paŋɦak̚
ㅂㅜㄹㄱㅘㅎㅏㄷㅏ	puɭɡwaɦada
ㅅㅣㄹㅎㅓㅁ	ɕʰiɾɦʌm
ㅌㅡㄱㅂㅕㄹㅎㅏㄷㅏ	tʰɯk̚pjʌɾɦada
ㅇㅢㅈㅗㄴㅈㅡㅇ	ɰid͡ʑoɲd͡ʑɯŋ
ㅋㅏㅁㅍㅏㄴ	kʰampʰan
ㄴㅡㄲㅣㄷㅏ	nɯkida
ㅈㅗㅅㅣㅁㅅㅡㄹㅓㅂㄷㅏ	t͡ɕoɕʰimsʰɯɾʌp̚ta
ㅊㅣㄴㄱㅜ	t͡ɕʰinɡu
ㅍㅓㅂㅡ	pʰʌbɯ
ㅅㅏㄴㅇㅑㅇ	sʰaɲjaŋ
ㅎㅚㄱ	ɸwek̚
ㄴㅏㅅㅏ	nasʰa
ㅈㅓㄱㅡㅁㅌㅗㅇ	t͡ɕɘɡɯmtʰoŋ
ㅂㅏㄹㄱㅣㄷㅏ	paɭɡida
ㅁㅑㅁ	mjam
ㄱㅜㄴㅎㅏㅁㅈㅗ	kunɦamd͡ʑo
ㅂㅜㄹㄱㅜ	puɭɡu
ㅇㅏㄴㄹㅏㄱㅇㅢㅈㅏ	aɭɭaɡɰid͡ʑa
ㅅㅣㄴㄹㅚㅎㅏㄷㅏ	ɕʰiɭɭweɦada
ㄱㅗㄱㅣ	koɡi
ㅈㅓㄴㅇㅕㅁㅂㅕㅇ	t͡ɕʌɲjʌmbjʌŋ
ㅂㅜㄹㅁㅕㄴㅈㅡㅇ	puɭmjʌɲt͡ɕɯŋ
ㅇㅠㄱㅊㅔ	juk̚t͡ɕʰe
ㄴㅏㄱㅡㄴㄴㅏㄱㅡㄴ	naɡɯnnaɡɯn
ㅇㅏㄹㅏㅂㅣㅇㅏ	aɾabia
ㄱㅓㅂㅜㄱㅅㅓㄴ	kʌbuksʌn
ㅈㅏㄹㄷㅚㄷㅏ	t͡ɕaɭdweda
ㅎㅡㄱㅇㅣㄴ	xɯɡin
ㄷㅓㄱㅜㄴㅏ	tʌɡuna
ㅌㅚㅈㅣㄱㄱㅡㅁ	tʰwed͡ʑik̚kɯm
ㄲㅡㅌㄴㅏㄷㅏ	kɯnnada
ㄷㅐㅅㅓㅇㅑㅇ	tɛsʰʌjaŋ
ㅁㅗㄱㅈㅏㅇ	mok̚t͡ɕaŋ
ㄱㅏㅈㅏㅇㅈㅏㄹㅣ	kad͡ʑaŋd͡ʑaɾi
ㅇㅏㅍㅡㄹㅣㅋㅏ	apʰɯɾikʰa
ㄴㅏㅁㅈㅏㅇㅏㅇㅣ	namd͡ʑaai
ㅇㅏㄹㅣㅅㅜ	aɾisʰu
ㄷㅟㄸㅏㄹㅡㄷㅏ	tɥitaɾɯda
ㅌㅏㅇㅣㅌㅏㄴㅠㅁ	tʰaitʰaɲjum
ㅈㅗㅇㅎㅏㅂ	t͡ɕoŋɦap̚
ㄷㅏㅇㅜㄴㄹㅗㄷㅡ	taunnodɯ
ㅍㅔㅂ	pʰep̚
ㅇㅣㄹㅓㄷㅏ	iɾʌda
ㅊㅏㅁㅏㄷㅏㅇ	t͡ɕʰamadaŋ
ㄴㅠㅇㅜㅂㅁㅏㄹ	ɲjuummaɭ
ㅇㅗㄹㅗㅅㅎㅏㄷㅏ	oɾotʰada
ㄲㅓㄱㅈㅓㄱㅣ	kʌk̚t͡ɕʌɡi
ㅊㅜㄱㅂㅗㄱㅎㅏㄷㅏ	t͡ɕʰuk̚pokʰada
ㄷㅚㄴㅈㅏㅇㄴㅕ	tweɲd͡ʑaŋɲjʌ
ㅈㅣㅂㄷㅏㄴㅎㅘ	t͡ɕip̚tanβwa
ㅁㅓㅇㅌㅓㅇㄱㅜㄹㅣ	mʌŋtʰʌŋɡuɾi
ㄱㅗㅂㅅㅏㅇㅕㄴㅇㅓ	kopsajʌnʌ
ㅇㅗㅁㅈㅡㄱㅣㄷㅏ	omd͡ʑɯɡida
ㅇㅏㄱㄱㅗㄱ	ak̚kok̚
ㅁㅣㅋㅏㅇㅔㄹ	mikʰaeɭ
ㅋㅗㅅㅡㅁㅗㅅㅡ	kʰosʰɯmosʰɯ
ㅅㅕㅊㅡ	ɕʰʌt͡ɕʰɯ
ㅂㅜㅌㅏㄱㅎㅏㄷㅏ	putʰakʰada
ㅍㅏㅌㅣ	pʰatʰi
ㅇㅣㄴㄷㅗㅇㅑㅇ	indojaŋ
ㅇㅣㅈㅣㅂㅌㅡ	id͡ʑip̚tʰɯ
ㄱㅡㅈㅔ	kɯd͡ʑe
ㄴㅗㅋㅡㅎㅏㄷㅏ	nokxɯɦada
ㅁㅜㄴㅇㅢ	munɰi
ㅈㅜㅇㅕㄴ	t͡ɕujʌn
ㄱㅛㅂㅏㄴ	kjoban
ㄴㅔㄹㅗ	neɾo
ㅈㅗㅇㅇㅣㄹ	t͡ɕoŋiɭ
ㅇㅣㅅㅡㅌㅏㄴㅂㅜㄹ	isʰɯtʰanbuɭ
ㅂㅜㄹㅇㅏㄴㅎㅏㄷㅏ	puɾanɦada
ㄱㅣㄴㅕㅁㅍㅜㅁ	kiɲjʌmpʰum
ㄴㅏㅁㅜㄹㅏㄷㅏ	namuɾada
ㅈㅏㅇㄱㅣ	t͡ɕaŋɡi
ㅈㅗㅈㅣㅌㅏㅇㅜㄴ	t͡ɕod͡ʑitʰaun
ㅈㅏㅇㅊㅣ	t͡ɕaŋt͡ɕʰi
ㅇㅏㅍㅏㅌㅡ	apʰatʰɯ
ㅅㅔㅈㅗㅇ	sʰed͡ʑoŋ
ㄲㅡㄶㅇㅣㅁㅇㅓㅄㄷㅏ	kɯnimʌp̚ta
ㅌㅏㅇㅣㅁㅓ	tʰaimʌ
ㅅㅜㅅㅏㄴㄱㅣ	sʰusʰanɡi
ㅅㅜㄱㅅㅗ	sʰukso
ㄱㅏㄴㅈㅣㄹㄱㅓㄹㅣㄷㅏ	kaɲd͡ʑiɭɡʌɾida
ㄷㅐㅎㅏㄱㄱㅛ	tɛɦak̚kjo
ㅊㅗㅇㅇㅏㄹ	t͡ɕʰoŋaɭ
ㅇㅓㅅㅓ	ʌsʰʌ
ㄴㅏㅁㅎㅏㄴ	namɦan
ㅇㅛㄱㅁㅏㅇ	joŋmaŋ
ㅎㅓㅁㄷㅏㅁ	hɘmdam
ㄷㅗㅇㄱㅜㄹ	toŋɡuɭ
ㄱㅏㄲㅡㅁㅆㅣㄱ	kakɯmɕik̚
ㄱㅡㄱㅓ	kɯɡʌ
ㄱㅣㅁㅏㄴㄷㅚㄷㅏ	kimandweda
ㅅㅣㅀㄷㅏ	ɕʰiɭtʰa
ㅇㅣㄴㅎㅜ	inβu
ㅌㅏㄹㅂㅜㄱㅈㅏ	tʰaɭbuk̚t͡ɕa
ㅅㅜㅍㅡ	sʰupʰɯ
ㅇㅡㅁㅇㅑㅇ	ɯmjaŋ
ㅁㅏㄹㄸㅜㄱ	maɭtuk̚
ㅇㅣㄹㅇㅓㅄㄷㅏ	iɾʌp̚ta
ㅁㅔㄷㅏ	meda
ㅆㅡㄸㅏㄹㄹㅗㅂㅏㅇㅑ	sɯtaɭɭobaja
ㅇㅗㅈㅣㄱ	od͡ʑik̚
ㄱㅚㅁㅜㄹ	kwemuɭ
ㄱㅗㅇㅇㅣㄴ	koŋin
ㄴㅏ	na
ㅍㅏㄹㄷㅏㄹㅣ	pʰaɭdaɾi
ㅁㅗㄴㅅㅜㄴ	monsʰun
ㅇㅓㅇㅛ	ʌjo
ㅅㅣㅁㅂㅜㄹㅡㅁ	ɕʰimbuɾɯm
ㄱㅏㅁㅊㅗ	kamt͡ɕʰo
